a - a, ale
abaja - abája
abażur - stínítko
abchaski - abcházština
abdykacja - abdikace
abdykować - abdikovat, odstupovat, odstoupit
Abel - Ábel, Abel
abertam - abertam, abertamský sýr
Abidżan - Abidžan
Abisyńczyk - Habešan
Abisynia - Habeš
abisyński - habešský
ablutomania - nutkavé mytí
abonament - předplatné
abonent - abonent, předplatitel
abonować - abonovat, předplácet
Abraham - Abrahám
Abruzja - Abruzzo
ABS - ABS
absencja - absence , nepřítomnost
absolutny - absolutní, úplný, naprostý; absolutní
absolutyzm - absolutismus
abstrakcja - abstrakce, zobecnění; abstrakce
abstrakcyjny - abstraktní, abstraktivní
abstynencja - abstinence
absurd - absurdnost , nesmysl
Abudża - Abuja
Abu Zabi - Abú Zabí
Abwehra - Abwehr
Achilles - Achilles , Achilleus
achondryt - achondrit
achromat - achromát
aczkolwiek - ačkoli, i když
Ada - Ada
Adam - Adam
adaptacja - adaptace
adapter - přenoska
Addis Abeba - Addis Abeba
Adelajda - Adelajda, Adelaida
administracja - administrativa, správa; administrace
administrator - administrátor , správce
administrować - obdivovat, uctívat, zbožňovat
Adonis - Adónis
adopcja - adopce
adres - adresa
adresat - adresát
Adriatyk - Jadran
adwokat - advokát
aerobik - aerobik
afekt - afekt
Afganistan - Afghánistán
afgański - afghánský
afisz - plakát
Afrodyta - Afrodita
Afryka - Afrika
Afrykanin - Afričan
Afrykanka - Afričanka
afrykański - africký
Agata - Agáta
agencja - agence, agentura
agent - agent, představitel; agent, tajný policista
agitacja - agitace
agitować - agitovat
Agnieszka - Anežka
agonia - agonie, agónie
agregat - agregát
agresja - agrese; agrese
agrest - angrešt
aguti - aguti
aikido - aikido
akcent - přízvuk , akcent
Akra - Accra
akson - axon
aktor - herec
aktorka - herečka
aktyn - aktinium
akupresura - akupresura
akupunktura - akupunktura
akwedukt - akvadukt
Akwizgran - Cáchy
Aladyn - Aladin
alarm - poplach
Albańczyk - Albánec
Albania - Albánie
Albanka - Albánka
albański - albánština
Alberta - Alberta
Albin - Albín
albinos - albín
ale - ale
aleja - alej
Aleksander - Alexandr, Alexander
Aleksandra - Alexandra
alergen - alergen
alergia - alergie
alergologia - alergologie
alfabet - abeceda
Alfred - Alfréd
algebra - algebra
Algier - Alžír
Algieria - Alžírsko
alibi - alibi
Alicja - Alice
Alina - Alina
alkoholik - alkoholik
alkoholowy - alkoholický
Allah - Alláh
allel - allela
Alojzy - Alois
Alpy - Alpy
Alzacja - Alsasko
Amadeusz - Amadeus
ambona - kazatelna
Ambroży - Ambrož
ambulatoryjny - ambulantní
Amelia - Amélie
Ameryka - Amerika
ameryk - americium
Amerykanin - Američan
Amerykanka - Američanka
Ameryka Północna - Severní Amerika
Ameryka Południowa - Jižní Amerika
ametyst - ametyst
amfetamina - amfetamin
amharski - amharština
Amman - Amán
amok - amok
amoniak - amoniak, azan
Amos - Amos
ampułka - ampule
amputacja - amputace
Amsterdam - Amsterdam
Amu-daria - Amudarja
amulet - amulet
Amur - Amur
anachronizm - anachronismus, anachronizmus
anakonda - anakonda
ananas - ananas
anarchizm - anarchismus
Anastazja - Anastázie
Anatol - Anatol
anatom - anatom
anatomia - anatomie ; anatomie
Andora - Andorra; Andorra la Vella
Andrea - Andrea
Andromeda - Andromeda; Andromeda
Andrzej - Andrej
Andy - Andy
aneksja - anexe
anestezjolog - anestetik ; anestetik
Aneta - Aneta
anewryzm - aneurysma
Angielka - Angličanka
angielski - angličtina
angiografia - zobrazení cév , angiografie
angiologia - angiologie
Anglia - Anglie
Anglik - Angličan
Angola - Angola
ani - ani; ani; ani; ani; ani; ani; ani
Aniela - Anděla
anioł - anděl
Anioł - Anděl
Anioł Pański - Anděl Páně
Anita - Anita
Ankara - Ankara
Anna - Anna
anoda - anoda
anoreksja - anorexie
Antananarywa - Antananarivo
Antares - Antares
Antarktyda - Antarktida
Antigua i Barbuda - Antigua a Barbuda
Antoni - Antonín, Anton, Antal
antonim - antonymum
Antwerpia - Antverpy
antybiogram - antibiogram
antyfaszystowski - protifašistický
antygen - antigen
antyimperialistyczny - protiimperialistický
antyklerykalizm - antiklerikalismus
antykwariat - antikvariát
Antyle Holenderskie - Nizozemské Antily
antymateria - antihmota
antymon - antimon
antypapieski - protipapežský
antypolski - protipolský
antysemicki - antisemitský
antyseptyczny - antiseptický
Anubis - Anup
anyż gwiazdkowy - hvězdicový anýz
Anzelm - Anselm
aorta - aorta
aparat fotograficzny - fotoaparát
aparat rentgenowski - rentgenový přistroj
apartheid - apartheid
apatia - apatie
apeniński - apeninský
Apeniny - Apeniny
Apia - Apia
aplikator - aplikátor
aplikować - podávat, poskytovat
Apollo - Apollo , Apollón ; Apollón
Apolonia - Apolena
apostoł - apoštol
apteka - lékárna
aptekarz - lékárník
Arabia Saudyjska - Saúdská Arábie
arabistyka - arabistika; arabistika
arabski - arabština
arachnologia - arachnologie
archaiczny - archaický
archanioł - archanděl
archeolog - archeolog
architekt - architekt
archiwum - archiv
arcybiskup - arcibiskup
Argentyna - Argentina
argon - argon
arkebuz - arkebuza
armata - dĕlo
Armenia - Arménie
Armida - Armida
aromaterapia - aromaterapie
aromatyczny - aromatický, voňavý, vonný
arsen - arsen
artefakt - artefakt
Artemida - Artemis
artykuł - článek
arytmetyczny - aritmetický
-arz - -ář, -ař
aseksualizm - asexualita
as - eso; eso
asfalt - asfalt
Asmara - Asmara
Astana - Astana
astat - astat
astma - astma
astronom - astronom
asymptota - asymptota
Asyria - Asýrie
Aszchabad - Ašchabad
atakować - útočit
atak - útok ; záchvat
ateista - ateista
ateistka - ateistka
Atena - Aténa , Athéna
Ateny - Athény
Atlantyda - Atlantida
atłas - atlas
atol - atol
atrakcja - atrakce
August - August
Augustów - Augustov
Aurora - Aurora ; Aurora
Australia - Austrálie; Austrálie
Australijczyk - Australan
Australijka - Australanka
austriacki - rakouský
Austria - Rakousko
Austro-Węgry - Rakousko-Uhersko
aut - aut
autentyczny - autentický
auto - auto
autobus - autobus
autokratyzm - autokracie
automat - automat
autor - autor
autostop - autostop
autostopowiczka - stopařka
autostopowicz - stopař
autostrada - dálnice
autystyczny - autistický
autyzm - autismus
awaria - havárie , porucha
awokado - avokado ; avokado
Azerbejdżan - Ázerbájdžán
azerski - ázerbájdžánština
Azja - Asie
Azjata - Asijec
Azjatka - Asijka
azjatycki - asijský
azot - dusík
baba - bábovka
babcia - babička
bać się - bát se; bát se
bączek - bukáček malý
badanie - vyšetření
Badenia-Wirtembergia - Bádensko-Württembersko
badian właściwy - badyán , čínský anýz , hvězdový anýz
badminton - badminton
bądź - bud'
bagażnik - kufr
bagaż - zavazadlo
Bagdad - Bagdád
bagietka - bageta
bagnet - bodák
Bahamy - Bahamy
Bahrajn - Bahrajn
bajka - pohádka
bakelit - bakelit
bakelitowy - bakelitový
bakłażan - oberžina
bakteria - bakterie
bakteriobójczy - dezinfekční
bakteriolog - bakteriolog
bakteryjny - bakteriální
Baku - Baku
bąk - vlk
bałagan - zmatek
bałałajka - balalajka
balkon - balkon
bal - ples
balsam - balzám
bałtycki - baltský
balustrada - balustráda
bałwan - sněhulák ; hlupák
Bamako - Bamako
banan - banán
bandaż - bandáž , obvaz
Bandżul - Banjul
Bangi - Bangui
Bangkok - Bangkok
Bangladesz - Bangladéš
bank - banka
bank krwi - krevní banka
banknot - bankovka
bankomat - bankomat
bankowy - bankovní
bank spermy - spermabanka
Bańska Bystrzyca - Banská Bystrica
Barabasz - Barabáš
baran - beran
Baran - Beran ; Beran
Barbados - Barbados
Barbara - Barbora
bar - baryum
Barcelona - Barcelona ; Barcelona
bardzo - velmi
baribal - baribal
barkarola - barkarola; barkarola
bark - rameno ; bark
Barnaba - Barnabáš
barometr - barometr
barszcz - boršč
Bartłomiej - Bartoloměj
barykada - barikáda
baryton - baryton
baskijski - baskičtina
baśń - báje
batalion - prapor
bat - bič
Bawaria - Bavorsko
bawarski - bavorský
bawełna - bavlna
bażant - bažant
bazar - bazar
Bazylea - Basilej
Bazyli - Basil
Beata - Beáta, Beata
Beatrycze - Beatrice
beczka - sud
Bejrut - Bejrút
bela - balík
beletrystyka - beletrie
Belg - Belgičan
Belgia - Belgie
Belgijka - Belgičanka
belgijski - belgický
Belgrad - Bělehrad
Belize - Belize
Belmopan - Belmopan
Benedykt - Benedikt
bengalski - bengálština
Benin - Benin
beret - baret
berkel - berkelium
Berlin - Berlín
Berlin Zachodni - Západní Berlín
Berno - Bern
beryl - beryllium
Betlejem - Betlém
beton - beton
betoniarka - míchačka betonu
bezbarwny - bezbarvý
bezczelny - drzý
bezdech - zástava dechu
bezgorączkowy - bez horečky
bezmocz - anurie
bezpieczeństwo - bezpečnost
bezpiecznik - pojistka
Bhutan - Bhútán
Biała - Bělá
białaczka - leukémie
białko - bílek ; bělima , oční bělmo , skléra ; bílkovina
Białoruś - Bělorusko
białoruski - běloruština
białowieski - bělověžský
biały - bílý
Biblia - Bible
biblijny - biblický
bibliofil - bibliofil
biblioteka - knihovna
bibliotekarz - knihovník
bidet - bidet
biec - běžet
bieda - chudoba , bída
biedak - chudák
biedny jak mysz kościelna - chudý jako kostelní myš
biegać - běhat
biegunka - průjem
bielizna - prádlo
Bielsko-Biała - Bílsko-Bělá
Bielsko - Bílsko
bierne palenie - pasivní kouření
biernik - akuzativ , čtvrtý pád
bilet - lístek , vstupenka , jízdenka
binturong - binturong
biochemia - biochemie
biologia - biologie
biologiczny - biologický
biopsja - biopsie
biotyna - biotin
birmański - barmština
biskup - biskup
Bissau - Bissau
Biszkek - Biškek
biustonosz - podprsenka
bizmut - bismut
Błażej - Blažej
błędne koło - bludný kruh
błękitna krew - modrá krev
Bliski Wschód - Blízký východ
blisko - blízko
blizna - jizva
Bliźnięta - Blíženci; Blíženci
bliźnięta syjamskie - siamská dvojčata
błona dziewicza - panenská blána
błona śluzowa - sliznice
blondyn - blonďák
błotnik - blatník
bluszcz - břečťan
błyskawica - blesk
bóbr - bobr
bocian - čáp
bodziec - podráždĕní
bogactwo - bohatství
bóg - bůh
Bóg - Bůh, Hospodin, Pán
bogini - bohyně
Bogota - Bogotá
Bogumiła - Bohumila
Bogumił - Bohumil
Bogusława - Bohuslava
Bogusław - Bohuslav
bohater - hrdina
bohr - bohrium
bójka - rvačka
bojler - bojler
boks - box
ból - bolest
Bolesław - Boleslav
Boliwia - Bolívie
bomba - bomba
Bombaj - Bombaj
boński - bonnský
bor - bor
borowina - fango
boski - božský; božský
bośniacki - bosenština
Bośnia i Hercegowina - Bosna a Hercegovina
Botswana - Botswana
Bożena - Božena
Boże Narodzenie - Vánoce
bożonarodzeniowy - vánoční
brać nogi za pas - vzít nohy na ramena
brak miesiączki - vynecháni menstruace
bramkarz - brankář
brat - bratr , brácha
Bratysława - Bratislava
bratysławski - bratislavský
brązowy - hnědý
Brazylia - Brazílie
Brazylijczyk - Brazilec
Brazylijka - Brazilka
Brno - Brno ; Brno
brodawka sutkowa - prsní bradavka
brokuł - brokolice
brom - brom
Bronisław - Bronislav, Branislav
broń - zbraň
broszura - brožura
Bruksela - Brusel
brukselka - kapusta
brukselski - bruselský
Brunei - Brunej
bryczesy - rajtky
bryg - briga
Brytyjczyk - Brit
Brytyjka - Britka
brzmienie - zvuk
brzoskwinia - broskev
brzuchomówca - břichomluvec
brzuszysko - panděro
brzydki - ošklivý
brzytwa - břitva
buda - bouda; bouda; bouda
Budapeszt - Budapešť
buddyzm - buddhismus
budzik - budík
Budziszyn - Budyšín
Bug - Západní Bug
Bukareszt - Bukurešť
buk - buk
Bułgar - Bulhar
Bułgaria - Bulharsko
Bułgarka - Bulharka
bułgarski - bulharština
bulimia - bulimie
burak - červená řepa
Burkina Faso - Burkina Faso
burmistrz - purkmistr , purkmistrová
bursztyn - jantar
Burundi - Burundi
burza - bouřka
burza w szklance wody - bouře ve sklenici vody
busola - busola
butan - butan
but - bota
Bużumbura - Bujumbura
być - být
być w siódmym niebie - být v sedmém nebi
być w swoim żywiole - být ve svém živlu
być z kimś na noże - být s někým na nože
Bydgoszcz - Bydhošť
Byk - Býk ; Býk
Była Jugosłowiańska Republika Macedonii - Bývalá jugoslávská republika Makedonie
Bytom - Bitom
całka - integrál
całkiem - úplně, naprosto; docela
całkowity - úplný
Caracas - Caracas
car - car
cebula - cibule
Cecylia - Cecílie
cedr - cedr
cegła - cihla
cela - cela
cel - cíl, účel
celibat - celibát
celownik - mířidlo , zaměřovač ; hledáček ; dativ , třetí pád
cennik - ceník
cep - cep
cer - cer
Ceres - Ceres; Ceres
cesarskie cięcie - císařský řez
cesarz - císař
cewka moczowa - močová trubice
cewnik - katetr
cez - cesium
Charków - Charkov
chart - chrt
Chartum - Chartúm
chcieć - chtít
Chełmno - Chlumno
Chełmża - Chlumže
chemik - chemik
chemioterapia - chemoterapie
chepresz - chepreš
Cheronea - Chairóneia
Cheroneja - Chairóneia
Chile - Chile
Chińska Republika Ludowa - Čínská lidová republika
Chiny - Čína
chirurgia kosmetyczna - kosmetická chirurgie
chleb - chléb
chlew - chlév , vepřín
chłodny - chladný
chłopiec - kluk , chlapec , hoch
chlor - chlor
chloroaceton - chloraceton
chłystek - hejsek
chmura - mrak
chodzić - chodit
choinka - vánoční stromek, vánoční stromeček
cholesterol - cholesterol
chomik - křeček
choroba morska - mořská nemoc
choroba - nemoc
choroba Parkinsona - Parkinsonova nemoc
chorobotwórczość - patogenita
Chorwacja - Chorvatsko
chorwacki - chorvatský; chorvatština
Chorwat - Chorvát
Chorwatka - Chorvátka
chory - nemocný
Chorzów - Chořov
chrapać - chrápat
chrom - chrom
chromosom - chromozom
chruścik - chrostík
Chrystus - Kristus
chrząstka - chrupavka
chrześcijański - křesťanský
chuj - chuj
chusteczka - kapesník
chwalić - chválit
chwila - chvíle
chwytać - chytat
chytry - chytrý
ciało obce - cizí tĕleso
ciąża - těhotenství
ciążowy - těhotenský
cicho - potichu
ciecz łzowa - slzní tekutina
ciemnowłosy - tmavovlasý
cień - stín
Cieplickie Skalne Miasto - Teplické skalní město
cierpliwość - trpělivost
cieszyński - těšínský
ciężki - téžký
ciocia - teta
ciotka - teta
cipa - píča
ciśnienie - tlak
cło - clo
cmentarz - hřbitov
co - co; co; proč; každý; každo-
codzienność - všednost
cofać - ustupovat
cokolwiek - cokoli
córka - dcera
cukier - cukr
cukiernik - cukrář
cukrzyca - cukrovka
ćwierćfinał - čtvrtfinále
cyberprzestrzeń - kyberprostor
cyferblat - ciferník
cyfra - cifra
cyjon - dhoul
cyklotron - cyklotron
cyna - cín
cynk - zinek
cypel - mys
Cypr - Kypr
cyrkiel - kružítko
cyrkon - zirkonium
Cyryl - Cyril
cyrylijski - cyrilský, kyrilský
cyrylo-metodejski - cyrilometodějský
cyrylo-metodiański - cyrilometodějský
cytryna - citron
cyzjojan - cisiojan
Czad - Čad; Čadské jezero
czador - čádor
czapla - volavka
czarna dziura - černá díra
czarna jagoda - brusnice borůvka, borůvka
czarna porzeczka - černý rybíz
Czarnogóra - Černá Hora
czarny - černý
czas - čas
czasopismo - časopis
czasownik - sloveso
czciciel - ctitel
Czech - Čech
Czechosłowacja - Československo
Czechy - Česko ; Čechy
Czeczenia - Čečensko
czekolada - čokoláda
czekoladowy - čokoládový
czereśnia - třešeň
Czerniowce - Černovice
czerwcowy - červnový
czerwiec - červen
czerwona porzeczka - červený rybíz
czerwony - červený
czerwony olbrzym - červený obr
cześć - ahoj, nazdar
czeski - čeština
Czeskie Budziejowice - České Budějovice
często - často
Częstochowa - Čenstochová
częsty - častý
czkawka - škytavka
członek - člen
czoło - čelo
czosnek - česnek
czterdziestoletni - čtyřicetiletý
czternastoletni - čtrnáctiletý
czteroletni - čtyřletý
czterystuletni - čtyřsetletý
czuć - cítit
czwartek - čtvrtek
czwartorzęd - čtvrtohory , kvartér, antropozoikum
czy - ''brak odpowiednika - pytanie zaczyna się bez partykuły''; zda, jestli; nebo
czytać - číst
czytać między wierszami - číst mezi řádky
czytelnia - čítárna, studovna
czytelniczka - čtenářka
czytelnik - čtenář
dąb - dub
dać - dát
dach - střecha
Dagestan - Dagestán
Dakar - Dakar
daktyl - datle
dalajlama - dalajlama
Dalmacja - Dalmácie
Damaszek - Damašek
Dania - Dánsko
darmsztadt - darmstadtium
Dawid - David
deficytowy - deficitní
definicja - definice
Deimos - Deimos
deklaracja - prohlášení
dekolt - výstřih
dekoracja - výzdoba
dekret - dekret
delegat - delegát
demagogia - demagogie
dementi - dementi
Demeter - Demeter
demokracja - demokracie
Demokratyczna Republika Konga - Demokratická republika Kongo
demokratyzacja - demokratizace
demon - démon
dentysta - zubař
denuncjować - denuncovat
depilator - epilátor
dereń - dřín
deszcz - déšť
detektyw - detektiv
diabeł - ďábel
diagnozować - diagnostikovat
dialog - dialog
diament - diamant ; diamant ; diamant
Diana - Diana ; Diana
Dili - Dili
dinozaur - dinosaurus
Dionizos - Dionýsos
diplodok - Diplodocus
dłoń - dlaň
długonogi - dlouhonohý
długopis - propiska , propisovačka
dłuto - dláto
dłużnik - dlužník
DNA - DNA
Dniepr - Dněpr
dobranoc - dobrou noc
dobry - dobrý
dobry wieczór - dobrý večer
Dodoma - Dodoma
doić - dojit
dokładnie - přesně
dolar - dolar
dolina - údolí
dolmen - dolmen
dolnołużycki - dolnolužická srbština, dolnolužičtina
dolny - dolní
dom - dům
dom dziecka - sirotčinec
domek z kart - domeček z karet
Dominika - Dominika
Dominikana - Dominikánská republika
doniczka - květináč
dopełniacz - genitiv , druhý pád
Dorota - Dorota
dorożka - drožka
dość - dost; dost
doskonały - dokonalý, skvělý
do widzenia - na shledanou
dozwolony - přípustný
drabina - žebřík
dragon - dragoun
drapacz chmur - mrakodrap
drapieżnik - dravec , predátor
dres - tepláky
drewniak - dřevák
drewno - dřěvo
Drezno - Drážďany
droga ekspresowa - rychlostní silnice
Droga Mleczna - Mléčná dráha
droga - silnice; cesta
Drohobycz - Drohobyč
drożdże - kvasinka
drugie śniadanie - svačina
drukarka - tiskárna
drukarz - tiskař
druk - knihtisk
drzemka - zdřímnutí
drzewo iglaste - jehličnan
drzewo - strom
drzwi - dveře
Dublin - Dublin
dubn - dubnium
duch - přízrak; duše; duch
Duch Święty - Duch svatý
dudek - dudek
duma - pýcha ; hrdost
Duńczyk - Dán
Dunka - Dánka
duński - dánština
dupa - prdel , buchta , roštěnka
dupek - kretén
dusza - duše
Duszanbe - Dušanbe
Duszniki-Zdrój - Dušníky
dużo - hodně
dwudziestoletni - dvacetiletý‎
dwuletni - dvouletý
dwunastoletni - dvanáctiletý
dwupokojowy - dvoupokojový
dwustuletni - dvěstěletý
dyliżans - dostavník
dynamika - dynamika
dynia - dýně
dyplomata - diplomat
dyplomatyczny - diplomatický
dyrektor - ředitel
dyskietka - disketa
dyspensa - dispens
dysproz - dysprosium
dysydent - disident
dyszel - oj , ojnice
Dżakarta - Jakarta
dżamahirijja - džamáhíríje
dżdżownica - žížala
dżelada - dželada
dżem - džem
dziadek - děd , děda
działo - kanón
dziąsło - dáseň
Dżibuti - Džibutsko; Džibuti
dzieciństwo - dětství
dzięcioł - žluna
dziecko - dítě děti;
dzięki - díky; díky
dzień - den
dzień dobry - dobré jitro
dzierzba - ťuhýk
dziesięcioletni - desetiletý
dziewczyna - holka, dívka
dziewica - panna
dziewięćdziesięcioletni - devadesátiletý‎
dziewięcioletni - devítiletý‎
dziewiętnastoletni - devatenáctiletý
dzik - divočák
dżinsy - džíny
dziób - zobák
dżip - jeep, džíp
dzisiaj - dnes
dziura - díra
dżudo - dżudo|judo
dźwig - jeřáb
dzwonnica - zvonice
Edirne - Edirne
Edward - Eduard
edykuł - edikula
edyl - aedil
Edyta - Edita
edytor tekstu - textový procesor
Egipcjanin - Egypťan
egipski - egyptský
Egipt - Egypt
egiptologia - egyptologie
egoista - sobec
egoizm - egoismus
einstein - einsteinium
ekologia - ekologie
ekonomia - ekonomie
ekosystem - ekosystém
ekspert - expert
eksplozja - exploze
eksponat - exponát
ekspresjonizm - expresionismus
ekstremizm - extremismus
Ekwador - Ekvádor
elektroenergetyka - elektroenergetika
elektrolit - elektrolyt
elektron - elektron
elektronika - elektronika
Elżbieta - Alžběta
emigrant - emigrant
Emilia - Emílie, Emilia
emir - emír
empiryczny - empirický
entomologia - entomologie
entropia - entropie
entuzjazm - nadšení
enzym - enzym
Eos - Éós , Eos ; Eos
erb - erbium
erekcja - erekce
Eris - Eris; Eris
Ernest - Arnošt
Eryk - Erik
Erytrea - Eritrea
Erywań - Jerevan
ESBC - ESCB
esperanto - esperanto
estetyka - estetika
Estończyk - Estonec
Estonia - Estonsko
Estonka - Estonka
estoński - estonština
etalon - etalon
etan - ethan
eten - ethen, ethylen
Etiopia - Etiopie
etologia - etologie
etruski - etruský; etruština
etymologia - etymologie
euforia - euforie
Eugeniusz - Evžen
Europa - Evropa
Europejczyk - Evropan
Europejka - Evropanka
europ - europium
eurosceptyk - euroskeptik
eutanazja - eutanázie
Ewa - Eva
Ezdrasz - Ezdráš
Ezop - Ezop
fałszywy - falešný
farerski - faerština
farsz - nádivka
fasola - fasole
fauna - fauna
Feliks - Felix
fenek - fenek
Fenicja - Fénicie
Ferdynand - Ferdinand
ferm - fermium
Fidżi - Fidži
figa - fík
figowiec - fíkovník
figura retoryczna - řečnická figura
Filip - Filip
filipiński - filipínský
Filipiny - Filipíny
film - film
filozof - filozof
filtr - filtr
filuterny - šibalský
finalista - finalista
finalistka - finalistka
finansowy - finanční
Fin - Fin
Finlandia - Finsko
fiński - finština
fioletowy - fialový, šeřikově modrý
fiord - fjord
fitogeografia - fytogeografie
flaga - vlajka
flaming - plameňák
flirt - flirt
Florencja - Florencie
fluor - fluor
folklor - folklor
forint - forint
fosa - vodní příkop
fosfor - fosfor
fotel - křeslo
foton - foton
fototropizm - fototropismus
frak - frak
Franciszek - František
Franciszka - Františka
Franciszkowe Łaźnie - Františkovy Lázně
Francja - Francie
francuski - francouzština
Francuz - Francouz
Francuzka - Francouzka
frans - francium
fretka - fretka
Fryderyka - Bedřiška
Fryderyk - Bedřich
funkcja stanu - stavová veličina
funkcjonować - fungovat
Gabon - Gabon
Gaborone - Gaborone
gadolin - gadolinium
gal - gallium
Galicja - Halič
Gambia - Gambie
gametangium - gametangium
gang - gang
gangster - gangster
gardło - hrdlo , krk
garncarstwo - hrnčířství
garnitur - oblek
garsonka - kostým
gąsię - house
gąsior - houser
gaz musztardowy - hořčičný plyn
gdakać - kdákat
Gdańsk - Gdaňsk
gdański - gdaňský
Gdynia - Gdyně
gęgać - kejhat
gejzer - gejzír
generał - armádní generál
generał broni - generálporučík
generał dywizji - generálmajor
Genewa - Ženeva
genewski - ženevský
Genua - Janov
geografia - zeměpis
geologia - geologie
german - germanium
gęś - husa
getto - ghetto
Ghana - Ghana
gibon - gibon
giez - velká moucha
gil - hýl
ginekologia - gynekologie
ginekolog - ženský lékař
gitara - kytara
glina - hlína
glin - hliník
glista - škrkavka
globus - glóbus
głód - hlad
głodny - hladový
Głogów - Hlohov
głośnik - reproduktor
głośno - nahlas
głoszenie - hlásání
głowa - hlava ; hlava
główka - hlavička
głownia - čepel
główny - hlavní
głuchy - hluchý
głupek - blb, blbec
głupiec - blbec
gniazdo - hnízdo
Gniezno - Hnězdno
gnu - pakůň žíhaný
godło - znak
godność - důstojnost
godzina - hodina ; hodina
gołębnik - holubník
gol - gól
gołoledź - náledí , námraza
goniec - posel
góra - hora
górnik - horník
górnołużycki - hornolužická srbština, hornolužičtina
gorset - korzet
goryl - gorila
Góry Skaliste - Skalnaté hory, Skalisté hory
gorzki - hořký
gospodyni - hospodyně
gówno - hovno
gracz - hráč
gra - hra
gramofon - gramofon
gramofonowy - gramofonový
granatowy - tmavomodrý
granica - hranice
granit - žula , granit
gra słów - slovní hříčka
gratulacja - blahopřání
Grecja - Řecko
grecki - řečtina
grejpfrut - grapefruit , grep
Grenada - Grenada
Grenlandia - Grónsko
grenlandzki - grónský
grób - hrob
groch - hrách
grog - grog
gromadzić - nahromadit, akumulovat; sbírat
gronostaj - hranostaj
gruba berta - Tlustá Berta
grubaska - tlusťoška
grudniowy - prosincový
grudzień - prosinec
gruszka - hruška
gruziński - gruzínský; gruzínština
Gruzja - Gruzie
grymas - grimasa
grypa - chřipka
grzanka - topinka
grzbiet - hřbet
grzebień - hřeben
grzechotka - chrastítko
Grzegorz - Řehoř
grzyb - houba
grzybobranie - houbaření
grzywka - ofina
Gujana Francuska - Francouzská Guyana
Gujana - Guyana
Gustaw - Gustav
gwałciciel - násilník
gwiazda - hvězda
Gwiazda Poranna - Jitřenka
Gwiazda Wieczorna - Večernice
Gwinea Bissau - Guinea-Bissau
Gwinea - Guinea
Gwinea Równikowa - Rovníková Guinea
gwóźdź - hřebík
Hades - Hádes ; hádes
hafn - hafnium
haft - výšivka
haitański - haitský
Haiti - Haiti
hala - hala
hałaśliwy - hlučný, rámusivý
hamulec - brzda
Hanoi - Hanoj
Harare - Harare
harfa - harfa
has - hassium
haszysz - hašiš
haubica - houfnice
Hawana - Havana
hazard - hazardní hra
hebrajski - hebrejský; hebrejština
Hefajstos - Hefaistos
hektar - hektar
Helena - Helena ; Helena ; Helene
hel - helium
helikopter - helikoptéra
Helios - Hélios
Helsinki - Helsinky
helsiński - helsinský
Henryk - Jindřich
heparyna - heparin
Hera - Héra
herbata - čaj
Herkules - Herkules
Hermes - Hermes ; Hermes
Hestia - Hestia
hiacynt - hyacint
Hiady - Hyády
Hieronim - Jeroným
Higieja - Hygieia
hindi - hindština
hinduizm - hinduismus
Hindukusz - Hindúkuš
Hindus - Ind
Hinduska - Indka
hinduski - indický
Hiob - Jób
hiobowa wieść - Jobova zvěst
hiperonim - hyperonymum
hipo- - hypo-
hiponim - hyponymum
hipopotam - hroch
hipoteza - hypotéza
Hiroszima - Hirošima
historia - dějiny
historyk - historik
Hiszpania - Španělsko
hiszpański - španělština
hokej - hokej
Holandia - Nizozemsko , Holandsko
Holender - Holanďan
Holenderka - Holanďanka
holenderski - nizozemština
holm - holmium
homeopatia - homeopatie
Honduras - Honduras
Hongkong - Hongkong
Honiara - Honiara
hormon - hormon
hormonozależny - závislý na hormonech
Horus - Hor
hostessa - hosteska
hotel - hotel
hulajnoga - koloběžka
humor - nálada
huśtawka - houpačka
husycki - husitský
husyta - husita
huta - huť
hydroponika - hydroponie
hydrostatyka - hydrostatika
i - a
ibis - ibis
idealny - ideální
idea - nápad
idiom - idiom
igła - jehla
Igława - Jihlava
iglicznia - dřezovec
Ignacy - Ignác
igrać z ogniem - hrát si s ohněm
ikona - ikona
imigracja - imigrace
imigrant - imigrant
imperator - imperátor, císař
Indie - Indie
ind - indium
indoktrynacja - indoktrinace
Indonezja - Indonésie
indonezyjski - indonéština
indris - indri
indyczę - krůtě
indyczka - krůta
inkaso - inkaso
inny - ostatní, jiný
instruktor - instruktor
instrument - nástroj ; přístroj
internet - internet
internetowy - internetový
inwazja - invaze
inżynier - inženýr
Irak - Irák
Iran - Írán
iranistyka - íránistika
Irena - Irena
Ireneusz - Ireneus
Iris - Iris
Irlandczyk - Ir
Irlandia - Irsko
Irlandka - Irka
irlandzki - irský
Iryda - Iris ; Iris
iryd - iridium
Islamabad - Islámábád
islandzki - islandský; islandština
Itaka - Ithaka
itd. - atd.
iterb - ytterbium
itr - yttrium
Iwan - Ivan
Iwo - Ivo
Iwona - Ivona
-izm - -ismus
izokoszta - izokosta
izokwanta - izokvanta
Izrael - Izrael
jabłko Adama - Adamovo jablko
jabłko - jablko
jabłko niezgody - jablko sváru‎
jabłoń - jabloň
jadalnia - jídelna
Jadwiga - Hedvika
ja - já
jajko - vejce, vajíčko
jajo - vejce, vajíčko
jakiś - nějaký
jakkolwiek - jakkoli
Jakub - Jakub; Kuba
jałowiec - jalovec
Jamajka - Jamajka
jamraj - bandikut
Jamusukro - Yamoussoukro
Janina - Jana
Jan - Jan, Ivan, Johan
Japończyk - Japonec
Japonia - Japonsko
Japonka - Japonka
japoński - japonština
Jaromir - Jaromír
jaskinia - jeskyně
jasne jak słońce - jasné jak facka
jastrząb - jestřáb
Jaworzno - Javořno
jazz - jazz
jechać z kimś na jednym wózku - být spolu na jedné lodi
jedenastoletni - jedenáctiletý
jednokomórkowy - jednobuněčný
jednopokojowy - jednopokojový
Jędrzej - Ondřej
jego - jeho; jeho
jej - její
Jelenia Góra - Jelení Hora
jelito - střevo
Jemeńczyk - Jemenec
Jemen - Jemen
Jemenka - Jemenka
jemioła - jmelí
jemiołuszka - brkoslav
jen - jen
Jerozolima - Jeruzalém
jerozolimski - jeruzalémský
Jerycho - Jericho
Jerzy - Jiří
jerzyk - rorýs
jeść - jíst
jesień - podzim
jesion - jasan
jeszcze - ještě; ještě; ještě
jezdnia - vozovka
jeźdźczyni - jezdkyně
jeździć - jezdit; jezdit
jeżeli - jestliže
jeż - ježek
jeżozwierz - dikobraz
Jezus - Ježíš
język - jazyk ; jazyk
język ojczysty - mateřský jazyk
jeżyna - ostružina
jiczyński - jičínský
jidysz - jidiš
Joachim - Jáchym
jod - jod
jodła - jedle
Jonasz - Jonáš
jon - iont
Jordania - Jordánsko
jordański - jordánský
Jowisz - Jupiter ; Jupiter
Józef - Josef
Józek - Pepík
jubiler - klenotník
judo - judo
Judyta - Jitka
Jugosławia - Jugoslávie
Julia - Julie
juliański - juliánský
Juliusz - Julius, Július
Justyna - Justýna
juta - juta
jutro - zítra
już - juž
kabanos - kabanos
Kabul - Kábul
kacap - kacap
Kacper - Kašpar
kaczątko - káče
kaczka - kachna
kaczor - kačer
kadm - kadmium
kadzidło - kadidlo
kairczyk - Káhiřan
Kair - Káhira
kairka - Káhiřanka
kairski - káhirský
kajak - kajak
kajuta - kajuta
kakadu - kakadu
kaktus - kaktus
kalafior - květák
kalendarz - kalendář
kaliforn - kalifornium
kalina - kalina
kalkulator - kalkulačka
kalosz - galoše
Kambodża - Kambodža
kambr - kambrium
Kamerun - Kamerun
Kampala - Kampala
kampus - kampus
Kanada - Kanada
Kanał Sueski - Suezský průplav
kanapka - chlebíček
kanarek - kanárek
kandydat - kandidát
kandydować - kandidovat
kangur - klokan
kania - bedla
kanion - kaňon
kantor - směnárna
kapelusz - klobouk
kaplica - kaple
Kapsztad - Kapské Město
kapusta - zelí
karabin maszynowy - kulomet
karabin - puška
karate - karate
kara - trest
karawela - karavela
karczoch - artyčok
kardiologia - kardiologie
kariatyda - karyatida
karierowicz - kariérista
kark - krk
Karlowe Wary - Karlovy Vary
Karolina - Karolína
Karol - Karel
karp - kapr
kartkówka - písemka , prověrka , přepadovka
karzeł - trpaslík
Kasandra - Kasandra , Kassandra
kasjer - pokladník
kaszalot - vorvaň
kaszel - kašel
kasztan jadalny - kaštanovník jedlý , kaštanovník setý
kasztanowiec - jírovec
kaszubski - kašubština
katafalk - katafalk
Katalonia - Katalánsko
kataloński - katalánský
katarakta - katarakta
Katar - Katar
Katarzyna - Kateřina
katastralny - katastrální
katastrofa - katastrofa
katedra - katedrála
Katmandu - Káthmándú
Katowice - Katovice
kąt - úhel
Katyń - Katyň
katyński - katyňský
kaukaski - kavkazský
Kaukaz - Kavkaz
kawałek - kousek, kus
kawiarka - moka, Moka Express; veka
kawiarnia - kavárna
kawowy - kávový
kazachski - kazaština
Kazachstan - Kazachstán
każdy - každý
Kazimierz - Kazimír
kebab - kebab
keczup - kečup
kefija - kefíja
kefir - kefír
Kenia - Keňa
keratynocyt - keratinocyt
kibuc - kibuc
kiedy - kdy; když; pokud
kiedyś - někdy
kiełbasa - salám , klobása
kierat - žentour
kierować - řídit
kierowca - řidič
kierunek - směr
kieszeń - kapsa
Kigali - Kigali
kijanka - pulec
Kijów - Kyjev
kilogram - kilogram
kilometr - kilometr
kino - kino , biograf, kinematograf, bio, biák
Kinszasa - Kinshasa
kirgiski - kyrgyzština
Kirgistan - Kyrgyzstán
Kiribati - Kiribati
Kiszyniów - Kišiněv
kiur - curium
kiwi - kiwi
kłamać - lhát
kłamca - lhář
kłamstwo - lež
Klara - Klára
klarnet - klarinet
kłaść - pokládat
klatka - klec
klatka piersiowa - hrudník
klaustrofobia - klaustrofobie
klej - lepidlo
klęska - debakl
klient - zákazník ; klient
Kłodzko - Kladsko
klon - javor
kłopot - starost
kłos - klas
kłusownik - pytlák
knedlik - knedlík
koala - koala
koati - nosál červený
kobalt - kobalt
kobiecy - ženský
kobieta - žena
kobra - kobra
kochać - milovat
kochanek - milenec
kocioł - kotel
kocioł parowy - parní kotel
koczkodan - kočkodan
kojot - kojot
koks - koks
kolacja - večeře
kolano - koleno
kołchoz - kolchoz
kolczasty - ostnatý
kolczyk - náušnice
kolęda - koleda
kolega - kamarád
kolektor - kolektor
kolendra - koriandr
koliber - kolibřík
kołodziej - kolář
koło - kruh ; kolo
Kolombo - Kolombo
Kolonia - Kolín nad Rýnem
kolonializm - kolonialismus
kolor - barva
kolorowy - barevný
Kolumbia - Kolumbie
komar - komár
komentować - komentovat
kometa - kometa
komfort - komfort
komiks - komiks
kominek - krb
kominiarz - kominík
Komory - Komory
kompas - kompas
kompot - kompot
kompromis - kompromis
kompromitacja - propadák
komunista - komunista
komunistka - komunistka
komunistyczny - komunistický
Konakry - Conakry
konchiologia - konchologie
kondolencje - kondolence, soustrast
konduktor - průvodčí /
kondygnacja - patro, podlaží
konflikt - konflikt
Kongo - Konžská republika
Kongresówka - Kongresovka
koniak - koňak
konieczny - nutný
konkordat - konkordát
koń - kůň
konny - koňský
Konstancja - Kostnice
konstelacja - souhvězdí
kontrabas - kontrabas
kontur - kontura, obrys
kontynent - kontinent, světadíl
konwalia - konvalinka
kopalnia - důl
koparka - rypadlo
Kopenhaga - Kodaň
koper - kopr
kopnąć w kalendarz - natáhnout bačkory
kora - kůra
Korea - Korea
Koreańczyk - Korejec
Koreanka - Korejka
Koreańska Republika Demokratyczna - Korejská lidově demokratická republika
koreański - korejský; korejština
Korea Północna - Severní Korea
Korea Południowa - Jižní Korea
korek - dopravní zácpa
korona - koruna
Koror - Koror
korrida - korida , býčí zápasy
korupcja - korupce
korytarz - chodba
Kościół - církev ; náboženská společnost
kościół - kostel
kość - kost ; kostka
kos - kos
kosmodrom - kosmodrom
Kostaryka - Kostarika
kostka Rubika - Rubikova kostka
Koszyce - Košice
koszykówka - košíková
kot - kočka
kowadło - kovadlina
kowal - kovář
koza - koza
kozioł - kozel
Koziorożec - Kozoroh
krab - krab
krach - krach
Kraina - Kraňsko
kraj - stát
Kraków - Krakov
krakowski - krakovský
kran - kohoutek
kreda - křída
krematorium - krematorium
krem - krém
Kreta - Kréta
kret - krtek
krętogłów - krutihlav
krew - krev
KRLD - KLDR
kroczyć - kráčet
krok - chůze
krokus - krokus
królestwo - království
królewski - královský
król - král
kronika - kronika
kropka - tečka
kropla - kapka
krowa - kráva
krowi - kraví, kravský
krtań - hrtan
krwotok - krvácení
krykiet - kriket
krypta - krypta
krypton - krypton
Krystian - Kristián
Krystyna - Kristýna
krzem - křemík
krzesło - židle
krzyczeć - křičet
Krzysztof - Kryštof
krzywa - křivka
krzyż - kříž
krzyżyk - vysoký
ksenofobia - xenofobie
ksenon - xenon
książka kucharska - kuchařka
księgarnia - knihkupectví
księżniczka - princezna
księżyc - měsíc
Księżyc - Měsíc
kształt - tvar
kto - kdo; kdo
kto pod kim dołki kopie, sam w nie wpada - kdo jinému jámu kopá, sám do ní padá
kto rano wstaje, temu Pan Bóg daje - ranní ptáče dál doskáče
który - který
Kuba - Kuba
Kubańczyk - Kubánec
Kubanka - Kubánka
kubek - hrnek
kucharz - kuchař
kuchenka - sporák
kufel - holba
kulik - koliha
kumkwat - kumquat
kupować - kupovat
kura - slepice
kurhan - kurhan
kurierka - kurýrka
kurier - kurýr
kurka wodna - slípka zelenonohá
kurwa - kurva
kuskus - kuskus
kusza - kuše
Kuwejt - Kuvajt
kuzynka - sestřenice
kwadrans - čtvrthodina
kwadrat - čtverec ; čtverec
kwadratowy - čtverečný
kwark - kvark
kwartał - čtvrtletí
kwartet - kvarteto
kwas akrylowy - kyselina akrylová
kwas foliowy - kyselina listová
kwaśny - kyselý
kwazar - kvazar
kwiatostan - květenství
kwiecień - duben
Łaba - Labe
łabędzi śpiew - labutí píseň
łabędź - labuť
Łabędź - Labuť
łacina - latina
lać - lít
ładnie - hesky
laguna - laguna
łajno - trus
łąka - louka
lakier do paznokci - lak na nehty
lakmus - lakmus
laktaza - laktáza
lalka - panenka
łamać sobie głowę - lámat si hlavu
łamaniec językowy - jazykolam
lampa - lampa
lampart - levhart
łańcuch pokarmowy - potravní řetězec
łania - laň
lantan - lanthan
Laos - Laos
laotański - laoština
łapać - lapat
laparotomia - laparotomie
Laponia - Laponsko
laser - laser
las - les
latać - létat
latawiec - drak
łatwy - snadný
ławka - lavice
łazienka - koupelna
lazuryt - lazurit
łechtaczka - klitoris
lecieć - letět
leczniczy - léčivý
Legnica - Lehnice
lekarz - lékař
lekki - lehký
lekkoatletyka - atletika , lehká atletika
lemur - lemur
Lena - Lenka
leniwy - líný
lesbijka - lesbička , lesba , lesbičanka
lesisty - lesnatý
Lesotho - Lesotho
letni - letní
lew - lev
Lew - Lev
leworęczny - levák
leżak - lehátko
Liban - Libanon
Liberec - Liberec
Liberia - Libérie
Libia - Libye
lichenologia - lichenologie
liczba atomowa - atomové číslo
liczba pierwsza - prvočíslo
liczba podwójna - dvojné číslo
liczi chińskie - liči čínské
liczyć - počítat
Lidia - Lýdie
likier - likér
likwidacja - likvidace
lilak - šeřík
liliowy - liliový; lila, lilový, šeříkový
Lima - Lima
limfocyt - lymfocyt
linijka - pravítko
linoleum - linoleum
lipa - lípa
lipcowy - červencový
lipiec - červenec
lipień - lipan
Lipsk - Lipsko
lis - liška
lista - seznam
listonosz - listonoš
listopad - listopad
listopadowy - listopadový
literacki - literární, spisovný
litewski - litevština
lit - lithium
Litomierzyce - Litoměřice
liturgia - liturgie
liturgika - liturgika
Litwa - Litva
Litwinka - Litevka
Litwin - Litevec
liza - lýza
Lizbona - Lisabon
lizuska - patolízalka
lizus - patolízal
Loara - Loira
łobuz - darebák
lód - led ; zmrzlina
lodowiec - ledovec
lodówka - lednička
łodyga - stonek
łódź - člun, loď
Łódź - Lodž
logarytm - logaritmus
-logia - -logie
logiczny - logický
łokieć - loket
lokówka - kulma
Lombardia - Lombardie
londyńczyk - Londýňan
Londyn - Londýn
lorens - lawrencium
lori - lori
lornetka - dalekohled
łotewski - lotyština
lotnisko - letiště
lotokot - letucha
Łotwa - Lotyšsko
łóżko - postel
Luanda - Luanda
Lublana - Lublaň
Lucerna - Lucern
Łucja - Lucie
łucznictwo - lukostřelba
ludność - populace
Ludwik - Ludvík
Łukasz - Lukáš
Luksemburg - Lucembursko; Lucemburk
lumbago - ústřel
lunatyk - lunatik , náměsíčník , somnambul
łupież - lupy
Lusaka - Lusaka
lustro - zrcadlo
lustrzanka - zrcadlovka
łuszczyca - psoriáza, lupénka
lutet - lutecium
lutnia - loutna
lutowy - únorový
luty - únor
Łużyce - Lužice
lwia część - lví podíl
lwiatka - lvíček
lwica - lvice
Lwów - Lvov
łydka - lýtko
łyska - lyska
łysy - plešatý
łza - slza
Macedonia - Makedonie
macedoński - makedonština
macica - děloha
Maciej - Matěj
macierz - matice
Madagaskar - Madagaskar
Madera - Madeira
Madryt - Madrid
MAEA - MAAE
mafia - mafie
magiczny - magický
magiel - mandl
magnez - hořčík
magnolia - magnólie
mahonia - mahónie
maj - květen
majonez - majonéza
makak - makak
mak - mák
Malabo - Malabo
malachit - malachit
malajski - malajština
malakologia - malakologie
Mała Niedźwiedzica - Malý medvěd
malarstwo - malířství
Malawi - Malawi
Malediwy - Maledivy
Male - Male
Malezja - Malajsie
Małgorzata - Markéta
Mali - Mali
malina - malina
malinka - cucflek
Małopolska - Malopolsko
malować - malovat
małpa - opičák , opice , zavináč
Malta - Malta
mały - malý; malý
małżeński - manželský
małżonka - manželka
mama - máma, maminka, mamička, mamka, mutra
mamka - kojná
mamut - mamut
Managua - Managua
Manama - Manáma
mangan - mangan
mango - mango; mango
maniak - maniak
Manila - Manila
manometr - manometr
mapa - mapa
Maputo - Maputo
marcepan - marcipán
marcepanowy - marcipánový
marchew - mrkev
Marcin - Martin
marcowy - březnový
Marek - Marek
Maria - Marie
marmolada - marmeláda
Maroko - Maroko
Marsjanin - Marťan
Marta - Marta
martwy - mrtvý
marynarz - námořník
marzec - březen
marzyć - snít
masa krytyczna - kritické množství
masaż - masáž
maść - mast
Maseru - Maseru
Maskat - Maskat
maślanka - podmáslí
masło - máslo
mastaba - mastaba
maszynista - strojvedoucí, strojvůdce
matematyczny - matematický
matematyka - matematika , matika
matka - matka, máti, máma, maminka, mamička, mamka, mutra
matkojebca - mamrd
matura - maturita
maturzysta - maturant
maturzystka - maturantka
Mauretania - Mauritánie
Mauritius - Mauricius
Mbabane - Mbabane
mebel - nábytek
mechaniczny - mechanický
mechanika - mechanika
mech - mech
meitner - meitnerium
Meksykanin - Mexičan
Meksykanka - Mexičanka
meksykański - mexický
Meksyk - Mexiko
melatonina - melatonin
Melchior - Melichar
mendelew - mendelevium
mendel - mandel
Men - Mohan
Merkury - Merkur ; Merkur
męski - pánský
metalowy - kovový
metan - metan
meteor - meteor
meteoryt - meteorit
metoda - metoda
metodyjski - metodějský
Metody - Metoděj , Metod , Metud
metr kwadratowy - metr čtvereční
metro - metro
mężczyzna - muž
MFW - MMF
mgła - mlha
mgławica - mlhovina
mgr - Mgr.
mianownik - nominativ , první pád ; jmenovatel
miasto - město
miażdżyca - ateroskleróza
miąższ - dužina
Michał - Michal
mieć dwie lewe ręce - mít obě ruce levé
mieć nosa - mít nos
miecz Damoklesa - Damoklův meč
miecz - meč
Mieczysława - Mečislava
miedza - mez
miedź - měď
Międzynarodowa Agencja Energii Atomowej - Mezinárodní agentura pro atomovou energii
Międzyrzec Podlaski - Podleské Meziříčí
miejsce - místo
miejscownik - lokativ , lokál , šestý pád
miejska legenda - současná pověst, městská pověst
miesiąc - měsíc
mięsień - sval
mięsożerny - masožravý
mieszkać - bydlet
mieszkaniec - obyvatel
mieszkanka - obyvatelka
mięta - máta
Mikołaj - Mikuláš
mikrocefalia - mikrocefalie
mikrofon - mikrofon
Mikronezja - Mikronésie
mikroskop - mikroskop
miłość - láska
ministra - ministryně
ministrant - ministrant
Mińsk - Minsk
miód - med; medovina
miodownik - medovník
miodowy miesiąc - líbánky
miód pitny - medovina
Mirosława - Miroslava
Miśnia - Míšeň
mleko - mléko
młody - mladý
młynarz - mlynář
moabicki - moabština
móc - moct
modelka - manekýnka
model - model
modlitwa - modlitba
modny - módní
modrzew - modřín
Mogadiszu - Mogadišu
Moguncja - Mohuč
Mojżesz - Mojžíš
Mołdawia - Moldavsko
mołdawski - moldavština
molibden - molybden
mól - mol
Monachium - Mnichov
Monako - Monako
moneta - mince
Mongolia - Mongolsko
mongolski - mongolština
monofizytyzm - monofyzitismus
Monrovia - Monrovia
Montevideo - Montevideo
morela - meruňka
Moroni - Moroni
morski - námořní
mors - mrož
Morze Adriatyckie - Jaderské moře
Morze Bałtyckie - Baltské moře
Morze Białe - Bílé moře
Morze Czarne - Černé moře
Morze Czerwone - Rudé moře
Morze Kaspijskie - Kaspické moře
Morze Martwe - Mrtvé moře
morze - moře
Morze Północne - Severní moře
Morze Śródziemne - Středozemní moře
Moskwa - Moskva
most - most
moszna - šourek
motyka - motyka
mówić - mluvit
Mozambik - Mosambik
może - možná, snad
mózg - mozek
możliwość - možnost
mrowisko - mraveniště
mrówka - mravenec
mrównik - hrabáč kapský
msza - mše
MSZ - MZV
muchomor - muchomůrka
mundur - uniforma
musieć - muset
muślin - mušelín
musztarda - hořčice
muza - Múza ; múza
muzyka - hudba
mydło - mýdlo
mylić - mýlit, plést
my - my
mysikrólik - králíček
myśleć - myslet
Myszka Miki - Myšák Mickey
mysz - myš; myš
myszoskoczek - pískomil
nacjonalista - nacionalista
nacjonalizować - znárodňovat
naczyniak - angiom
naczyniak krwionośny - hemangiom
naczynie - nádoba; nádobí
naczyniowy - cévní
nadawca - odesílatel
naddunajski - podunajský
nadwaga - nadváha
nadzieja - naděje
Nadzieja - Naděžda
naftalen - naftalen
nagietek - měsíček ; měsíček
nagietkowy - měsíčkový
nagle - najednou
nagrobek - náhrobek
Nairobi - Nairobi
naleśnik - palačinka
należeć - patřit; patřit
nalot - razie
Namibia - Namibie
namiot - stan
na pewno - určitě
napletek - předkožka
naprawa - oprava
naprawdę - opravdu
naraz - naráz, najednou; naráz
narciarski - lyžařský
narciarz - lyžař
narkomanka - narkomanka
narkotyk - droga
narzędnik - instrumentál , sedmý pád
Nassau - Nassau
nastolatek - teenager
nastrój - nálada
nasz - náš
Natasza - Nataša
natron - natron
naturalizacja - naturalizace
natychmiast - okamžitě
nauczyciel - kantor
Nauru - Nauru
Nawakszut - Nuakšott
nawa - loď
nawyk - zvyk
na zdrowie - na zdraví; na zdraví
nazwisko - příjmení
Ndżamena - Ndžamena
Neapol - Neapol
negatywny - negativní
nektarynka - nektarinka
neodym - neodym
neon - neon
Nepal - Nepál
neptun - neptunium
Neptun - Neptun ; Neptun
nerwowy - nervózní
neutron - neutron
niacyna - niacin
Niamey - Niamey
nic - nic
nicnierobienie - nicnedělání
niebezpieczeństwo - nebezpečí
niebieski - modrý, blankytný
niebo - nebe; nebe, nebesa
nieboszczyk - nebožtík
niechętnie - nerad
niech - nechť
niedokrwienie - ischemie
niedokrwistość - chudokrevnost
niedopałek - nedopalek
niedostatek - nedostatek
niedziela - neděle
niedźwiedź - medvěd
Niemcy - Německo
Niemen - Němen
Niemiecka Republika Demokratyczna - Německá demokratická republika
niemiecki - němčina
Niemiec - Němec
Niemka - Němka
niemowlę - nemluvně
nie - ne
niepodległość - nezávislost
niepotrzebny - zbytečný
nieść - nést
nieskończony - nekonečný
niestety - bohužel
nie wszystko złoto, co się świeci - navrch huj, vespod fuj
niewyobrażalny - nepředstavitelný
niezapominajka - pomněnka
niezbędny - nutný
nieznany - neznámý
nigdy - nikdy
nigdzie - nikde
Nigeria - Nigérie
Niger - Niger
Nikaragua - Nikaragua
nikiel - nikl
Nikozja - Nikósie
ni - ný
niob - niob
NIP - DIČ - podatkowy numer identyfikacyjny
ni pies, ni wydra - ani ryba, ani rak
niż - než
nobel - nobelium
noc - noc
noga - noha
nora - pelech
normalny - normální
Norwegia - Norsko
Norweg - Nor
norweski - norština
Norweżka - Norka
nosić - nosit; nosit
nos - nos
Nowa Zelandia - Nový Zéland
Nowe Delhi - Nové Dillí
nowojorski - newyorský
noworoczny - novoroční; novoroční
nowotwór - novotvar
nowożytny - novověký
Nowy Rok - Nový rok
nóż do masła - nůž na màslo
nóż - nůž
nożyczki - nůžky
NRD - NDR
Nuku'alofa - Nuku'alofa
nurek - potápěč
nutria - nutrie
nylon - nylon
oaza - oáza
obcas - podpatek
obelisk - obelisk
obiecać - slíbit
obiecanki cacanki - sliby chyby
obiekt - objekt
oblężenie - obležení
obłuda - pokrytectví
obojczyk - klíční kost
obój - hoboj
obora - kravín
obowiązek - povinnost
obrażać - uražet
obrazić - urazit
obrotnica - točna
obrus - ubrus
obywatelka - občanka
obywatel - občan
Ocean Atlantycki - Atlantský oceán
Oceania - Oceánie
Ocean Indyjski - Indický oceán
oczywiście - samozřejmě
odcisk palca - otisk prstu
oddech - oddech, oddych
oddychać - dýchat
oddzielić ziarno od plew - oddělit zrno od plev
odejmowanie - odčítání, odečítání
odezwać się - ozvat se
odkurzacz - vysavač
od - od, z
odpowiadać - odpovědět
odpowiedź - odpověď
Odra - Odra
odra - spalničky
odtrutka - protijed
odwieczny - odvěký
odwiedzać - navštěvovat
odwiedzić - navštívit
odżywka - kondicionér
ofiara - oběť
ogniskowa - průvodič
ogólniak - gympl
ogórek - okurka
ogród - zahrada
ogr - zlobr
ojciec - otec, táta, tatínek, taťka, fotr
ojczym - otčím , nevlastní otec
ojczyzna - vlast
okno - okno
oko - oko ; oko
okop - příkop
okrąg - kruh
okrągły - kruhový, kulatý
okraść - vykrást
okręt liniowy - řadová loď
okręt - loď
oktan - oktan
okulary - brýle
okulary przeciwsłoneczne - sluneční brýle
okulista - oční lékař
olbrzym - obr
olcha - olše
olej - olej
Olga - Olga
Ołomuniec - Olomouc
ołówek - tužka
ołów - olovo
ołtarz - oltář
Oman - Omán
omen - omen
omlet - omeleta
onager - onager
oni - oni
on - on
ono - ono
ontologiczny - ontologický
ONZ - OSN
opat - opat
Opawa - Opava
opona - pneumatika
opowiadać - vyprávět
oprócz - kromě, mimo
optymalny - optimální
orchidea - orchidea , orchidej
ordynator - primář
organista - varhaník
orientalistyka - orientalistika
ornament - ornament
ornitologia - ornitologie
ornitolog - ornitolog
ortodoksyjny - ortodoxní
orzech - ořech
orzeł - orel
oset - bodlák
osiągać - dosáhnout
osiemdziesięcioletni - osmdesátiletý‎
osiemnastoletni - osmnáctiletý‎
osiemsetletni - osmisetletý
osika - osika
oślica - oslice
Oslo - Oslo
ośmioletni - osmiletý
osm - osmium
osoba - osoba
osteoporoza - osteoporóza
Ostrawa - Ostrava
ostrokrzew - cesmína
ostrosłup - jehlan
ostry - ostrý; palivý
Oświęcim - Osvětim
oszukańczy - podvodný
oszust - podvodník
otocjon - pes ušatý
Ottawa - Ottawa
otwierać - otevírat
otwór - otvor
otworzyć - otevřít
-owa - -ová
owca - ovce
owies - oves
owoc - ovoce
pacha - podpaží
pachnidło - parfém
pacynka - maňásek
pączek - kobliha
paczka - balík
padlinożerca - mrchožrout
pająk - pavouk
pajęczyna - pavučina
Pakistan - Pákistán
Palau - Palau
Palermo - Palermo
palić za sobą mosty - spálit za sebou všechny mosty
Palikir - Palikir
palindrom - palindrom
pallad - palladium
pamiątka - památka
Panama - Panama
Panna - Panna
panna - slečna ; slečna
państwo - stát
papieros - cigareta
papier - papír ; papír
papier ścierny - smirkový papír
papieski - papežský
papież - papež
paproć - kapraďorost
Papua-Nowa Gwinea - Papua-Nová Guinea
parabola - parabola
parafia - fara , farnost
parafianka - farnice
paragon - paragon
paragraf - paragraf
Paragwaj - Paraguay
Paramaribo - Paramaribo
parapetówka - kolaudačka
parapet - parapet
parasol - deštník ; slunečnik
Pardubice - Pardubice
parking - parkoviště
park - park
parter - přízemí
partykuła - částice
partytura - partitura
Parys - Paris ; Paris
Paryż - Paříž
pasjans - pasiáns
pasować - slušet
pasożyt - parazit
pasta - pasta
pasza - paša; krmivo
paszport - pas, cestovní pas
pasztet - paštika
Patryk - Patrik
Paweł - Pavel
paw - páv
październikowy - říjnový
październik - říjen
paznokieć - nehet
pchła - blecha
pech - smůla
pediatra - dětský lékař
pedofilia - pedofilie
pedofil - pedofil
pejoratywny - pejorativní
Pekin - Peking
pełny - plný
penis - penis , pyj
pensjonat - penzion
pępek - pupek
pergola - pergola
perkoz - potápka
perliczka - perlička
perski - perština
Peruwiańczyk - Peruánec
Peruwianka - Peruánka
peryskop - periskop
pestka - pecka
pewien - jistě
pianista - pianista
pianistka - pianistka
piąta kolumna - pátá kolona
piątek - pátek
pić jak szewc - pít jako duha
pięćdziesięcioletni - padesátiletý‎
pięcioletni - pětiletý
pięcioosobowy - pětimístný
pięciopokojowy - pětipokojový
piec - pec; péci
pięćsetletni - pětisetletý
pieczarka - pečárka
pieczęć - pečeť
pieczętować - pečetit
piegża - pěnice
piekło - peklo
pielęgniarka - zdravotní sestra
pielgrzymka - pouť
pieluszka - plenka
pień - kmen
pieprzyć - pepřit, mlít, kecat, mrdat, šukat, šoustat, prcat
pierścionek - prsten
pierwotniak - prvok
pierwsza pomoc - první pomoc
pierwszorzędny - prvotřídní
pięść - pěst
pies ogrodnika - žába na prameni
pies - pes
pieszo - pěšky
pięta Achillesa - Achillova pata
piętnastoletni - patnáctiletý
piętro - patro, podlaží
pietruszka - petržel
pigwa - kdoule
piła - pila
piłka - míč , balón
piłka nożna - fotbal
piłkarka - fotbalistka
Pilzno - Plzeň
pingwin - tučňák
piorun - blesk
piosenka - píseň , písnička
Piotr - Petr
piramida - pyramida ; pyramida
pirat - pirát
pirenejski - pyrenejský
pisać - psát
pisanka - kraslice
pisklę - pískle
pismo - písmo
pistacja - pistácie
pistolet maszynowy - samopal
pisuar - pisoár
piwiarnia - pivnice
piwnica - sklep
piwo - pivo
piżama - pyžamo
pizda - pizda
pizza - pizza
pizzeria - pizzerie
Pjongjang - Pchjongjang
płacić - platit
płakać nad rozlanym mlekiem - plakat nad rozlitým mlékem
płakać - plakat
planeta - planeta
planetarium - planetárium
planować - plánovat
plastelina - plastelína
plaster - náplast
płaszcz - kabát
płaszczyzna - rovina
platan - platan
płatek śniegu - sněhová vločka
platyna - platina
plaża - pláž
plazma - plazma
plecak - batoh
plecówka - plec
Plejady - Plejády , Kuřátka
plejstocen - pleistocén
plemię - plemeno
pliszka - konipas
płot - plot
płucnica islandzka - pukléřka islandská
płuco - plíce
pluć - plivat
pług - ruchadlo , pluh
pluskolec - znakoplavka
pluskwiak - ploštice
pluton - plutonium
Pluton - Pluto ; Pluto ; Pluto
płynny - plynný, likvidní, kapalný, tekutý
pływać - plavat
pochodzenie - původ
pochwa - pochva
pociąg - vlak
początkowo - zpočátku
początkowy - počáteční
poczta - pošta
pocztówka - korespondenční lístek, pohlednice
pocztowy - poštovní
podatkowy - daňový
podatnik - poplatník
podciąć komuś skrzydła - přistřihnout křídla komu
poddasze - podkroví
Podgorica - Podgorica
podkolanówka - podkolenka
podkoszulek - tričko , nátělník
podkowa - podkova
Podlasie - Podlesí
podnosić do potęgi - mocnit
podpisać - podepsat
podpułkownik - Podplukovník
podróżować - cestovat
poduszka - polštář
poduszka powietrzna - airbag
pogoda - počasí
pojutrze - pozítří
pokuta - pokání
pokutnik - kajícník
polder - polder
polegać - spoléhat
polemika - polemika
policjantka - policistka
policjant - policista
policja - policie
policzek - tvář
policzyć - spočítat
poligamia - polygamie
polityka - politika
półnagi - polonahý
połóg - šestinedělí
polon - polonium
polować - lovit
położenie - umístění
położyć - položit '''', lehnout si ''''
Polska - Polsko
polski - polský; polština
południe - poledne; jih
południk - poledník
południowoamerykański - jihoamerický
pomagać - pomáhat, pomoct
pomarańcza - pomeranč
pomidorówka - rajský|rajská polévka
pomidor - rajče
pomnik - památník
pomnik przyrody - přírodní památka
pomoc - pomoc
Pomorze - Pomořansko
pompka - hustilka
poniedziałek - pondělí
ponieważ - protože
pontyfikat - pontifikát
poprawnie - správně
poprawny - správný
popularność - oblíbenost
popularyzować - popularizovat
porcja - porce
poród - porod
por - pórek
portfel - peněženka
Portugalia - Portugalsko
portugalski - portugalština
porucznik - nadporučík
porwanie - únos
porzeczka - rybíz
Posejdon - Poseidón
poseł - poslanec
pośladek - hýždě
pośpiech - kvap
posprzątać - uklidit
postać - podoba
potas - draslík
potoczny - hovorový
powiedzieć - říct
powietrze - vzduch
powódź - povodeň, záplava
powoli - pomalu, zvolna
powtarzać - opakovat
poziomica - vodováha
Poznań - Poznaň
późno - pozdě
pożyczyć - půjčit
PP - PP; PP
praca - práce
pracodawca - zaměstnavatel
pracoholiczka - workoholička
pracoholik - workoholik
pracować - pracovat
Praga - Praha
pragnąć - dychtit, toužit
pragnienie - žízeň
pralka - pračka
prawa zwierząt - práva zvířat
prawda - pravda
prawdopodobnie - pravděpodobně
prawdziwych przyjaciół poznaje się w biedzie - v nouzi poznáš přítele
prawica - pravice
prawie - teměř, skoro
prawnik - právník
prawnuczka - pravnučka
prawo jazdy - řidičský průkaz
prazeodym - praseodym
Preszów - Prešov
Pretoria - Pretoria
prezydent - prezident
problematyczny - problematický
proboszcz - farář
próbować - zkoušet
procesja - procesí
prodiż - remoska
proletariusz - proletář
promet - promethium
propan - propan
proponować - nabízet, navrhovat
propozycja - propozice
prorokini - prorokyně
prosta - přímka
prostokątny - obdélníkový
prostokąt - obdélník
proszek - prášek
proszę - prosím
protaktyn - protaktinium
protestować - protestovat
protokolant - zapisovatel
proton - proton
prowansalski - okcitánština, okcitánský
Prusy - Prusko
prysznic - sprcha
prywatny - soukromý
przeciąg - průvan
przecież - přece
przecinek - čárka
przeciwgorączkowy - protihorečnatý
przeciwlotniczy - protiletecký
przedmieście - předměstí
przedmiesiączkowy - premenstruační
przedostatni - předposlední
przedpokój - chodba
przedsiębiorstwo - podnik
przedszkole - mateřská škola
przedwczoraj - předevčírem
przedwiośnie - předjaří
przedwojenny - předválečný
przedwyborczy - předvolební
przekaz - poukázka
Przemyśl - Přemyšl
przemysł - průmysl
przemytnik - pašerák
przepaść - propast
przepiórka - křepelka
przepraszam - promiňte
przeprowadzać - stěhovat
przeprowadzić - přestěhovat
Przerów - Přerov
przerwa - přestávka
przestrzeń kosmiczna - kosmický prostor
przewijanie - převíjení
przewlekły - chronický
przewodnik - průvodce
przez - přes, skrz
przeżuwacz - přežvýkavec
przygotować - připravit
przygotowywać - připravovat
przyimek - předložka
przyjaciel - přítel
przyjąć - přijmout
przyjęcie - přijetí
przylot - přílet
przymiotnik - přídavné jméno
przynieść - přinést
przypadek - náhoda ; náhodou; pád ; případ
przyroda - příroda
przysięgać - přísahat
przystojniak - krasavec
przyszłość - budoucnost
przytulić - obejmout
pseudonauka - pseudověda
pseudonim - pseudonym
psychologia - psychologie
pszczelarstwo - včelařství
pszczeli - včelí
pszczoła - včela
Ptah - Ptah
publiczny - veřejný
pudełko - krabice
puder - pudr
pułapka - past
punkt - bod
pustynia - poušť
pusty - prázdný
puszczyk - puštík
pyrrusowe zwycięstwo - Pyrrhovo vítězství
pytać - ptát se
pytanie - otázka
rabat - rabat
Rabat - Rabat
rabin - rabín
rachatłukum - rahat, turecký med
Racibórz - Ratiboř
racjonalizm - racionalismus
raczej - raději
radar - radar
radioodbiornik - radiopřijímač
radon - radon
rad - radium
Rak - Rak
rak - rak ; rakovina
ramię - rameno
randka - rande
rano - ráno‎
raróg - raroh
rasa - rasa
rasistowski - rasistický
ratusz - radnice
razem - pospolu
reaktor katalityczny - katalyzátor výfukových plynů
refektarz - refektář
reinkarnacja - reinkarnace
ręka - ruka
rekin - žralok
rekomendować - doporučit
remis - remíza , plichta
ren - rhenium
reporter - reportér
reprezentant - reprezentant
republika bananowa - banánová republika
Republika Czeska - Česká republika
Republika Federalna Niemiec - Spolková republika Německo
Republika Konga - Konžská republika
Republika Korei - Korejská republika
Republika Południowej Afryki - Jihoafrická republika
Republika Słowacka - Slovenská republika
Republika Środkowoafrykańska - Středoafrická republika
Republika Zielonego Przylądka - Kapverdy
respekt - respekt
restart - restart
rewers - žádanka
rezeda - rezeda
RFN - SRN
Rijad - Rijád
ring - ring
Robert - Robert
robić z igły widły - dělat z komára velblouda
robinsonada - robinzonáda
robotnik - dělník
robot - robot
rock - rock, rock-and-roll, rokenrol
rocznica - výročí
rod - rhodium
rodzeństwo - sourozenci
rodzina językowa - jazyková rodina
rodzina - rodina
rodzynek - rozinka
roentgen - roentgenium
rok - rok
roleta - roleta
rolnictwo - zemědělství
romb - kosočtverec
Rom - Rom
rondo - kruhový objezd
ronić łzy - ronit slzy
ropucha - ropucha
ro - ró
rosarium - rosarium , rozárium
Rosja - Rusko
rosyjski - ruský; ruština
rower - kolo
rowerzysta - cyklista
równanie - rovnice
równanie stanu - stavovou rovnicí
również - též, také, taky
różaniec - růženec ; růženec ; růženec
Róża - Růžena
róża - růže ; růže ; růže ; růže
rozdroże - rozcestí , křižovatka
rozmaity - rozmanitý
rozmowa - rozhovor
różny - různý
różowy - růžový
rozsądny - rozumný
roztargniony - roztržitý
różyczka - zarděnky
rtęć - rtuť
rubid - rubidium
Rumcajs - Rumcajs
Rumunia - Rumunsko
rumuński - rumunština
rupia - rupie
ruta - routa
ruten - ruthenium
rutherford - rutherfordium
Rwanda - Rwanda
ryba - ryba
rybitwa - rybák
rybny - rybí
Ryby - Ryby
rycerz - rytíř
Ryga - Riga
rysować - kreslit
rysunek - kresba
Ryszard - Richard
ryż - rýže
ryzyko - riziko
rządzić - vládnout
rzeczownik - podstatné jméno
rzecz - věc
rzeka - řeka
rzemiosło - řemeslo
rzęsa - řasa
Rzeszów - Řešov
rzeżączka - kapavka
rzeźbiarka - sochařka
rzeźbiarz - sochař
rzodkiewka - ředkvička
rzucać perły przed wieprze - házet perly sviním
rzut - hod, vrh
rzut karny - pokutový kop , penalta, desítka
rzut rożny - roh
Rzym - Řím
rzymski - římský
sadz - sádka
safari - safari
Sahara - Sahara
Saipan - Saipan
Saksonia - Sasko
sałata - salát
salceson - tlačenka
salomonowy wyrok - šalamounské rozhodnutí
Saloniki - Soluň
Salwador - Salvador
samar - samarium
samica - samice
Samoa - Samoa
samobójca - sebevrah
samobójstwo - sebevražda
samodzielny - samostatný
samolot - letadlo
samouk - samouk
Sana - San'á
sandacz - candát
sandałowiec - santal
Sandomierz - Sandoměř
San Marino - San Marino
sanskryt - sanskrt
Santiago - Santiago de Chile
Santo Domingo - Santo Domingo
Sao Tomé - Sao Tomé
Sarajewo - Sarajevo
sarkofag - sarkofág
sarna - srnec
sąsiad - soused
satelita - satelit
Saturn - Saturn; Saturn; Saturn
saudyjski - saúdskoarabský
schabowy - vepřový řízek
schadzka - dostaveníčko
schody - schody
schyłek - sklonek
ścięgno - šlacha
seaborg - seaborgium
sękaty - sukovitý
seks oralny - orální sex
sekunda - sekunda
Selene - Seléné
selenografia - selenografie
selen - selen
seler - celer
Senegal - Senegal
senność - ospalost
sen - spánek
sepsa - sepse
sęp - sup
Serbia i Czarnogóra - Srbsko a Černá Hora
Serbia - Srbsko
serbski - srbština
serce - srdce
serduszko - srdíčko
serial - seriál
serologia - sérologie
ser - sýr
seryjny - sériový; sériový
Seszele - Seychely
Seul - Soul
siano - seno
siarka - síra
siarkowodór - sirovodík, sulfan
siąść - sednout, posadit se
sieć - síť
siedemdziesięcioletni - sedmdesátiletý
siedemnastoletni - sedmnáctiletý
siedemsetletni - sedmsetletý
siedmioletni - sedmiletý
siedzieć - sedět
siekiera - sekera , sekyra
sierpień - srpen
sierp - srp
Sierra Leone - Sierra Leone
sierść - srst
się - se
sikora - sýkora
sikorka - sýkorka
silnik - motor
Singapur - Singapur
siodło - sedlo
siostra - sestra , ségra ; jeptiška
siostrzenica - neteř
skała - hornina ; skála
skalpel - skalpel
Skały Adrszpaskie - Adršpašské skály
Skały Adrszpasko-Cieplickie - Adršpašsko-Teplické skály, Adršpašskoteplické skály
Skały Adrszpasko-Teplickie - Adršpašsko-Teplické skály, Adršpašskoteplické skály
skand - skandium
skąpstwo - skoupost
skasować - zrušit
sklep - obchod
skoczek - jezdec
Skopje - Skopje
skorpion - štír
Skorpion - Štír
skowronek - skřivan
skroń - spánek
skrucha - zkroušenost
skrzydlaty - okřídlený
skrzydłówka - křídlovka
skrzynka - schránka
skrzypce - housle
skrzyp polny - přeslička rolní
skurwysyn - zkurvysyn
skuter - skútr
Śląsk Cieszyński - Těšínsko, Těšínské Slezsko
śląski - slezský
Śląsk - Slezsko
śledziona - slezina
ślepa uliczka - slepá ulička
ślimak - plž
ślina - slina
śliwka - švestka
śliwowica - slivovice
słodki - sladký
słoma - sláma
słomiany - slaměný
słońce - slunce
Słońce - Slunce
słonecznik - slunečnice
słoniątko - slůně
słonica - slonice
słoń - slon
słony - slaný
Słowacja - Slovensko
słowacki - slovenština
Słowak - Slovák
Słowenia - Slovinsko
słoweński - slovinština
słowiański - slovanský
słowik rdzawy - slavík obecný
słowik - slavík
słownikowy - slovníkový
słownik - slovník , slovní zásoba
ślub - svatba
slup - šalupa
słyszeć - slyšet
smacznego - dobrou chuť
smakować - chutnat
smerf - šmoula, šmoulové ''''
śmiać się - smát se; smát se
śmierć - smrt
śmietana - smetana
smok - drak
śniadanie - snídaně
śniadanko - snídáníčko
śnieg - sníh
Śnieżka - Sněžka; Sněhurka
śnieżyć - sněžit
sobota - sobota
socjalista - socialista
socjalizm - socialismus
socjologia - sociologie
soczewica - čočka
sód - sodík
Sofia - Sofie
sójka - sojka
sok - džus
sokół - sokol
sokowirówka - odšťavňovač
solniczka - slánka ; solnička
Somalia - Somálsko
Somalijczyk - Somálec
somalijski - somálština
sopel - rampouch , střechýl
Sopot - Sopoty
sosna - borovice
sos - omáčka
sos sojowy - sójová omáčka
sowa - sova
spadochroniarz - parašutista
spaliny - zplodiny
spam - spam
spędzać - trávit
spędzić - strávit
spichrz - sýpka
śpieszyć - spěchat, pospíchat
śpiewaczka - zpěvačka
śpiewać - zpívat
śpiewak - zpěvák
spiker - hlasatel , speaker
śpioch - ospalec
spiżarnia - spižírna
spódnica - sukně
spodnie - kalhoty
spojówka - spojivka
społeczeństwo - společnost
sport - sport
spotkać - setkat se
spowiedź - zpověď
spróbować - zkusit
sprzątać - uklízet
sprzedawać - prodávat
sp. z o.o. - s.r.o.
srebrny - stříbrný
srebro - stříbro
średnica - průměr
średniowiecze - středověk
średniowieczny - středověký
Sri Lanka - Šrí Lanka
środa - středa
sroka - straka
stacja benzynowa - benzínová pumpa
stacja - stanice
stajnia Augiasza - Augiášův chlév
stalagmit - stalagmit
stalaktyt - stalaktit
Stanisław - Stanislav
Stany Zjednoczone - Spojené státy americké
Stare Bielsko - Staré Bílsko
stary - starý
statek - loď
statyw - stativ
stawiać - stavět
staw - kloub
Stefan - Stefan
step - step ; step
stewardesa - stevardka , letuška
stojak - stojan
stokrotka - sedmikráska , sedmikrása
stolarz - truhlář
stolica - hlavní město
stołowy - stolní
stół - stůl
stomatologia - stomatologie
stonka - mandelinka
stonka ziemniaczana - mandelinka bramborová
stoper - stoper
stopień - stupeň
stopniowo - postupně
stosunek płciowy - pohlavní styk
strajk - stávka
stres - stres
stront - stroncium
struktura - struktura
stryj - strýc
strzała - šíp
Strzelec - Střelec
student - student
studnia - studna
stuletni - stoletý
styczeń - leden
styczniowy - lednový
suchar - suchar
Sudan - Súdán
Sudety - Sudety
sufit - strop
sufizm - súfismus
suka - fena
sukces - úspěch
sułtanat - sultanát
sumienie - svědomí
Surinam - Surinam
surowiec - surovina
suseł - sysel
suszarka do włosów - fén
sutek - bradavka
świat arabski - arabský svět
światło - světlo
świątynia - chrám
Świdnica - Svídnice
świecić - svítit
świerk - smrk
świetny - skvělý
świętojański - svatojánský
świeży - čerstvý
Świna - Svina
świt - svítání, úsvit
Syberia - Sibiř
Sylwester - Silvestr
sylwester - silvestr ; silvestr
symbol - symbol
synapsa - synapse
syndrom miodowy miodowego miesiąca - syndrom líbánek
synowa - snacha
syn - syn
sypialnia - ložnice
Syria - Sýrie
Syriusz - Sirius
Syryjczyk - Syřan
Syryjka - Syřanka
syryjski - syrský
system operacyjny - operační systém
sytuacja - situace
syzyfowa praca - Sisyfovská práce
szafir - safír
szałamaja - šalmaj
szalik - šála
szal - šátek
szampan - šampaňské
szampon - šampon
szantażować - vydírat
szantaż - vyděračství
szantażysta - vyděrač
szantażystka - vyděračka
szaszłyk - šašlik
Szczecin - Štětín
szczegółowy - podrobný
szczęka - čelist
szczekać - štěkat
szczekuszka - pišťucha
szczepionka - vakcína
szczęście - štěstí
szczoteczka do zębów - kartáček na zuby
szczur - krysa, potkan
szczygieł - stehlík
szeptać - šeptat
szermierka - šerm
szermierz - šermíř
szeroki - široký
szerokokątny - širokoúhlý
sześćdziesięcioletni - šedesátiletý
sześciokąt - šestiúhelník
sześcioletni - šestiletý
szesnastoletni - šestnáctiletý
szew - lebeční šev, šev; sešití, steh, sutura
szkielet - kostra
szklarnia - skleník
Szkocja - Skotsko
szkocki - skotský
szkoła podstawowa - základní škola
szkoła średnia - střední škola
szkop - Skopčák
Szkotka - Skotka
szminka - rtěnka
szósty zmysł - šestý smysl
szpak - špaček
szpinak - špenát
szpital - nemocnice‎
szrapnel - šrapnel
Sztokholm - Stockholm
sztuczna szczęka - umělý chrup
szukać dziury w całym - hledat na všem hnidy
szukać - hledat
szukać igły w stogu siana - hledat jehlu v kupce sena
szum - šum
Szwabia - Švábsko
szwagierka - švagrová; švagrová
Szwajcaria - Švýcarsko
Szwecja - Švédsko
Szwedka - Švédka
Szwed - Švéd
szwedzki - švédština
szyja - krk , šíje
szykanowanie - šikana
szypszyna - růže šípková
szyszka - šiška
tabla - tabla
tabletka - tableta
tablica rejestracyjna - registrační značka
tabliczka mnożenia - násobilka
Tadeusz - Tadeáš
Tadżykistan - Tádžikistán
Tajlandia - Thajsko
tak - ano
taksówka - taxi
taktyka - taktika
talizman - talisman
Tallinn - Tallinn
tal - thallium
Tamara - Tamara
Tamiza - Temže
tam - tam
tangens - tangens
tantal - tantal
Tanzania - Tanzanie
tarcza antyrakietowa - protiraketová obrana
tarcza ostrzegawcza - předvěst
tarcza - štít
Tarnów - Tarnov
Taszkent - Taškent, Toškent
tata - táta, tatínek, taťka
Tatry - Tatry
Tbilisi - Tbilisi
tchórzliwy - zbabělý
teatr - divadlo
technet - technecium
technologiczny - technologický
tęcza - duha
Tegucigalpa - Tegucigalpa
Teheran - Teherán
telefon komórkowy - mobilní telefon
telefonować - telefonovat
telefon - telefon
telegram - telegram
teleobiektyw - teleobjektiv
telewizor - televizor , televize
telewizyjny - televizní
tellur - tellur
temat - téma
temperówka - ořezávátko
tenis - tenis
ten śmiać się śmieje, kto śmiać się śmieje ostatni - kdo se směje naposledy, ten se směje nejlépe
teologia - teologie
teologiczny - teologický
Teplickie Skalne Miasto - Teplické skalní město
teraz - nyní, teď
terb - terbium
Teresa - Tereza
termit - všekaz
termodynamika - termika
terrarium - terárium
teściowa - tchyně
teść - tchán
tęsknić - toužit
tęsknota - tužba, touha
testament - závěť
Tezeusz - Théseus
tik - tik
Timor Wschodni - Východní Timor
Tirana - Tirana
tkać - tkát
tkacz - tkadlec
tkanka tłuszczowa - tuková tkáň
tlen - kyslík
Togo - Togo
tokijski - tokijský
Tonga - Tonga
topola - topol
torebka - sáček
torfowisko - rašeliniště
torf - rašelina
tornado - tornádo
tor - thorium; izolovaná skála, tor, izolovené skalisko, mrazový suk
Toruń - Toruň
totalitaryzm - totalita
towar - zboží
towarzysz - soudruh
trąd - lepra
tradycja - tradice
tradycyjny - tradiční
trądzik - akné
traktor - traktor
tramwaj - tramvaj
transakcja - transakce
transport - doprava
trawienie - trávení
trawnik - trávník
Trenczyn - Trenčín
tren - vlečka
treser - krotitel
Trnawa - Trnava
trójkąt - trojúhelník
trójskok - trojskok
trolejbus - trolejbus
trunek - alkoholický nápoj
trup - mrtvola
truskawka - jahodník; jahoda
truskawkowy - jahodový
truteń - trubec
Trynidad i Tobago - Trinidad a Tobago
Trypolis - Tripolis
trzcina - třtina
trzęsienie ziemi - zemětřesení
trzydziestoletni - třicetiletý‎
trzyletni - tříletý‎
trzynastoletni - třináctiletý
trzypokojowy - třípokojový
trzystuletni - třísetletý
tulipan - tulipán
tul - thulium
tundra - tundra
Tunezja - Tunisko
tunezyjski - tuniský
Tunis - Tunis
Turcja - Turecko
turecki - turečtina
Turkmenistan - Turkmenistán
turkmeński - turkmenština
tur - tur
Turyn - Turín
turysta - turista
Tuvalu - Tuvalu
tuzin - tucet
tuż - skoro, téměř
twaróg - tvaroh
twarz - obličej, tvář
twierdzić - tvrdit
tybetański - tibetský
tyć - tloustnout
tydzień - týden; týden
tyle - tolik
tylko - jen, jenom, pouze
typografia - typografie
tysiącletni - tisíciletý
tytan - titan
tytuł - titul; titul
ty - ty
ubezpieczenie - pojištění
ubiór - oděv
ucho - ucho
uderzyć - uhodit
udziec - stehno
UE - EU
Uganda - Uganda
układ okresowy - periodická tabulka
układ okresowy pierwiastków - periodická tabulka
Ukraina - Ukrajina
ukraiński - ukrajinština
Ułan Bator - Ulánbátar
ulica - ulice
ulotka - leták
ul - úl
umowa - úmluva
umrzeć - zemřít
Unia Europejska - Evropská unie
upokarzać - ponížit
Ural - Ural; Ural
uran - uran
Uran - Uran ; Uran , Uranos
Urban - Urban
urlop - dovolená
urna - urna
Urszula - Uršula
Urugwaj - Uruguay
Uście nad Łabą - Ústí nad Labem
uśmiechać się - usmívat se
uśmiech - úsměv
usta - ústa
uszny - ušní
uwaga - pozor
uzasadniać - zdůvodnit
uzbecki - uzbečtina
Uzbekistan - Uzbekistán
uznać - uznat&lt;ref&gt;&lt;/ref&gt;
uznanie - uznání&lt;ref&gt;&lt;/ref&gt;
użytkownik - uživatel
używać - používat
Waga - Váhy
Waldemar - Valdemar
Walia - Wales
wanad - vanad
wanienka - vanička
wapń - vápník
waran - varan
warga - ret
warkocz - cop
Warszawa - Varšava
warto - být záhodno
wartość - hodnota
wąski - úzký
Waszyngton - Washington
wątpliwość - pochybnost
wątroba - játra
wątrobianka - jitrnice
Watykan - Vatikán
wąż - had
ważyć - vážit
wczoraj - včera
w cztery oczy - mezi čtyřma očima
wdzięczność - vděčnost
weganizm - veganství
wegetarianin - vegetarián
wegetarianizm - vegetariánství
węgiel - uhlík
Węgierka - Maďarka
Węgier - Maďar
węgierski - maďarština
Węgry - Maďarsko , Uhry ''pl''
Wełtawa - Vltava
Wenecja - Benátky
wenerologia - venerologie
Wenezuela - Venezuela
Wenus - Venuše ; Venuše
wernakularny - vernakulární
wesoło - vesele
Wesołych Świąt - Veselé Vánoce
Westa - Vesta
western - western
wesz - veš
węzeł gordyjski - gordický uzel
węzeł - uzel
Wezuwiusz - Vesuv
wiać - vát, foukat
wiadomość - zpráva
wiarygodność - hodnověrnost
wiatr - vítr
widelec do porcjowania - vidliĉka porcovací
widelec - vidlička
wideoklip - videoklip
widz - divák
więc - tak, tedy, pak
wieczorny - večerní
wieczór - večer
Wiedeń - Vídeň
wiedzieć - vědět
wiejski - vesnický
większość - většina
Wielka Brytania - Velká Británie
Wielka Niedźwiedzica - Velká medvědice
wielkanocny - velikonoční
Wielkanoc - Velikonoce
Wielkie Równiny - Velké planiny
Wielki Piątek - Velký pátek
wielokomórkowy - mnohobuněčný
wieniec laurowy - laur , vavřín ; laur , vavřín
Wientian - Vientiane
wiercenie - vrtání
wierzba - vrba
wieś - vesnice, ves
Wietnamczyk - Vietnamec
Wietnamka - Vietnamka
wietnamski - vietnamský, vietnamština, vietnamský
Wietnam - Vietnam
wiewiórka - veverka
wieża - věž
więzienie - věznice
Wigilia - Štědrý den
wiking - Viking
Wikipedia - Wikipedie
Wikisłownik - Wikcionář, Wikislovník
Wikiźródła - Wikizdroje
Wiktor - Viktor
wilga - žluva
wilkołak - vlkodlak
wilk - vlk
wilk w owczej skórze - vlk v beránčím rouše
Wilno - Vilnius
winda - výtah
winiarstwo - vinařství ; vinařství
winnica - vinice
winogrodnictwo - vinohradnictví ; vinohradnictví
wiosenny - jarní
wiosna - jaro , vesna
wiskacza - viskača
wiśnia - višeň
witraż - vitráž , vitraj
wizyta - návštěva
wkładka - vložka ; příloha
właściciel - vlastník , majitel
właściwy - vhodný
Włoch - Ital
Włochy - Itálie
Włocławek - Włocławek
Włodzimierz - Vladimír
włókno - vlákno
włoski - italština
włos - vlas
Włoszka - Italka
wnętrze - interiér
woda - voda
Wodnik - Vodnář ; Vodnář
wodolot - křídlová loď, křídlový člun
wodór - vodík
wodospad - vodopád
Wojciech - Vojtěch
województwo - kraj
wojna trojańska - trojská válka
wojna - válka
wołacz - vokativ , pátý pád
wolfram - wolfram
Wołga - Volha
worek - pytel, vak
wrażenie - dojem
Wrocław - Vratislav , Wrocław
wrogi - nepřátelský
wróg - nepřítel
wrona - vrána
wrzesień - září
wschód - východ
wścibski - všetečný
wścieklizna - vzteklina
współczucie - soustrast , soucit
współpraca - spolupráce
wstyd - stud
wszak - přece
wtedy - tehdy
wtorek - úterý
wujek - strýc
wulkan - sopka , vulkán
Wulkan - Vulkán
wybierać - vybírat, volit
wybrać - vybrat, zvolit
Wybrzeże kość Kości Słoniowej - Pobřeží slonoviny
wybuchowy - výbušný
wychudzony - vyhublý
wycieraczka - stěrač
wydma - duna
wydra - vydra
wyjątek - výjimka
wyjec - vřešťan
wyjść po angielsku - zmizet po anglicku, prásknout do bot
wylać dziecko z kąpielą - vylít vaničku i s dítětem
wypadek - nehoda
wypełniać - vyplňovat
wypełnić - vyplnit
wyposażenie - zařízení
wyprzedaż - výprodej
wysoki - vysoký , vysoká , vysoké
Wyspa Bożego Narodzenia - Vánoční ostrov
wyspa - ostrov
Wyspa Świętego Wyspy Świętego Tomasza i Wyspa Książęca - Svatý Tomáš a Princův ostrov
wyspiarz - ostrovan
Wyspy Kanaryjskie - Kanárské ostrovy
Wyspy Marshalla - Marshallovy ostrovy
Wyspy Owcze - Faerské ostrovy
Wyspy Salomona - Šalamounovy ostrovy
wysyłać - posílat
wy - vy
wzdłuż - podle, podél
Yaren - Yaren
zabijać - zabít
zabójca - vrah
zabytek - památka
ząb - zub
zachód - západ
zachorować - onemocnět
zaćmienie - zatmění
Żagań - Záhaň
zagłada - vyhlazení
zagranica - cizina
Zagrzeb - Záhřeb
zaimek - zájmeno
zakaz - zákaz
zakładać - předpokládat
zakładka - záložka
zakochany - zamilovaný
zakonnica - matka , jeptiška
zakonnik - řeholník
żako - žako , papoušek šedý
zakręt - zatáčka
zaleta - klad
zalotka - kleštičky
żal - smutek, žal
zamach stanu - puč , převrat
Zambia - Zambie
zamek - hrad
zamężna - vdaná
zapalenie płuc - zápal plic
zapałka - zápalka, sirka
zapominać - zapomínat
zapomnieć - zapomenout
zaproponować - nabídnout, navrhnout
zaprosić - pozvat
zapytać - zeptat se
żarłok - žrout
żart - vtip , žert
zasmażka - jíška , zásmažka , zápražka
zasnąć - usínat
zaspa - závěj
zawodowy - profesionální
zawór bezpieczeństwa - pojistný ventil
zawsze - vždy, vždycky
zbawienie - spása
zbiornik - nádrž
zbór - sbor
zbrodnia katyńska - Katyňský masakr
zbyt - příliš
zdrowie - zdraví
zdrowy - zdravý
Żdżar nad Sazawą - Žďár nad Sázavou
zebra - zebra ; zebra
zebroid - zebroid
żeby - aby
Zefir - Zefyros
zegarek - hodinky
zegarmistrz - hodinář
zegar słoneczny - sluneční hodiny /
żelazomangan - feromangan
żelazo - železo
żelbet - železobeton
zespół napięcia przedmiesiączkowego - premenstruační syndrom
że - že
Zgierz - Zgierz
Zgorzelec - Zhořelec
zgubić - hubit
zięba - pěnkava
zielarstwo - bylinkářství
zielnik - herbář
Zielona Góra - Zelená Hora
zielony - zelený
Ziemia - Země
ziemniaczany - bramborový
ziemniak - brambor
zima - zima
Zimbabwe - Zimbabwe
zimny - studený
zimorodek - ledňáček říční
ziołolecznictwo - fytoterapie
Zjednoczone Emiraty Arabskie - Spojené arabské emiráty
złodziej - zloděj
złoto - zlato ; zlato
zmartwienie - starost
zmieniać - měnit
żmija - zmije
znajdować - nacházet; nacházet se
znajomy - známý
znakomity - skvělý
znaleźć - najít
znieść - zrušit
Zofia - Žofie, Sofie, Soňa
żołądek - žaludek
żółć - žluč
żółty - žlutý
żółw - želva
żona - žena
zoogeografia - zoogeografie
zostać - zůstat
z poważaniem - s pozdravem
z powrotem - zpět, zpátky
źródło - pramen
ZSRR - SSSR
zupa - polévka
zupełny - úplný
żurawina - brusinka
żuraw - jeřáb ; jeřáb
Związek Socjalistycznych Republik Radzieckich - Svaz sovětských socialistických republik
zwierzę - živočich , zvíře
żwir - štěrk
zwłoki - mrtvola
zwrotnica - výhybka
zwykle - obvykle
życie - život
żyć na wysokiej stopie - žít na vysoké noze
życzenie - přání
żydowski - židovský
żyd - žid
Żyd - Žid
żyła - žíla
żyletka - žiletka
Żylina - Žilina
żyrafa - žirafa
Żytawa - Žitava
z zamkniętymi oczami - se zavřenýma očima
