abazja - abasia
abdykować - abdicare
Abelard - Abaelardus, Abelardus
Abidżan - Abidjan
abituria - abitus
ablatyw - ablativus
aborcja - abortus , abortio|abortiō
Abraham - Abraham
absencja - absentia
absolucja - absolutio
absolut - absolutus
absolutny - absolutus
absolutorium - absolutorium
absolutyzm - absolutus
aceton - acetonum
acetylen - acetylenum
Adam - Adamus
adorować - adorare
adwena - advena
adwent - adventus
adwokat - advocatus
adwokat Boga - advocatus Dei
adwokat diabła - advocatus diaboli
adyton - adytum
afekcja - affectio
afektacja - affectatio
afekt - affectus
afektować - affectare
Afryka - Africa
agresja - aggresio; aggresio
akacja - acacia
akordeon - harmonica diductilis
aktorka - actrix
aktyn - actinium
akwedukt - aquae ductus
Akwileja - Aquileia
akwilejczyk - Aquileienses
akwilejski - Aquileiensis
Akwilon - Aquilo
Akwitania - Aquitania
Akwizgran - Aquisgranum
ale - autem
alegoria - allegoria
Aleksja - Alexia
alfabet - alphabetum , abecedarium
Alfred - Alfredus
algorytm - alrogithmus
aligator - aligator
alkan - alkanum
alken - alkenum
alkin - alkinum
alkoholizm - alcoholismus
Alojzy - Aloisio, Aloysius
Alzacja - Elisatia
Amadeusz - Amadeus
Ameryka - America
ameryk - americium
aminokwas - acidum aminicum
amlodypina - amlodypinum
amputacja - amputatio
Amu-daria - Oxus
Anastazja - Anastasia
anatomia - anatomia
Andaluzja - Vandalitia
Andrea - Andrea
Andromeda - Andromeda; Andromeda
Andrychów - Andrichovia
Andy - Andes
Anglia - Anglia
Aniela - Angela
ani - nec
Anioł - Angelus
Antananarywa - Antananarivo
Antares - Antares
Antarktyda - Antarctica
Antonia - Antonia
Antoni - Antonius
Antonina - Antonina
antykwariusz - antiquarius
Antyle Holenderskie - Antillae Nederlandenses
antymon - stibium , antimonium
Anzelm - Anselmus
Apeniny - Apenninus
Apia - Apia
Arabia Saudyjska - Arabia Saudiana
archanioł - archangelus
architraw - epistylium
areszt domowy - custodia libera
Arkadiusz - Arcadius
armia - vires , exercitus
arsen - arsenicum
arteria - arteria
aspiryna - Acidum acetylosalicylicum
astronom - astronomus
astronomia - astronomia
Asyria - Assyria
atawizm - atavismus
ateista - atheos
Ateny - Athenae
atrium - atrium
August - Augustus
aulos - aulus
auspicje - auspicium
Auster - Auster, Notus
Austria - Austria
Austro-Węgry - Austro-Hungaria
autor - autor
autyzm - autismus
Azerbejdżan - Adrabigania
azot - nitrogenium
Bachus - Bacchus
Badenia-Wirtembergia - Badenia-Virtembergia
bałwan - alveus
Baran - Aries; Aries
Baranek Boży - Agnus Dei
barchan - barcanus
bażant - Phasianus colchicus
Bazylea - Basilia
Beatrycze - Beatrix
beatyfikacja - beatificatio
befsztyk - caro costalis assa
belona - Belona belona
Beniamin - Beniaminus
Benin - Beninum
Beocja - Boeotia
berkel - berkelium
beryl - beryllium
bez- - in-, il-, im-, ir-
bez - sambucus; syringa; sine
Białoruś - Russia Alba
biały - albus, blancus, candidus
biały kruk - rara avis
Biblia - Biblia
biedronka - coccinella ; coccinella
biegać - currere
bieg - cursus
biernik - accusativus
biochemia - biochemia
bizmut - bisemutum
błagać - orare, implorare, deprecari, exorare, supplicare, comprecari, obsecrare
błaganie - invocatio
Błażej - Blasius
błędne koło - circulus vitiosus, circulus in demonstrando; circulus vitiosus, circulus in definiendo, idem per idem
bliski - arest
Bliźnięta - Gemini; Gemini
bluszcz - hedera , edera
błyskawica - fulgur
bób - faba ; faba
bóbr - castor
bóg - deus
Bóg - Deus
Bogu świeczka, a diabłu ogarek - uni sacrificio, ut prosit, alteri, ne noceat
bohr - bohrium
bojaźń - timor; timor
boleściwy - dolorosus
Bolonia - Bononia
bor - borum
borowik - boletus
Borys - Boris
braterstwo - fraternitas
brat - frater
Bratysława - Posonium
brawo - macte, macte animo, euge, poeta
brąz - aes ; aes
broda - barba
broda mędrcem nie czyni - barba non facit philosophum
brom - bromium
broń - telum|tēlum , ferrum , armum
brzmienie - sonus
brzoza - betula
brzuchomówca - ventriloquus
brzuch - venter
brzydki - foedus; turpis
brzytwa - novacula
budowla - exstructio
budynek - diaeta
buk - fagus ; fagus
bukowy - faginus, fagineus
bursztyn - glaesum , glesum , electrum , sucinum
butan - butanum
but - calceus
być - esse; adesse; esse
bydło - taurus; taurus
Byk - Taurus; Taurus
całować - basiare, osculari
cały - totus, omnis
c.b.d.o. - Q.E.D.
cebula - cepa
cecha - genus
cedr - cedrus ; cedrus
Cefeusz - Cepheus; Cepheus; Cepheus
celownik - dativus
cel uświęca środki - exitus acta probat
cenotaf - cenotaphium
centurion - centurio
cer - cerium
Ceres - Ceres; Ceres
cesarski - dominicus
cez - caesium
chaber piękny - Centaurea pulcherrima
chciwy - avidus, cupidus
chemia - chemica
Cheronea - Chaeronea
Cheroneja - Chaeronea
Chiny - Sina, Sinae
chleb - panis , pane
chlew - hara
chłodny - frigidus
chlor - chlorium
chlorek sodu - natrii chloridum
chlormetyna - chlormethinum
chmura - nubes /, nubis , nubs , nebula , nimbus , aer
choćby - ut, si, etsi, tametsi; denique, saltem, utque, dumtaxat; vel, velut, veluti
choinka - arbor natalicia
chomik - cricetus
chór - chorus
choroba - aegritudo
choroba von Willebranda - morbus von Willebrandi
chrom - chromium
cień - umbra
ciepło - calor
cieśń gardzieli - isthmus faucium
cieszyć - gaudere, laetari
ciężki - gravis
ciocia - matertera
ciotka - amita
cis japoński - taxus cuspidata
cis pospolity - taxus baccata
cis - taxus
citalopram - citalopramum
ćma - papilio
cnota - virtus
córka - filia
coś jest na wodzie pisane - in aqua scribis
co wolno wojewodzie, to nie tobie, smrodzie - quod licet Iovi, non licet bovi
cud - miraculum
cukier - saccharum
ćwiczenie czyni mistrza - repetitio est mater studiorum
ćwierćfinał - quarterfinalis
cyklofosfamid - cyclophosphamidum
cyna - stannum
cynk - zincum
cyprofloksacyna - ciprofloxacinum
cyrk - circus
cyrkon - zirconium
Cyryl - Cyrillus
cytryńcowate - Schisandraceae
cywilizacja - civilizatio
czarna dziura - gurges ater
czarna porzeczka - ribes nigrum
Czarnogóra - Mons Niger
czarnoskóry - ater, furvus, fuscus
czarny - ater, cacabatus, caccabatus, furvus, fuscus, morulus, niger, nigrans, nigricolor, piceus, picinus, pulleiaceus
czarny bez - ebulum , ebulus
czasownik - verbum
czas - tempus
czaszka - calva
czciciel - cultor
Czechy - Tzechia, Czechia, Bohemia
Czeczenia - Tsetsenia
czerwiec - Iunius
cześć - honor; salve, ave
część mowy - pars orationis
często - saepe
częsty - frequens
czkawka - singultus
człowiek człowiekowi wilkiem - homo homini lupus est
czwartek - dies jovis
czyściec - purgatorium
czysty - mundus
czytać - legere
dąb korkowy - suber
dach - tectum
Dagestan - Daghestania
daktyl - dactylus
Dalmacja - Dalmatia
Dania - Dania
darmsztadt - darmstadtium
dawca - dator
decyzja - decisio
de facto - de facto
definicja - definitio
Deimos - Dimos
dekret - decretum
dekspantenol - Dexpanthenolum
Delfin - Delphinus
delfin - delphinus , delphin ; Delphinus
demokracja - democratia
deportować - deporto
destrukcyjny - destructivus, calamitosus, damnosus, destructivus, exitiabilis, exitialis, exitiosus, fatifer, funestus, internecivus, mortifer, pemeptorius, perniciabilis, pernicialis, perniciosus, pestifer
deszcz - pluvia ; pluvia
diadem - diadema /
Diana - Diana; Diana
dieta - diaeta
dihydralazyna - dihydralazinum
Dionizos - Bacchus
długo - longe; diu
dłuto - caelum
DNA - DNA, ADN
dno - fundus
dobry - bonus
dobry wieczór - bonum vesperum
do greckich kalend - ad Kalendas Graecas
dojrzewanie - adolescentia
dokonany - perfectum
dokuczliwy - ater, atrox, niger, spinosus
dołek - fossa
domowy - domesticus
dom publiczny - lupanar
dopełniacz - genitivus
dopełnienie - obiectus
doszczętnie - funditus
do widzenia - ave, vale
dowódca - ductor , dux
drewniany - ligneolus|līgnĕŏlŭs, ligneus|līgnĕŭs
Droga Mleczna - Via lactea
dromader - dromas
druga wojna światowa - Bellum Orbis Terrarum II
drwina - dicterium
drzewo - arbor
dubn - dubnium
Duch Święty - Spiritus Sanctus
Dunaj - Danubius
dunajski - danubialis
dupa - culus, podex
dupek - culus
dusza - anima
dwoinka zapalenia płuc - streptococcus pneumoniae
dwutlenek węgla - carbonii dioxidum, dioxidum carbonis, dioxydum carbonis
dymić - fumare
dynia - cucurbita
dysk - discus
dysproz - dysprosium
dywan - tapes , tapete
działać - gerere
dzieciobójstwo - infanticidium
dzięcioł - picus, picumnus
dzielić - dividere
dzieło - opus
dzień - dies
dziesięciolecie - decennium
dziewica - virgo|virgō
dziewierz - levir
dzik - aper /
dziób - rostrum
dzisiaj - hodie
dżuma - pestis
dźwięk - sonus
Edyta - Editha
Egipt - Aegyptus
einstein - einsteinium
-ek - lus
ekologia - oecologia
ekonazol - econasolum
ekskomunika - anathema
ekskomunikować - excommunicare
ekstremalny - extremus
ekstremum - extremum
Elżbieta - Elisabetha
Emilia - Aemilia
encyklopedia - encyclopaedia
Eos - Eos , Aurora
epistoła - epistola
erb - erbium
Eris - Eris; Eris
esperanto - Esperanto
etan - ethanum
eten - ethenum , ethylenum
Etiopia - Aethiopia
etopozyd - ethoposidum, etoposidum
Etruria - Etruria , Hetruria
etruski - Etruscus, Hetruscus
etymologia - etymologia
etyn - ethinum , aethinum
Europa - Europa
europ - europium
Euros - Eurus
ewokacja - evocatio
ewokować - evocare
Ezdrasz - Esdra, Esdras, Esra
Ezop - Aesopus
falerno - Falernum , Falernus
fallus - phallus
famotydyna - famotidinum
fasola - phaseolus
fenek - vulpes zerda, fennecus zerda
ferm - fermium
figa - ficus /
figowiec - ficus /
Filip - Philippus
filozofia - philosophia
filozof - philosophus
Finlandia - Finnia
fiołek - viola
Florencja - Florentia
fluor - fluor
Focjusz - Photius
foka - phoca|phōcā
formoterol - formoterolum
fort - castellum
fortuna - fortuna ; fortuna
Francja - Gallia
frans - francium
fregata białobrzucha - Fregata andrewsi
fregata mała - Fregata ariel
fregata orla - Fregata aquila
fregata średnia - Fregata minor
fregata wielka - Fregata magnificens
fryzjerka - tonstrix
fryzjer - tonsor , tosor
funkcja - functio
furosemid - Furosemidum
gadolin - gadolinium
gad - reptile
gałąź - termes
gal - gallium
garb - gibba ; gibber ; gibbus
Gdańsk - Gedania , Dantiscum
gentamycyna - gentamicinum
Genua - Genua
geografia - geographia
geologia - geologia
german - germanium
Germania - Germania
gest - gestus , motus
g - g
gitara - cithara
gladiator - gladiator
gleba - terra
glin - aluminium
głód - fames , esuries , esuritio , inedia , ieiunium
Głogów - Glogovia
głos - sonus
Gniezno - Gnesna
gnój - fimum , fimus
gnu - connochaetes
godność - dignitas
gołąb - columba , columbus ''''
gołębi - columbinus
gołębnik - columbarium
goleń - crus
golić - tondeo
goniec - cursor , nuntius
góra - mons
gospodarz - erus
gówno - merda
gracz - lusor
gramofon - discophonum
gromada - grex; divisio, classis
gromadzić - cumulo, grego, adgrego, aggrego, congrego
grudzień - December
grusza - pirus
gruszka - pirum
gruźlica - tuberculosis
gryf - gryps , gryphus , grypus
Gryfice - Griphemberch
grzbiet - dorsum , spina
grzech - peccatum
grzmot - tonitrus , tonitruum
gwiazda - stella , astrum ; Myriostoma
hafn - hafnium
Hamilkar - Hamilcar , Amilcar
has - hassium
Hazdrubal - Hasdrubal , Asdrubal
Hefajstos - Hephaestus
hel - helium
Helios - Helius
hełm - cassida , cassis
heparyna - heparinum
herb - sigillum
heretycki - haereticus
hetman - regina
hiacynt - hyacinthus , hyacinthos
Hieronim - Hieronymus
hinduizm - hinduismus
hipopotam - hippopotamus
historia - historia
historyk - Rerum gestarum scriptor
Hiszpania - Hispania
hiszpanka - Morbus Hispanicus
holm - holmium
homar - locusta
homeopatia - homeopathia
Hongkong - Hongcongum
Horus - Horus
hybryda - hibrida , hybrida , ibrida
Hydra - hydra , excetra
idarubicyna - idarubicinum
idy - idus
i - et, at, atque, -que
igła - acus
ile - quot
imię - nomen
imiesłów - participium
imikwimod - imiquimodum
imipenem - imipenemum
imperium - imperium
ind - indium
inercja - inertia
infekcja - infectio
Inflanty - Livonia
influenca - influentia
informacja - informatio
ingrediencja - ingredientia
inkomodować - incommodare
inny - alius
insularny - insularis
insurekcja - insurectio
inteligencja - intelligentia
intencja - intentio
intensywny - amplus
internować - internus
interwencja - interventio
interwenient - interventio
interweniować - interventio
introspekcyjny - introspectus
inwencja - inventio
inwentaryzacja - inventarium
inwentarz - inventarium
inwokacja - invocatio
iperyt siarkowy - yperitum
ironia - ironia
iryd - iridium
iść - eo, ire, itum
istnieć - sum fui futurus
Itaka - Ithaca
itd. - etc.
iterb - ytterbium
itr - yttrium
jabłko - malum, -i
Jaćwież - Sudovia , Jatvesonia
ja - ego
jajko - ovum
jajo - ovum
jakkolwiek - utut, ut ut
jak Kuba Bogu, tak Bóg Kubie - qui dicit que vult, audit que non vult
Jakub - Iacobus, Iacomus
jałmużna - elemosina
jałowiec - iunipirus , iuniperus , cedrus
jama bębenkowa - cavum tympani , cavitas tympani
jama ustna - cavum oris
Jan - Ioannes
Japonia - Iaponia
jaskółka - hirundo , irundo
jaśmin - jasminum
jasny - clarus
jaszczurka - lacerta , lacertus
jęczmień - hordeum , ordeum ; hordeolus
jedlina - abies
jedność - unitas ; unitas
jej - sua
jelonek - Lucanidae ''lm f''
jelonek rogacz - Lucanus cervus
jemioła - viscum
Jerzy - Georgius
jesion - ornus
jesiotr - acipenser , acipenseris , acupenser , acupenseris
jeżeli - si
jeż - erinacaeus
jezioro - lacus
Jezus - Iesus
język - lingua
jeżyna - rubus
jidysz - lingua iudaeogermanica
jod - iodium
jodła - abies
jodłowy - abiegineus, abiegneus, abiegnus
Jowisz - Iuppiter; Iuppiter
Judea - Iudaea
juliański - Iulianus
jutro - cras
kabergolina - cabergolinum
kac - crapula
kadm - cadmium
kadzidło - incensum
Kair - Cairus
kąkol - lolium, Agrostemma
kalarepa - Brassica oleracea var. gongyloides; caulorapa
kalendarz - kalendarium
kalendy - Kalendae , Calendae
kaliforn - californium
Kalisz Pomorski - Nova Calisia
kalumnia - calumnia
Kamil - Camillus
kamyczek - calculus
Kanada - Canada
kandydat - candidatus , petitor
kangur - macropus
kania - milvus , miluus
kaptur - cucullus
karabin maszynowy - polybolum
karacena - corazina, coratina, coratium
karbunkuł - carbunculus ; carbunculus
kardamon - cardamomum
kark - collum
karmnik - Sagina
karygodny - culpabilis
kastrat - castratus
kaszleć - tussio
Katalonia - Catalonia
kataloński - catalana
katarakta - cataracta
katar - destillatio , catarrhus , rheuma
Katarzyna - Catharina
katastrofa - calamitas
katechumen - catechumenus
katoda - Cathodus , Kathodus
kaucja - cautio
kawa arabska - Coffea arabica
Kenia - Kenia
kiełbaska - hilla
kimeryjskie ciemności - Cimmeriae tenebrae
kiur - curium
kłamca - mendax, falsus, falsidicus
klatka piersiowa - thorax
Klaudia - Claudia
kłębek - glomus
klej - gluten
klęska - malum
klon - acer
klucz - clavis
kminek - cuminum|cumīnum
kmin rzymski - Cuminum cyminum
kobalt - cobaltum
kobiecy - femineus, femininus
kobieta - femina, -ae; mulier, -is
kochać - amare
kochanek - amator , adulter
kocioł - cortina
koc - tapes , tapete
kolano - genu
kołczan - corytos , gorytos , gorytus , pharetra
kolczasty - spineus, spinosus
kolekcjonować - colligere
kolendra - coriandrum
Kolonia - Colonia Agrippina
kolor - color
komar - culex
komórka - cellula
kończyć - finire
koń - equus , Equus caballus
konfraternia - confraternitas
koniczyna - trifolium
koniec - finis, exitus
konklawe - conclave
konsensus - consensus
konstelacja - constellatio
konwent - conventus
Kopenhaga - Hafnia
koper - anethum , anetum
koper włoski - Foeniculum vulgare
kora - cortex /
korek - cortex /, suber
korona - Fritillaria
Korona Południowa - Corona Australis
Kościerzyna - Costerina
kości zostały rzucone - alea iacta est
kość - os; talus , tessera
kos - merula
kosteczki słuchowe - ossicula auditoria
kostka - talus
kot - felis
kowadło - incus
Koziorożec - Capricornus
Krak - Cracus
Kraków - Cracovia
kręgosłup - columna vertebralis , spina
kret - talpa
krew - sanguis
krok - gressus , itus
królestwo - regnum
królewski - basilicus
królik - lepus
królowa - regina
król - rex
kropla - gutta , stilla
krótki - brevis
krowa - vacca
krtań - larynx
krucjata - expeditio sacra
kruk - corvus
krypton - krypton, crypton
krzem - silicium
Krzysztof - Christophorus
krzywonogi - valgus
krzyż - crux, -cis
ksenon - xenon
książę - princeps ; dux
książka - liber
Księga Rodzaju - Liber Genesis
księżyc - luna
Księżyc - Luna
kto pod kim dołki kopie, sam w nie wpada - incidit in foveam qui primus fecerat illam
kto - qui; qui
kto rano wstaje, temu Pan Bóg daje - aurora habet aurum in ore
kto szuka, ten znajdzie - Qui quaerit, invenit
kto z przyrodzenia głupi, i w Paryżu sobie rozumu nie kupi - quod natura non dat, Salmantica non praestat
Kubuś Puchatek - Winnie ille Pu
kukułka - cuculus
kulinarny - culinarius
kultura - cultura
kupować - emere
kuropatwa - perdix
kurulny - curulis
kwadryga - quadriga
kwantowy - quanticus
kwant - quantum
kwas mlekowy - acidum lacticum
kwas mrówkowy - acidum formicum
kwas węglowy - acidum carbonicum
kwestor - quaestor
kwiat - flos
kwiecień - Aprilis
kwietniowy - Aprilis
Łaba - Albis
łabędź - cycnus , olor
Łabędź - Cygnus
łabędzi - olorinus, cycneus
labirynt - labyrinthus
laboratorium - laboratorium
łaciński - latinus
Lacjum - Latium
ląd - terra
Ładysław - Ladislaus
lalka - pupa
lampart - pardus , panthera
lantan - lanthanum
laparoskopia - abdominoscopia
lapis lazuli - lapis lazuli
laseczka - bacillus
łasica - mustela
łaska - gratia
las - silva
łatwy - facilis
latynista - latinista
łechtaczka - clitoris
leczyć - curare
legion - legio
lękać się - timere
lękliwy - timidus
len - linum
lepszy - melior
lepszy wróbel w garści niż gołąb na dachu - est avis in dextra melior, quam quattuor extra; sola avis in cavea melior, quam mille volantes
lesisty - silvestris, silvester, silvosus
leśny - silvestris, silvester
leukocytoza - leucocytosis
Lew - Leo
lew - leo ; Leo
liczba mnoga - pluralis
liczny - multus
lilak - syringa
lipa - tilia
lipiec - Iulius
Lipsk - Lipsia
liść - folium
lis polarny - Alopex lagopus
listopad - November
lis - vulpes
litera - littera , litera
literatura - litterae
literówka - lapsus calami
lit - lithium
liza - lysis
Lizbona - Lisbonum
łódź - cumba, linter, alveus, cymba, paro, navis , navigium , puppis
łokieć - cubitus , cubitum
Londyn - Londinium
łono - sinus
loratadyna - loratadinum
lorens - lawrencium
losowy - fortuitus
łóżko - cubile
lucerna - cytisus /, cytisum
łucznik - sagittarius
ludzki - humanus
ludzkość - humanitas, mundus
łuk - arcus
lustro - speculum
łuszczyca - psoriasis unguium
lutet - lutetium
luty - Februarius
lwia część - pars leonina
lwica - lea
lwi - leonis
Lwów - Leopolis
łysy - calvus
machać - moveo
Maciej - Matthias
mądrej głowie dość dwie słowie - sapienti sat, dictum sapienti sat est
mądrość - sapientia
magiczny - magicus
magnez - magnesium
magnolia - magnolia
magnoliowate - Magnoliaceae
majestatyczny - augustus
maj - Maius
mąka - farina
mak - papaver
makrela - lacerta , lacertus
Mała Niedźwiedzica - Ursa Minor
malarstwo - pictura
malarz - pictor
Malezja - Malaesia
mało - parum
Małopolska - Polonia Minor
małpa - simia , simius
Malta - Melitta
mangan - manganum
Marcin - Martinus
Marek - Marcus
marmur - marmor , marmur
Mars - Mars ; Mars
martwy - mortuus
marzana - rubia
marzec - Martius
marzyć - somniare
masa - massa , materia , materies ; multitudo
maszyna - machina
matematyka - mathematica
matka chrzestna - commater
matka - mater
Mazowsze - Mazovia
męczyć - desudo, sudo
Mediolan - Mediolanum
meitner - meitnerium
Meksyk - Mexicum
melatonina - melatoninum
mendelew - mendelevium
menstruacja - menses
Merkury - Mercurius; Mercurius
męstwo - fortitudo
metan - methanum
metr kwadratowy - metrum quadratum
metronidazol - metronidasolum, metronidazolum
mężczyzna - vir, -i
mgła - nebula
mianownik - nominativus
miasto - urbs
miażdżyca - atheromatosis, atherosclerosis
Michał - Michaelus
mieć - habere
miecz - gladius
miedź - cuprum
Międzyrzec Podlaski - Meserici
miejscownik - locativus
miesiąc - mensis
mięsień - musculus
mięta - mentha
miłość - amor
ministra - ministra
miód - mel
miotła - scopa
miscellanea - silva rerum
miseczka - catillus
miska - catinus
mit - mythus
mleć - molo
mleko - lactus
młodość - iuventus
młody - iuvenis
mnogość - multitudo
Modena - Mutina
modlić się - orare
modliszka - mantis
modlitwa - preces , precatio
modrzew - larix /
Mojżesz - Moyses
mokry - udus, uvidus, madidus, umidulus, humidulus, umidus, humidus, umifer, humifer, umorosus, uvens, uvidulus, aquosus
molibden - molybdenum
mól książkowy - helluo librorum
moralność - moralitas
morderstwo - parricidium
Morze Bałtyckie - Mare Balticum
morze - mare , pelagus , pontus , fretum , fretus , salum , altum
Morze Śródziemne - Mare Mediterraneum
mosiądz - orichalcum
most - pons
motyka - sarculum , sarculus
motyl - papilio
moździerz - pila
mrówka - formica|formīca
mrównik - Orycteropus afer; Tubulidentata
msza - missa
mucha - musca
muchomor - amanita
mydło - sapo
mykeński - Mycenaeus, Mycensis
Mykeny - Mycena , Mycenae
mykoplazma - mycoplasma
my - nos
myśleć - cogito
myśliwy - venator
mysz - mus
naczyniak - angioma
naczyniak krwionośny - haemangioma, hemangioma
naczynie - vas|vās
naczyniowy - vascularis
naga prawda - nuda veritas
nagietek - caltha , calta ; caltha , calta
nagi - nudus
nagły - subitus
napar - infusio
napisać - scribere
napletek - praeputium
na przykład - ad exemplum, exempli gratia
nard - nardum , nardus /; oleum nardinum
nardowy - nardinus
narzędnik - instrumentalis
na świętego Dygdy - Ad Kalendas Graecas
nasz - noster
naszyjnik - monile
natura - natura
natychmiast - actutum
nauczyciel - magister
nauka - scientia
nazywać - appellare, dicere
neandertalczyk - Homo neanderthalensis /, Homo sapiens neanderthalensis /
Neapol - Neapolis
negować - nego
neodym - neodymium
neon - neon; ''niektóre'' Paracheirodon
neptun - neptunium
Neptun - Neptunus
Nicea - Nicaea
nić - filum
nic - nihilum ; nil , nihil
niebieski - caeruleus
niebo - coelum
niedobiałczenie - hypoproteinaemia
niedokonany - imperfectum
niedokrwistość - anaemia
niedokrwistość złośliwa - anaemia perniciosa
niedziela - dies Solis, dies Dominica
niedźwiedzica - ursa
niedźwiedź polarny - ursus maritimus
niedźwiedź - ursus
Niemcy - Germania
nie - non
nieśmiało - timide
niewolnik - famulus
nie wszystko złoto, co się świeci - non omne quod nitet aurum est
niewybaczalny - inveniabilis
niewydolność - insufficientia
nigdzie - nusquam
nikczemny - abiectus, contemptus, vilis
nikiel - niccolum
Nikodem - Nicodemus
ni - nu
niob - niobium , columbium
nobel - nobelium
noc - nox ''f nom.'', noctis ''gen.''
nony - nonae
nornica - clethrionomys
nosorożec - rhinoceros
Nowa Fundlandia - Terra Nova
Nowa Zelandia - Nova Zelanda
nów - interlunium
nowotwór - neoplasma
nowotworowy - neoplasmaticus
nowy - novus
nóż - culter
np. - e.g.
numer - numerus
numerować - numerare
nuncjusz - nuncius
obraz - pictura ; pictura
obrona - defensio
obwiniać - condemno, damno
ocean - Oceanus
odcisk palca - digiti signum
oddział - ordo
odkupiciel - redemptor
odpowiedzialność - auctoritas
Odra - Viadrus
odtąd - inde
odwaga - fortitudo|fortitūdō , virtus , audentia
ofiara - anathema
ofiarny - sacrificalis|sacrificālis
ogień - ignis
ognie świętego Elma - corpus sanctum
ogon - cauda , coda
ogórek - cucumis
ojciec - pater, patris
ojczenasz - paternoster
Ojcze nasz - Pater noster
ojczyzna - patria
ok. - ca.
okno - fenestra
oko - oculus
oko za oko, ząb za ząb - oculum pro oculo, dentem pro dente
określenie - significatio
okrytonasienne - Magnoliophyta
okupacja - occupatio
olejek eteryczny - oleum aethereum , oleum aetherium
ołów - plumbum
ołtarz - altaria , ara
omocznia - allantois
ona - ea
ontologia - ontologia
opłakiwać - doleo, collacrimo, lacrimo, deploro, lamentor, delamentor, plango, deplango, eiulo
opłatek - oblata
oprócz - extra
optymalny - optimus
orbita - orbita , gyrus
orzeł - aquila
Osaka - Osaca
osierdzie - pericardium ; saccus pericardiacus
osierdziowy - pericardiacus, pericardialis
osioł - asinus, asellus
osm - osmium
osoba - persona
ostateczny - peremptorius, peremtorius; ultimus
ostrożny - cautus
ostrze - lamina
oszczep - sparus
oszust - fraudator
oszustwo - fraud
owacja - ovatio
owca - ovis
owoc - fructus
pacyfikacja - pacificatio
Pad - Padus
pająk - aranea
pajęczyna - aranea , araneum
pałeczka - coccobacillus; Tulostoma
Palermo - Panormus
palimpsest - palimpsestus
pallad - palladium
pan - dominus , erus ; dominus , erus ; dominus , erus
Pan - Dominus ; Pan , Faunus
pani - domina ; dea
Panna - Virgo
papieros - sigarellum, fistula nicotiana
papież - papa , pater
paproć - filix , filex
papuga - psittacus ; psittacus
Parys - Paris; Paris
Paryż - Parisium, Lutetia
pasierbica - privigna|prīvigna
pasierb - privignus|prīvignus
pasożyt - parasitus
pasza - cibaria , cibus , pabulum , pastus , caballatio '''', capitum '''', capetum ''''
patrzeć - spectare, specere
Paweł - Paulus
październik - October
paznokieć - unguis
pchła - pulex , pulix
pefloksacyna - pefloxacinum
Pekin - Pechinum , Pecinum
Pełczyce - Arcto-Lithanus
pelikan - pelecanus
penis - penis , sopio , sopitio , mentula , cauda , coda
pentan - pentanum
pępek - umbilicus
per capita - per capita
perła - margarita
Persja - Persia
perswadować - persuadere
pewność - certitudo
piątek - dies Veneris
pić - bibo; bibo
pieczarka - Agaricus campestris
pieczęć - signaculum, sigillum
piękny - bellus
pieniądze nie śmierdzą - pecunia non olet
pieniądz - pecunia
pień - truncus
pieprzyca siewna - Lepidium sativum L.
pierdolić - futuere
pierścień - anulus
pierwotniak - protozoon
pies - canis
pieśń - carmen
pijak - potor ; potor
pijany - ebrius, udus, uvidus, madidus, crapulatus, deebriatus, ebriacus, mattus, matus, merulentus, potus, temulentus, vinolentus, vinulentus, vinosus; ebrius, potor
pijawka - sanguisuga , hirudo
piosenkarz - cantor
pirat - pirata
pisać - scribere
piwo - cervisia, cerevisia
piżama - paiama
pizza - placenta compressa; placentula
płakać - lacrimare
planeta - planeta
plansza - abacus
pląsawica - chorea
Platon - Plato
platyna - platinum
plebiscyt - plebiscitum
płeć - sexus
płuco - pulmo
pluton - plutonium
Pluton - Pluto ; Pluto
płyn - liquor|lĭquŏr
płynny - liquidus
płyta główna - tabula materna
p.n.e. - AC
pocałunek - basium , osculum
pochwa - vagina
pocić się - desudo, sudo; desudo, sudo
pocisk - telum|tēlum , sagitta
poczwarka - pupa
podeszwa - solea ; planta
Podlasie - Podlachia
podniebienie - palatum
poduszka - pulvinus
podwładny - servus; satelles
pojazd - vehiculus
pojedynczy - simplex
pokój - pax ; pax ; pax ; cella
pokrzewka - Sylvia
pokrzywa - urtica
polityka - politica
północny - boreus
polon - polonium
Polska - Polonia
polski - polonicus; polonice
południk - meridianus
półwysep - paeninsula
pomieszczenie - diaeta
pomoc - auxilium
Pompa - Antlia
poniedziałek - odmiana klasyczna dies Lunæ, dies lunae; odmiana ludowa lunæ dies; odmiana kościelna secunda feria
ponieważ - quia, quod, quoniam, cum, propter
ponton - ponto
ponury - ater, atrox, furvus, niger, nigrans
poronienie - abortus
port - portus
Portugalia - Lusitania
porzeczka - ribes
posiłek - cena
pospolity - vulgaris
postać literacka - homo fictus
postęp - progressio
post - ieiunium ; ieiunium
potas - kalium
potaż - potassa
potępiać - condemno
potomstwo - progenies
potop - eluvies , eluvio
potwierdzić - affirmare
powieszenie - suspensio
powietrze - aer
powodować - inducere, inferre
powódź - diluvium , inundatio
powszedni - cotidianus
powtarzać - repetere, iterare
powtarzanie jest matką wiedzy - repetitio est mater studiorum
poza - extra
poziomka - fragum ; fraga
Poznań - Posnania
pozorny - mendax
praca - labor
prącie - penis ; membrum virile
Praga - Praga
prawda - veritas
prawdziwych przyjaciół poznaje się w biedzie - amicus certus in re incerta cernitur
prawnik - curialis
prawo jest po to, aby je omijać - inventa lege, inventa fraude
prawo - lex , ius
prawo pierwszej nocy - ius primae noctis
prawo publiczne - ius publicum
prawowity - iustus
prazeodym - praseodymium
pręcik - stamen
prewencja - praeventio
prezydent - praesidens, praeses
proletariusz - proletarius
promet - promethium
prom - ponto
propan - propanum
propen - propenum
propylen - propylenum
propyn - propinum , methylacetylenum
prorok - haruspex
prosić - rogare
prosto - simpliciter
protaktyn - protactinium
proweniencja - proveniens, provenientis
prowokator - provocator
prowokować - provocare
Prusy - Borussia, Prutenia, Prussia
prymaria - primaria
prymas - primaria
prym - primus
pryskać - aspergo, conspergo, contingo, exspergo, respergo, spargo
przeciwciało - anticorpus
przegroda nosowa - septum nasi
przepiórka - coturnix coturnix
przestraszyć - terrere, perterrere, horrificare, exanimare, exterrere, consternare
przestrzeń - spatium ; locus
przewlekły - chronicus
przewodnik - ductor , dux
przodek - abavus
przy - apud
przybity - fractus, demissus
przychodzić - adventus
przydział - cibaria
przyimek - prepositio
przyjaciółka - amica
przyjemność - voluptas
przykład - exemplum
przymiotnik - adiectivus
przyroda - natura
przysadka mózgowa - hypophysis, glandula pituitaris
przysłówek - adverbium
przysłowie - adagium
psowate - Canidae
pszczoła - apis
pszenica - triticum
Ptah - Phthas
ptak - avis
publiczny - publicus
puls - pulsus
puma - puma concolor
purpurowy - purpureus
pusty - vacuus, inanis, vanus, vastus
rachatłukum - lucumium
rączka - manubrium
r. - AD; AUC
radon - radon
rad - radium
radzić - consilior; consulo
Rak - Cancer
ramię - umerus , humerus
razem - simitu
ręcznik - mantele
ręka - manus
rekin - squalus
Remigiusz - Remigius
renowacja - renovatio
ren - rhenium
Ren - Rhenus
reprymenda - reprehensio
Republika Federalna Niemiec - Respublica Foederalis Germanica
rewokować - revoco
robić - facio, ago
robić z igły widły - elephantum ex musca facere
rod - rhodium
rodzinny - familiaris
roentgen - roentgenium
róg obfitości - cornu copiae
rok - annus
rokitnik - hippophae
rok przestępny - annus bissextus
ropień - abscessus
ropucha - bufo
rotunda - tholus
równanie - eaquatio
również - quoque
równość - aequalitas
róża - rosa
rozdepka dunajska - Theodoxus danubialis
rozdrażnienie - irritatio
rozdzielać - dividere
rozmaryn - rosmarinus
rozmyślać - reputare
różowy - roseus
rozumieć - intelligere, intellegere, sapere
rozwaga - considerantia
rozwielitka - Daphnia
rtęć - hydrargyrum
rubid - rubidium
ruch - motus ; motus
ruchomy - mobilis
Rudolf - Rudolphus
rufa - puppis
ruta - ruta
ruten - ruthenium
rutherford - rutherfordium
rybak - piscator
ryba - piscis
Ryby - Pisces
rycerz - eques
rynek - emporium ; mercatus
ryś - lynx
rytualny - ritualis
rzadki - rarus
rzadko - raro
rząd - ordo
rządzić - regere, regnare
rzeczny - fluviālis
rzeczownik - nomen
rzeczownik odczasownikowy - gerundium
rzecz - res|rēs
rzeczywistość - realitas
rzekłem - dixi
Rzeszów - Resovia
rzeszowski - resoviensis
rzeżucha - Cardamine L.; Lepidium sativum L.
Rzym - Roma
Sabina - Sabina
samar - samarium
sandał - crepida
sanktuarium - sanctuarium
Sardynia - Sardinia
sarkopenia - sarcopaenia
Saturn - Saturnus; Saturnus
schyłek - finis, exitus, terminus
Scylla - Scylla
seaborg - seaborgium
sękaty - geniculosus, geniculatus, nodabilis, nodosus
seks oralny - coitus oralis
Sekwana - Sequana
selen - selenium
seler - apium
senator - senator
sen - somnus
sepulka - sepulca
sepulkowate - Sepulcidae
serdeczny - cordialis
serio - serio|sēriō
Sewilla - Hispalis
siarka - sulfur , sulphur , sulpur
sieć - rete , tenus ; aranea , casses
sierpień - Augustus
sikać - meio
sikora modra - Cyanistes caeruleus, Parus caeruleus
sikora - parus
siła - fortitudo
siła wyższa - vis maior
Silesia - Silesia
siostra - soror
Skałosz - Petrus
skand - scandium
skarb - thesaurus
skop - vervex
skóra - corium
skorpion - scorpio
Skorpion - Scorpius
skowronek - alauda
skroń - tempus ; tempora
skunks - mephitis
Śląsk - Silesia
śledź - clupea harengus
śledziona - lien
ślimak - gastropus , coclea , cochlea
ślina - saliva|salīva
slipy - parvum subligaculum
śliwa - prunus
śliwka - prunum
słońce - sol
Słońce - sol
słonecznik - Helianthus
słoneczny - solaris; apricus
słoń - elephantus , barrus , elephas
słowacki - slovachus
słowik - luscinia
słowik rdzawy - Luscinia megarhynchos
słownik - dictionarium
słowo - vocabulum , verbum
Słupsk - Stolpe
służący - famulus
śmiałym szczęście sprzyja - audaces fortuna iuvat
śmieć - purgamen, purgamentum
śmierć - mors
śmiertelny - mortifer; mortalis
smok - draco
smutny - ater, atratus, niger
śnieg - nix
śnieżka - Montifringilla nivalis
sobota - dies Saturni
socjologia - sociologia
soczewica - lens
sód - natrium , sodium
sokół - falco
sokolnik - falconarius
sok - sucus
sperma - semen
śpiący - somniosus, veternosus
śpiewak - cantor
śpiew - cantus
spisek - coniuratio
spokojny - inturbidus, quietus, humanus, lentus, sedatus; abstinens
spór - controversia
sprawiedliwość - iustitia
sprzedawać - vendere
sprzedawca - venditor
srebrny - argenteus
srebro - argentum
Sri Lanka - Sri Lanca
środa - dies Mercurii
śródręcze - metacarpus
sroka - pica
stąd - inde
stadion - stadium
stado - armentum , pecus , grex /
stal - chalybs , adamas
Stanisław - Stanislaus
Stany Zjednoczone - Respublicae Unitae, Respublicae Unitae Americae
Stargard Szczeciński - Stargardia
starożytny - antiquus
staruszka - anus
starzec - senex
staw kowadełkowo-młoteczkowy - articulatio incudomallearis
staw krzyżowo-biodrowy - articulatio sacroiliaca
staw skroniowo-żuchwowy - articulatio temporomandibularis
Stefan - Stephanus
Stolica Apostolska - sedes apostolica
stolica - caput
stół - mensa
stopa - pes
stopień najwyższy - superlativus
stopień wyższy - comparativus
stosunek płciowy - actus sexuales
stosunek przerywany - coitus interruptus
straszny - ater, atrox, furvus, niger, nigrans
strażak - vigil ignis
streszczać - abbreviare
strona bierna - passivum
strona czynna - activum
stront - strontium
struktura - structura
strzała - sagitta
strzelec - sagittarius
Strzelec - Sagittarius
strzemiączko - stapes
stulejka - phimosis
stwardnienie rozsiane - sclerosis multiplex
styczeń - mensis Ianuarius, Ianuarius
subwencja - subventio
suka - canicula
sum - silurus
sutek - papilla
swastyka - crux gammata , svastica ; crux gammata , svastica
światło - lux , lumen ; lumen
światłowstręt - photophobia
świat - mundus
świątynia - templum
świerk - picea
świetny - splendidus, praeclarus
świnia - porcus , sus
świstak - marmota
swój - suus
syn - filius
sypialnia - cubiculum
szafka - cista
szampon - capitilavium
szarańcza - locusta
szczaw - rumex
Szczecinek - Nova Stetin&lt;ref&gt;Jadwiga Karwasińska, Ignacy Zakrzewski: Lites ac res gestae inter Polonos Ordinemque Cruciferorum. T. 3. Sumptibus Bibliothecae Cornicensis, 1935, ss. 185, 254.&lt;/ref&gt;
Szczecin - Stetinum, Scecinum
szczęśliwy - felix
szczur - mus, ''nazwa naukowa:'' rattus, Rattus norvegicus
szerokość geograficzna - latitudo
szerszeń - crabro
szewc - sutor
szew - sutura; sutura
szkielet - skeleton
szkliwo - enamelum
szkło - hyalus , vitrum
szlachetny - nobilis
szop - procyon
szron - pruina
sztuka - ars
Szwabia - Suebia|Suēbĭa
Szwajcaria - Helvetia
Szwecja - Suecia
Szydłowiec - Shidloviecz
szyja - collum
szyjka macicy - cervix uteri
szynszyla - chinchilla
szynszyla mała - Chinchilla lanigera
tablica rejestracyjna - nota autocineti
ta - ea
tafa - phascogale tapoatafa
tajemnica - secretum, arcanum
tak - sic
talasemia - thalassaemia
talerz - catinus
tal - thallium
tamtędy - eadem
tantal - tantalum
Tantal - Tantalus
tarcza - scutus , scutum
tchawica - trachea
teatr - theatrum
technet - technetium
Tekla - Thecla
tekst - scriptum
Telesfor - Telesphorus
tellur - tellurium
Teofania - Theophania
Teofan - Theophanes
teologia - theologia
terb - terbium
teren - humus
termometr - thermometrum
testament - testamentum
tętnica szczękowa - arteria maxillaris
tj. - ie.
tkanka - textum , tela
tkanka tłuszczowa - textus adiposus
tlenek węgla - monoxidum carbonii, monoxidum carbonis
tlen - oxygenium
to - id; id
Tomasz - Thomas
topaz - chrysolithos
torebka - theca
tor - thorium
trąd - lepra
tramadol - tramadoli hydrochloridum
trebusz - tripantium
triumf - triumphus
tron - thronus , sedes
trunek - temetum|tēmētum
truskawka - fragaria
tryb łączący - coniunctivus
tryb orzekający - indicativus
tryb przypuszczający - conditionalis
Trzebiatów - Treptow
trzeźwy - sobrius
trzoda - armentum , pecus , grex /
tu - hic
tukan tęczodzioby - Ramphastos sulfuratus
tulipan - tulipa
tul - thulium
tuńczyk - thynnus , thunnus
Tunezja - Tunesia
turkusowy - callainus
Turyn - Taurinum
tuż - paene, fere
twój - tuus
twórca - effector
tygrys - tigris
tylko - solum, solummode
tył - puppis
Tymon - Timon
typografia - typographia
tytan - titanium
ty - tu
Tytus - Titus
ubierać - vesto
ubiór - vestimenta
ucho - auricula ; auris
ucho środkowe - auris media
ucho wewnętrzne - auris interna
uczta - cena
udawać - imitor
udziec - crur
układ okresowy pierwiastków - periodicum systema elementorum chemicorum
ulica - via, vicus
umarł król, niech żyje król - Augustus mortuus est, habemus novum Augustum!
umierać - mori
umowa - contractus
Unia Europejska - Unio Europæa
ununbium - ununbium
unununium - unununium
uprawa - cultivatio
Uranos - Uranus, Caelus
uran - uranium
uraz - vulnus
uśmiechać się - subridere
usta - os
ustny - oralis
uzasadniać - iustificare
Waga - Libra
waga - statera
walczyć - bellare
walec - cylindrus
wanad - vanadium
wapń - calcium
waran - varanus
Warszawa - Varsovia
warszawski - Varsoviensis
warunek konieczny - conditio sine qua non
warzywo - olus , holus
wasz - vobis
wątpić - dubitare, haesitare, ambigere
wątpliwość - dubium, dubitatio, dubietas
wątroba - iecur
Watykan - Civitas Vaticana ; Mons Vaticanus
wąż - serpens , , anguis , , coluber , colubra
wchodzić - venire
wczoraj - heri, here
wdowa - vidua, ae
węgiel - carbonium
wehikuł - vehiculum
wełna - lana
wena - vena
Wenezuela - Venetiola
Weronika - Veronica
Wesołych Świąt - felix dies Nativitatis; Natale hilare; Lorem Nativitatis
Westa - Vesta
weto - veto
węzeł chłonny - nodus lymphaticus
Wezuwiusz - Vesuvius
wiatr - ventus
wiciokrzew przewiercień - caprifolium
widzieć - videre
widz - spectator
Wiedeń - Vindobona
wielbłąd - camelus
Wielka Brytania - Britannia
Wielka Niedźwiedzica - Ursa Maior
Wielkanoc - Pascha, Festa Paschalia
wielki - magnus
Wielkopolska - Polonia Maior
wierność - fidelitas
wieś - rus, pagus
wieża - turris
Wikipedia - Vicipaedia
Wikisłownik - Victionarium
Wikiźródła - Vicifons
wilczyca - lupa
wilgotny - udus, uvidus
wilk - lupus
Wilno - Vilna
wina - culpa
Wincenty - Vincentius
winny - culpabilis, culpatus
wino - vinum , vinus
wioślarz - remex
wiosło - remigium , remus , tonsa , palmula
Wisła - Vistula
wiśnia - cerasus
Wit - Vitus
władca - erus , regnator
Władysława - Wladislava
Władysław - Wladislaus
władza - auctoritas, dicio
właściwość - proprietas
Włochy - Italia
Włocławek - Vladislavia
Włodzimiera - Wladimira
Włodzimierz - Wladimirus
włos - capillus
w międzyczasie - interibi
wnuczka - neptis
wnuk - nepos
woda - aqua
Wodnik - Aquarius; Aquarius
wodór - hydrogenium
wodospad - aquae cadentes, deiectus aquae, deiectus
Wojciech - Adalbertus
wojenny - bellicus
wojna - bellum
wojskowy - militaris; miles
wokanda - vocanda
wołacz - vocativus
wół - bos
Wolfgang - Wolfgangus
wolfram - wolframium
wosk - cera
wrażenie - pulsus
Wrocław - Wratislavia , Vratislavia
wróg - hostis , inimicus
wrogi - ater, atrox, inimicus, iniquus, niger
wrona - cornix
wrzeć - inferveo, invervesco
wrzesień - September
wrzód - ulcus
wschodni - orientalis
wschód - oriens ; oriens
wschodzić - oriri
wścieklizna - rabies
wszystko - omnis
wtorek - dies Martis
Wulkan - Vulcanus
w - w; in
wybrzeże - maritimus, litus, ora
wydziedziczyć - exheredo
wygrywać - vincere
wyjść - exire
wykałaczka - dentiscalpium ; lentiscus , lentiscum '''', spina , spicna , spica , spinus ; frondea cuspis ''''
wyrak - Tarsius
wyrostek soczewkowaty kowadełka - processus lenticularis
wysoki - altus; arduus
wyspa - insula
Wyspa Świętego Wyspy Świętego Tomasza i Wyspa Książęca - Insulae Sancti Thomae et Principis
wy - vos
ząb - dens
zabraniać - prohibeo
zachodni - occidentalis
zachód - occidens , occasus
zaćma - cataracta
zaćmienie - eclipsis
żądło - aculeus
Żagań - Saganum
zagraniczny - exter
zaimek - pronomen
zając - lepus
zakażenie - infectio
zakonnica - monacha
zakonnik - monachus
żako - Psittacus erithacus
załącznik - additamentum
żal - luctus
żałobny - ater, atratus, niger; ater, atratus, niger
zamek - castellum , castrum
zamojski - Zamoscensis
Zamość - Zamoscia
zapalenie płuc - pneumonia
zapalenie skóry - dermatitis
zapowiedź - nuntius
żartować - iocor, ioculor
zawiły - spinosus
zazdrośnik - zelotes
zbiór - grex /
zbrodnia - facinus, scelus
z - cum
zdolny - potens; ingeniosus
zdrowie - salus
żebrak - mendicabulum, mendicus, aeruscator
Zefiryna - Zephyrina
Zefiryn - Zephyrinus
Zegar - Horologium
zegar słoneczny - horologium solarium , solarium
żeglarz - nauta
żelazo - ferrum , chalybs
Zenobia - Zenobia
Zenobiusz - Zenobius
Zenon - Zeno
zespół kanału nadgarstka - syndroma isthmi canalis carpi
zewsząd - undique
zielnik - herbarium
ziemia - terra
Ziemia - Terra
zima - hiems
zimorodek - alcedo , alcyon , halcyon
złośliwy - ater, atrox, niger
złoto - aurum ; aurum
złoty środek - aurea mediocritas
zmiana - cambiatio
zmieniać - mutare
żmija - vipera , aspis
znajdować - adesse
znany - notus, cognitus
Zofia - Sophia
żołądek - stomachus
żółć - bilis
żółty - flavus
żółw - testudo
żona - uxor
żongler - ventilator
Zozym - Zosimus
zręczny - habilis
źródlany - fontanus
źródło - fons; radix
zrywać - tondeo
zupa - ius
zupełny - integer
zwierzę - animal , bestia
zwyciężać - vincere
zwycięzca - victor
życie - vita
Zygfryd - Sigfridus
Zygmunt - Sigismundo
żyła - vena
żylistek - deutzia
żyrafa - giraffa , camelopardalis
zysk - faenus , fenus
Zyta - Zita
