1. - &amp;rlm;1־טער
abażur - אַבאַזשור
abdykować - אַבדיקירן
abiturient - אַביטוריענט , גראַדואַנט
abonent - אַבאָנענט
aborcja - אַבאָרט
Abraham - אבֿרהם , אַבֿרם
Abramczyk - אַבראַמטשיק
absolutny - אַבסאָלוט
absolwent - אַבסאָלווענט
absorpcja - אײַנזאַפּונג , אַבסאָרבירונג
absurd - אַבסורד
Adam - אָדם
adiutant - אַדיוטאַנט
administracyjny - אַדמיניסטראַטיוו
administrator - אַדמיניסטראַטאָר
administrować - אַדמיניסטרירן
admirał - אַדמיראַל
adopcja - אַדאָפּטירונג
adresat - אַדרעסאַט
adres - אַדרעס
adwokat - אַדוואָקאַט
afisz - אַפֿיש ,פּלאַקאַט
aforyzm - אַפֿאָריזם , גלײַכווערטל
afrykanerski - אַפֿריקאַנס , אַפֿריקאַנעריש
Afrykanin - אַפֿריקאַנער
afrykański - אַפֿריקאַניש
agat - אַגאַט
agent - אַגענט ; אַגענט ; אַגענט
agrafka - אַגראַפֿקע
agresja - אַגרעסיע
agresor - אַגרעסאָר
agrest - אַגרעס
aj waj - אוי וויי!&amp;rlm;
akacja - אַקאַציע
akademicki - אַקאַדעמיש
akademik - אַקאַדעמיקער
akcja - אַקציע ; קאַמף
akordeon - האַרמאָניע
aksamit - סאַמעט
aksjomat - אַקסיאָם
aktorka - אַקטריסע
aktor - אַקטיאָר
akt urodzenia - געבוירן־אַקט
aktyn - אַקטיניום
akt - אַקט
akuszeria - אַקושעריע
akuszerka - אַקושערקע , הייבאַם
akwarium - אַקוואַריום
aleja - עוועניו , שפּאַליר
alergia - אַלערגיע
alfabet - ''alfabet łaciński:'' אַלפֿאַבעט ; ''alfabet hebrajski:'' אַלף־בית
alfabetyczny - אַלפֿאַבעטיש
alimenty - אַלימענטן
alkoholik - אַלקאָהאָליקער
alkoholowy - אַלקאָהאָליש
alkohol - אַלקאָהאָל
alkowa - אַלקאָווע
altruizm - אַלטרויִזם
alt - אַלט ; אַלט ; אַלט ; אַלט
ambasada - אַמבאַסאַדע
ambicja - אַמביציע
ambulans - אַמבולאַנס
Amerykanin - אַמעריקאַנער
amerykanizm - אַמעריקאַניזם
amerykański - אַמעריקאַניש
amnestia - אַמנעסטיע
amputacja - אַמפּוטירונג
amputować - אַמפּוטירן
amulet - שמירה
analfabeta - אַנאַלפֿאַבעט
ananas - אַנאַנאַס
anarchia - אַנאַרכיע
anegdota - אַנעקדאָט
anegdotyczny - אַנעקדאָטיש
angielski - ענגליש
anglosaski - אַנגלאָסאַקסיש
animacja - אַנימאַציע
anioł - מלאך
Antares - אַנטאַרעס
antonim - אַנטאָנים
antyczny - פֿאַרצײַטיק
antyk - אַנטיק
antysemicki - אַנטיסעמיטיש
antysemita - אַנטיסעמיט
antysemityzm - שׂינאת־ישׂראל
apetyt rośnie w miarę jedzenia - דער אַפּעטיט קומט מיטן עסן
apetyt - אַפּעטיט
apologia - אַנטשולדיקונג , התנצלות
apostazja - פֿעלטשונג ; zobacz też: שמד
aprobata - הסכּמה
aptekarstwo - אַפּטייקערײַ
aptekarz - אַפּטייקער
apteka - אַפּטייקקראָם , אַפּטייק
arabski - אַראַביש ; אַראַביש
arbiter - אַרביטער , שליש
arbitralny - אַרביטראַריש
arbuz - אַרבוז
archanioł - אַרכאַנגל
archeologia - אַרכעאָלאָגיע
arcybiskup - אַרציביסקופּ
arcydzieło - מײַסטערווערק
aria - אַריע
Arizona - אַריזאָנאַ
Arka Noego - תּיבֿה
Arkansas - אַרקאַנסאָ
arka - תּיבֿה ; אָרון
armia - אַרמיי
arteria - אַרטעריע ; מאַגיסטראַל
artykuł - אַרטיקל
artystyczny - קינסטלעריש
-arz - ער
asfalt - אַספֿאַלט
aspekt - פּרט , אַספּעקט
aspiryna - אַספּירין
astma - אַסטמע
astronomia - אַסטראָנאָמיע
astronomiczny - אַסטראָנאָמיש
astronom - אַסטראָנאָם
ateista - אַטעיִסט , כּופֿר־בעיקר
ateizm - אַטעיִזם
atłas - סאַטין
atomowy - אַטאָמיש
atom - אַטאָם
atrament - טינט
audytorium - אוידיטאָריע
Australia - אויסטראַליע
Australijczyk - אויסטראַליער
australijski - אויסטראַליש
austriacki - עסטרײַכיש
Austria - עסטרײַך
autobiografia - אויטאָביאָגראַפֿיע
autobus - אויטאָבוס
automat - אויטאָמאַט
autonomia - אויטאָנאָמיע
autor - אויטאָר
auto - אויטאָ
awizo - אַוויז
Azerbejdżan - אַזערבײַדזשאַן
Azja Mniejsza - קליינאַזיע
Azja - אַזיע
baba - באַבע ; באַבקע
babcia - באָבע
bach - באַך
bać się - מורא האָבן
bączek - דריידל
bagażnik - באַגאַזשניק
bagaż - באַגאַזש
bagno - זומפּ
bajgiel - בייגל
bakteria - באַקטעריע
bałagan - באַלאַגאַן
bałałajka - באַלאַלײַקע
bałamucić - באַלעמוטשן
balia - באַליע
balkon - באַלקאָן
balon - באַלאָן , לופֿטבאַלאָן
bałwan - באַלוואַן
bambus - יאַמש
banan - באַנאַן
bandaż - באַנדאַזש
bańka - קאַנע
banknot - באַנקנאָט
bank - באַנק
baranina - שעפּסנס
Baran - באַראַן ; באַראַן
baran - באַראַן , ווידער
Barcelona - באַרצעלאָנע
bardzo - זייער
bark - אַקסל
bar - באַר ; באַר ; באַריום
basen - שווימבאַסיין ; באַסיין
batalion - באַטאַליאָן
bateria - באַטעריע
bateryjka - באַטערייקע
batuta - טאַקטשטעקל
bawarka - באַוואַרקע
bawełna - באַוול
beczka - פֿאַס
Będzin - בענדין
Belgia - בעלגיע
benzyna - גאַזאָלין
beret - בערעט
berlińczyk - בערלינער
Berlin - בערלין
beżowy - בעזש
bezpośredni - דירעקט
bez - בעז
białoruski - ווײַסרוסיש
Białoruś - ווײַסרוסלאַנד , בעלאָרוסיע
Białystok - ביאַליסטאָק
biały - ווײַס
Biblia - ביבל
bieda - אָרעמקייט , בידע , דלות
biedronka - משה־רבנוס קיִעלע
biegunka - לאַקסירעכץ , דורכפֿאַל
bieg - לויף
bierzmowanie - קאָנפֿירמאַציע
bigoteria - פֿאַרגלייבטקייט
bilet - בילעט
bimbrownia - ברײַזל
biografia - ביאָגראַפֿיע
biologia - ביאָלאָגיע
biskup - ביסקופּ
biurko - שרײַבטיש
biuro podróży - פֿאָר־אַגענטור
biust - בוזעם
błąd - טעות , גרײַז , פֿעלער
błagać - בעטן רחמים ,באַשווערן
blagier - בליאַגער
blef - בלאָף
blizna - העפֿט
Bliźnięta - צווילינג
błoto - בלאָטע
błyskawica - בליץ
bóbr - ביבער
bób - באָב
bocian - באָטשען , בושל
bogactwo - רײַכקייט , עשירות ; אוצר , מטמון
bogaty - רײַך
bogini - געטין
Bóg - גאָט
bohr - באָריום
bojkot - בויקאָט
boks - באָקס
boleć - וויי טאָן
bolesny - ווייטיקדיק
bombardować - באָמבאַרדירן
bombka - טשאַטשקע
bor - באָר
botanik - באָטאַניקער
Boże Narodzenie - ניטל
bożonarodzeniowy - ניטלדיק
brać nogi za pas - נעמען די פֿיס אויף די פּלייצעס
brakować - פֿעלן
bramka - בראָם ; טויער ; ראָגאַטקע
bratek - חנהלעס אייגעלע
brązowy - ברוין
brednia - שמאָנצעס
broda - גאָמבע ; באָרד
broń - געווער , כּלי־זיין
broszura - בראָשור
brukselka - בריסלער קרויט
bruk - ברוק
brylant - בריליאַנט
brzeg - ברעג
brzmienie - געזונט
brzoskwinia - פֿערשקע
brzuch - בויך
brzydki - ברידקע
buda - בודע
buddyzm - בודיזם
budować zamki na lodzie - לייגן זיך פֿייגעלעך אין בוזעם
budować - בויען
budzić - אויפֿוועקן
budzik - וועקער
bułka - בולקע , זעמל
burak - בוריק , צוויק
burdel - שאַנדהויז , הײַזל
burmistrz - בירגער־מײַסטער
butelka - פֿלאַש
but - שוך
być w siódmym niebie - זײַן אין זיבעטן הימל
być - זײַן
bydło - פֿיך
byk - ביק
Byk - ביק ; ביק
bzdura - שמאָנצעס
cacko - צאַצקע
cal - צאָל
cap - צאַפּ
cebula - ציבעלע
celnik - צאָל־באַאַמטער
cena - פּרײַז
cent - סענט
cesarskie cięcie - קייסערשניט
cez - צעזיום
chałat - כאַלאַט
chałka - חלה
chałupa - כאַלופּע
cham - כאַם
chaotyczny - כאַאָטיש
charakter - טבֿע כאַראַקטער
chata - כאַטע
chcieć - וועלן
Chełm - כעלם
chemia - כעמיע
chemiczny - כעמיש
chętnie - גערן
Chińczyk - כינעזער
chinina - כינין
Chinka - כינעזערין
chiński - כינעזיש
Chiny - כינע
chleb - ברויט
chłodny - קיל
chłodzić - קילן
chłop jak dąb - שטאַרק ווי אַ דעמב
chlor - כלאָר
chmura - כמאַרע
chociaż - הגם
chodnik - לאַווע
chodzenie - גאַנג
choinka - ניטלבוים
cholera - כאָלערע
choroba - קראַנקייט
chory - קראַנק
chowany - קריקציִיִק
chromosom - כראָמאָסאָם
chronologia - כראָנאָלאָגיע
Chrystus - קריסטוס
chrzan - כריין
chrześcijański - קריסטלעך
chrześcijaństwo - קריסטנטום , קריסטלעכקייט
chuj - שמאָק , פּוץ
chusteczka - נאָזטיכל
chwila - רגע
chytry - כיטרע
ciągle - כּסדר
ciasto - טייג ; קוכן
ciąża - טראָגן
cichy - שטיל
ciekawy - טשיקאַווע
ciemny - טונקל
cienki - דין
cień - שאָטן
ciepły - וואַרעם
ciężarówka - משׂא־אויטאָ
ciężki - שווער ; האַרט
cmentarz - בית־עולם /
cokolwiek - אַבי וואָס
coś - עפּעס
co - וואָס
cudowny - וווּנדערלעך , אַ מחיה
cukierek - צוקערקע
cukier - צוקער
cukrzyca - צוקערקרענק
cyfra - ציפֿער
cynamon - צימרינג
cyrkon - צירקאָניום
cytryna - ציטרין
czajnik - טשײַניק ; טשײַניק
czarna dziura - שוואַרצע לאָך
Czarnogóra - מאָנטענעגראָ
czarny - שוואַרץ
czary - כּישוף
czasem - צו מאָל
czasownik posiłkowy - העלפֿווערב
czasownik - ווערב
czaszka - שאַרבן
czas - צײַט
Czechosłowacja - טשעכאָסלאָוואַקײַ
Czechy - טשעכיע
czekać - וואַרטן
czekolada - שאָקאָלאַד
czekoladka - שאָקאָלאַדקע
czereśnia - קאַרש
Czerniowce - טשערנאָוויץ
czerwiec - יוני
czerwony - רויט
część - טייל
czeski - טשעכיש
często - אָפֿט
czkawka - שלוקערץ
człowiek - מענטש
czołg - טאַנק
czoło - שטערן
czosnek - קנאָבל
czulent - טשאָלנט /
czwartek - דאָנערשטיק
czyj - וועמענס
czystość - ריינקייט
czysty jak łza - שפּיגל ריין
czysty - ריין ; לויטער
czytać - לייענען
czy - צי
dąb - דעמב
dach - דאַך
dać - געבן
daktyl - טייטל /
darmo - אומזיסט
dar - גאָב
Dawid - דוד
dawno - לאַנג צוריק
dbać - אָפּהיטן
definicja - דעפֿיניציע
dekalog - די עשׂרת־הדיברות , די צען געבאָט
deklinacja - דעקלינאַציע
dekoracyjny - דעקאָראַטיוו
delfin - דעלפֿין
demokrata - דעמאָקראַט
demokratyczny - דעמאָקראַטיש
denerwować - דענערווירן , צערייצן ; דענערווירן זיך
deprymować - דעפּרימירן
deser - דעסערט ; פֿאַרבײַסן
despota - דעספּאָט
deszczowy - רעגנדיק
deszcz - רעגן
diabeł - טײַוול
dialog - דיאַלאָג
dinozaur - דינאָזאַווער
dlaczego - פֿאַר וואָס
dlatego - דעריבער , דערפֿאַר
długi - לאַנג
dłużnik - בעל־חובֿ
dobry wieczór - גוטן אָוונט
dobry - גוט
dobrze - גוט
dochód - הכנסה
doić - מעלקן
dojrzały - צײַטיק
dokąd - וווּהין
dokładny - גענוי
doktor - דאָקטאָר
dokuczać - דערקוטשען
dokument - דאָקומענט
dolar - דאָלאַר
domena publiczna - רשות־הרבים
domokrążca - פּעדלער
dom publiczny - שאַנדהויז , הײַזל
dom - הויז ; היים ; …בית־
dorsz - דאָרש
dosłownie - ממש , וואָרט פֿאַר וואָרט
dostęp - צוטריט , דריסת־הרגל
dotyk - פּאָרקע
do - ביז
drabina - לייטער
drapacz chmur - וואָלקן־קראַצער
dręczyć - פּײַניקן , מאָרען , מאַטערן
drobiowy - עופֿן
drobnostka - קלייניקייט
drób - עוף
Droga Mleczna - מילכוועג
droga - וועג ; אופֿן
drogi - טײַער
Drohobycz - דראָהאָביטש
drożdże - הייוון
druga wojna światowa - צווייטע וועלט־מלחמה
drukarz - דרוקער
drzemać - דרימלען , דרעמלען , שלומערן
drzemka - דרימל , דרעמל , שלומער
drzewo - בוים
dr - ד״ר
duma - שטאָלץ
dupa - תּחות
dusza - נשמה , נפֿש
duży - גרויס
dwukropek - צווייפּינטל
dynamit - דינאַמיט
dynia - דיניע
dyrygent - דיריגענט
dysk twardy - האַרטדיסק
dysk - דיסק
dysproz - דיספּראָסיום
dyszel - דישעל
dziadek do orzechów - קנאַקניסל
dziadek - זיידע
dziadkowie - זיידע־באָבע
działać - פֿונקציאָנירן
działalność - אַקטיוויטעט
dziąsło - יאַסלע
dziecięcy - קינדערש , קינדעריש
dziecko - קינד
dziegieć - דזשעגעכץ
dziękuję - אַ דאַנק
dzieło - ווערק
dzień dobry - גוט מאָרגן
dziennikarstwo - זשורנאַליסטיק
dziennikarz - זשורנאַליסט
dzień - טאָג
dziesięciolecie - יאָרצענדלינג
dziewica - בתולה עלייסבת ,בתולה
dzik - קאַבאַן , וואַלד־חזיר
dziób - שנאָבל
dzisiaj - הײַנט ; הײַנט צו טאָג
dzisiejszy - הײַנטיק
dziura - לאָך /
dzwonić - טעלעפֿאָנירן
egipski - מיצריש
Egipt - מצרים
egoistyczny - עגאָיִסטיש
egoizm - עגאָיִזם
egzystować - עקסיסטירן
einstein - אײַנשטײַניום
ekspert - ידען , מבֿין , מומחה
eksploatować - עקספּלוּאַטירן
eksponat - עקספּאָנאַט
ekstremalny - עקסטרעם
elektroniczny - עלעקטראָניש
elektronika - עלעקטראָניק
elektrownia - קראַפֿטסטאַנציע , עלעקטרײַ
elektryczność - עלעקטרע
elektryk - עלעקטריקער
elektryzować - עלעקטריזירן
element - שטאָף
elf - שרעטל
Eliasz - אליהו
elipsa - עליפּס , אָוואַל ; עליפּס
emerytura - פּענסיע
encyklopedia - ענציקלאָפּעדיע
esperanto - עספּעראַנטאָ
Etiopia - עטיאָפיע
etniczny - עטניש
etymologia - עטימאָלאָגיע
Eurazja - אייראַזיע
Europa - אייראָפּע
europejski - אייראָפּעיִש
fajka - פּיפּקע
fajny - פֿײַן
fakt - פֿאַקט
fala - כוואַליע
fałszywy - פֿאַלש
faraon - פּרעה
farma - פֿאַרם
fasola - פֿאַסאָליע , בעבל
felczer - רופֿא , פֿעלדשער
fenek - פֿענעק
ferment - העצע
figa - פֿײַג
filia - פֿיליע
film - פֿילם
filozofia - פֿילאָסאָפֿיע
filozof - פֿילאָסאָף
Finlandia - פינלאנד
fiołek - פֿיאַלקע
fioletowy - וויאָלעט
flaga - פֿאָן
flet - פֿלייט
foka - ים־הונט
folwark - פֿאָלוואַרק
fonem - פֿאָנעם
fontanna - פֿאָנטאַן
forma - פֿאָרעם
fosfor - פֿאָספֿאָר
fotel - פֿאָטעל
fotografia - פֿאָטאָגראַפֿיע
fotograficzny - פֿאָטאָגראַפֿיש
foton - פֿאָטאָן
francuski - פֿראַנצויזיש
frans - פֿראַנציום
fregata - פֿרעגאַט
fryzjer - פֿריזירער
fryzura - פֿריזור
gadolin - גאַדאָליניום
Gad - גד
gad - רעפּטיליע , שרץ
gag - שפּאַס , הלצה
galareta - גליווער , גאַלאַרעט
galaretka - גאַלאַרעט
gałka muszkatołowa - מושקאַט
gałka - קנאָפּ
garaż - גאַראַזש
garb - האָרב
gardło - גאָרגל , האַלדז
garnek - טאָפּ
gatki - גאַטקעס
gatunek - זגאַל
gaża - פּיידע
gazeta - צײַטונג
gaz - גאַז
Gdańsk - דאַנץ
gdyby - כּלומרשט
gdzie indziej - אַנדערש וווּ
gdzie kucharek sześć, tam nie ma co jeść - וווּ עס זײַנען דאָ אַ סך קעכינס, דאָרט איז דאָס עסן רױ
gdzieniegdzie - וווּ ניט וווּ
gdzie - וווּ
gejzer - גײַזער
generał - גענעראַל
geologiczny - געאָלאָגיש
gestapo - געסטאַפּאָ
gest - זשעסט , תּנועה
getto - געטאָ
głąb - גלאָמב ;גלאָמב
głębia - טיף , טיפֿקייט
głębokość - טיף , טיפֿקייט
glina - ליים
głodny - הונגעריק
głód - הונגער
głos - שטים
główny - הויפּט
głupota - טיפּשות
gniazdo - נעסט ; קאָנטאַקט ; שפּעלטל
gołąb - טויב
golarka - גאָלער
golf - גאָלף
gorący - הייס
gorączka - פֿיבער , היץ ; היץ
góra lodowa - אײַזבאַרג
góra - באַרג
górnik - גרעבער
goryl - גאָרילע
gorzelnia - ברײַזל
gorzki - ביטער
gość - אורח , גאַסט
gówno - דרעק
gracz - שפּילער
grać - שפּילן
grad - האָגל
gramatyka - גראַמאַטיק
granat - גראַנאַט ; מילגרוים
graniastosłup - פּריזמע
granica - גרענעץ /
gratulacja - מזל־טובֿ
gra - שפּיל
grdyka - גאָרגל , גאָרגלקנאָפּ
grejpfrut - גרייפּפֿרוט , גרייפּפֿרוכט
grom - דונער
groszek - אַרבעס
grosz - גראָש
gruby - באַלײַבט , גראָב ; דיק , גראָב ; גראָב
grudzień - דעצעמבער
gruntownie - גרינטלעך
grupa - גרופּע
gruszka - באַר
Gruzja - גרוזיע
gruźlica - טובערקולאָז
gryka - רעטשקע , גריקע
gryźć - בײַסן , גריזשן
grzebień - קאַם ; קעמל
grzech - זינד , חטא , עבֿירה
grzyb - שוואָם / ; שוואָם / , שוווים
guma - גומע ; קײַגומע
gumka - מעקער
gwałt - גוואַלד
gwiazda - שטערן
gwiazdka - שטערנדל
gwizdać - פֿײַפֿן
hafn - האַפֿניום
haftować - העפֿטן ,האַפֿטן
Haga - האַג
hak - האָק
hałaśliwy - טומלדיק
hałastra - כאַליאַסטרע
harmonia - האַרמאָניע
harować - האָרעווען
harowanie - האָרעוואַניע
harówka - האָרעוואַניע
haszysz - האַשיש
hazardzista - אַזאַרטשפּילער
hazard - אַזאַרט
hebrajski - העברעיִש ; העברעיִש , עבֿריתּ
hełm - קאַסקע
hel - העליום
heparyna - כעפּערין
herbata - טיי
Hindus - אינדיער
hipokryta - צבֿועק
hipoteza - היפּאָטעז
historia - געשיכטע ; מעשׂה
hit - שלאַגער
holenderski - האָלענדיש
holm - האָלמיום
hucpa - חוצפּה
hycel - היצעל
identyczny - אידענטיש
idiota - אידיאָט
igła - נאָדל
ignorancja - אומוויסן , עם־הארצות , אומקענטעניש
ile - וויפֿל
iloraz - וויפֿלער
ilustracja - אילוסטראַציע ; משל /
imbir - אינגבער
imiennik - חבֿר צום נאָמען
imiesłów - פּאַרטיציפּ
imię - נאָמען
impotencja - מענערשוואַכקייט , אימפּאָטענץ
Indie - אינדיע
Indonezja - אינדאָנעזיע [indonezje]
indyk - אינדיק
ind - אינדיום
infekcja - אינפֿעקציע
inflacja - אינפֿלאַציע
inkryminować - אינקרימינירן , שולדיקן
instytut - אינסטיטוט
insurekcja - אויפֿשטאַנד
inteligencja - אינטעליגענץ
intencja - כּוונה , מיין
interesujący - אינטערעסאַנט , טשיקאַווע
inżynier - אינזשעניר
iryd - אירידיום
islamski - איסלאַמיש
islam - איסלאַם
iterb - איטערביום
-izm - יזם|&amp;rlm;-יזם
Izrael - ישׂראל
i - און
jabłko niezgody - סלע־המחלוקת
jabłko - עפּל
jacht - יאַכט
jagnię - לאַם
jaguar - יאַגואַר
jajecznica - פּרעזשעניצע
jajko - איי
jajnik - אייערשטאָק
jakkolwiek - אַבי ווי
jama - לאָך /
jarzmo - יאָך
jaskinia - הייל
jaskółka - שוואַלב
jasny - העל
jaszczurka - יאַשטשערקע
jazz - דזשעז
ja - איך
jedyny - איינציק
jedzenie - עסן
jeniec - געפֿאַנגענער
Jerozolima - ירושלים
jeść - עסן
jesień - האַרבסט ; יעשען ; אָסיען
jesion - אַשבוים
jezioro - אָזערע
Jezus - יעזוס
język ojczysty - מאַמע־לשון
językowy - שפּראַך|שפּראַכ-&amp;rlm; , שפּראַכיק
język - צונג ; לשון , שפּראַך
jeżyna - אָזשענע
jidyszyzm - ייִדישיזם
jidysz - ייִדיש
jodła - יאָדלע
jod - יאָד
jogurt - יאָגורט
judaizm - ייִדישקייט /
judasz - לעכל
judeochrześcijański - ייִדיש־קריסטלעך
jutro - מאָרגן ; מאָרגן
kabuki - קאַבוקי
kaczka - קאַטשקע
kakao - קאַקאַאָ
kalafior - קאַליפֿיאַר
kaliforn - קאַליפֿאָרניום
kaliski - קאַלישער
kalkulator - רעכן־מאַשין
kalmar - טינטפֿיש
kalosz - קאַלאָש
kałuża - קאַלוזשע ,לוזשע ,קאַליוזשע
kamień węgielny - ווינקלשטיין ; גרונטשטיין
kamień - שטיין
kanał - קאַנאַל
kanapa - דיוואַן , קאַנאַפּע
kangur - קענגורו
kantor - חזן
kapitalista - קאַפּיטאַליסט
kapitalistyczny - קאַפּיטאַליסטיש
kapitalizm - קאַפּיטאַליזם
kapusta - קרויט
karabin maszynowy - פּולעמיאָט [pulemiot]
karabin - ביקס
karaluch - טאַראַקאַן
karczoch - אַרטישאָק
karp - קאַרפּ
karta do gry - קאָרט
kartka - בלאַט /
karygodny - שענדלעך
kasjer - קאַסיר
kasza - קאַשע , גריץ ; קאַשע
kaszleć - הוסטן
kasztan - קעסט
kataryniarz - קאַטערינשטשיק
katedra - קאַטעדרע
katolicki - קאַטויליש
kawa - קאַווע
kawiarnia - קאַפֿע
każdy - יעדער
kciuk - גראָבער־פֿינגער
keczup - פּאָמידאָרן־סאָס , קעטשאָפּ
khaki - כאַקי
kichać - ניסן
kieliszeczek - גלעזל
kieszeń - קעשענע
kieszonkowiec - קעשענע־גנבֿ
kino - קינאָ
kit - קיט
klamka - קליאַמקע
kłamstwo - ליגן , שקר
klawiatura - קלאַוויאַטור
klawisz - קלאַוויש
kleszcze - צוואַנג
klikać - קנאַקן
klikanie - קנאַק
klimatyzacja - לופֿטקילונג
klon - נעזבוים
klucz - שליסל
kminek - קימל
knajpa - קנײַפּע
knot - קנויט
koalicja - קאָאַליציע
kobalt - קאָבאַלט
kobiecy - ווײַבלעך
kochać - ליבן ; קאָכען זיך
kochanek - קאָכאַנעק , ליבהאָבער , ליובאָווניק
kochanie - ליובע ; ליובטשע , ליובעליו , ליובעניו
kochany - ליב ;ליבלעך
kocioł - קעסל
koci - קעציש
kocur - קאָטער
kogel-mogel - גאָגל־מאָגל
koks - קאָקס
kołdra - קאָלדרע
kolęda - קאָלענדע
kolej - באַן
kołnierz - קאָלנער
kolonia - קאָלאָניע ; ייִשובֿ ; קעמפּ , מחנה
Kolonia - קעלן
koło - ראָד
kolumna - קאָלאָנע , זײַל ; קאָלאָנע ; קאָלומנע ; רובריק
kołysanka - וויגליד
kołyska - וויג
komar - קאָמאַר
kominek - קאַמין
kominiarz - קוימען־קערער
komisja - קאָמיסיע
komoda - קאַמאָד
komora - קאַמער
komórka - צעלקע
komputer - רעכענער , קאָמפּיוטער
komunista - קאָמוניסט
komunistyczny - קאָמוניסטיש
komunizm - קאָמוניזם
koncert - קאָנצערט
kończyć - ענדיקן
kondom - קאָנדאָם
konduktor - קאָנדוקטאָר
koniak - קאָניאַק
koniec - סוף
konik morski - ים־פֿערדל
konik - פֿערדל
koniugacja - קאָניוגאַציע
konstytucja - קאָנסטיטוציע ; גוף־געבוי
kontakt - קאָנטאַקט
konto - קאָנטע
kontrast - קאָנטראַסט , היפּוך
kontynent - קאָנטינענט
koń - פֿערד
kopać - בריקען
kopalnia - גרוב
koperta - קאָנווערט
kopnięcie - בריקע
Korea Północna - צפֿון־קאָרעע
korek - קאָריק
korona - קרוין
korpus - קערפּער
korytarz - קאָרידאָר
korzeń - וואָרצל
kosa - קאָסע
kosiarka - גראָז־שנײַדער
kosić - קאָשען
kosmetyk - קאָסמעטיק
kosmos - קאָסמאָס
Kosowo - קאָסאָווע
koszula - העמד
koszykówka - קוישבאָל
kotek - קעצעלע , קאָטינקע
kot - קאַץ
kozak - קאָזאַק
Kozak - קאָזאַק
koza - ציג
kozia bródka - ציגן־בערדל
kozioł ofiarny - שׂעיר־לעזאָזל , כּפּרה־הינדל
kozi - ציגן
kradzież - גנבֿה
kraj - לאַנד
Kraków - קראָקע
kraść - גנבֿענען
krawat - שניפּס , קראַוואַט , אויסבינדער
krawiec - שנײַדער
kra - קריע
kremacja - פֿאַרברענונג , קרעמאַציע
krematorium - קרעמאַטאָריע
krem do opalania - זונשמירעכץ
kretyński - מאָראָניש
kretyn - מאָראָן
kret - מולטוואָרעס , קראָט
krewetka - ראַקל
krewni i znajomi królika - קינד־און־קייט
krew - בלוט
kroić - שנײַדן
krokodyl - קראָקאָדיל
królestwo - קיניגרײַך
królowa - קיניגין
król - מלך , קיניג
kropka - פּינטל
kropla - טראָפּן
krótki - קורץ
krowa - קו
krowi - קיִיִש
krówka - קיִעלע
krtań - שטימע קעסטל
kruk - וואָראָן , ראָב
krupnik - קרופּניק
krytyka - קריטיק
kryzys - קריזיס
krzem - סיליציום
krzesło - שטול
krzyk - גוואַלד , געשריי
ksiądz - גלח
książę - פּרינץ
książka - בוך
Księga Rodzaju - &amp;rlm; בראשית
księżniczka - פּרינצעסין
księżyc - לבֿנה
który - וועלך
ktoś - עמעץ , עמעצער
kto - ווער
kubek - טעפּל
Kubuś Puchatek - וויני־דער־פּו
kufel - קופֿל
kukułka - קוקאַווקע
kukurydza - פּאַפּשוי , קוקורוזע
kula - קויל ; קוליע
kulturalny - קולטורעל
kultura - קולטור ; תּרבות
kuna - קונע
kura - הון
kurwa - זונה , הור ; קורוואַ
kurz - שטויב /
kwasić - זײַערן
kwaśny - זויער
kwiaciarnia - בלומענקראָם
kwiat - בלום , קווייט
kwiecień - אַפּריל
kwitnąć - בליִען , צוויטען ; בליִען זיך
łabędź - שוואַן
ładny - שיין
łąka - לאָנקע
łamać - ברעכן
lampart - לעמפּערט
lampa - לאָמפּ
łańcuch - קייט
łapać - כאַפּן
łapu-capu - כאַפּ־לאַפּ
łasica - וויזעלע
las - וואַלד
latawiec - פֿלישלאַנג
łata - לאַטע
lato - זומער
lawa - לאַווע
lawina - לאַווינע
ławka - באַנק
lecieć - פֿליִען
legalny - לעגאַל
lejce - לייצע
lekarz - דאָקטער
letni - זומערדיק
lewy - לינק
lew - לייב
liczba mnoga - מערצאָל
liczba pojedyncza - איינצאָל
liczba - צאָל
liczebnik - צאָלוואָרט
liczyć - ציילן
lilak - בעז
lilia - ליליע
linia - ליניע ; מאַרשרוט ; שורה
linoleum - לינאָליי
lipa - לינדנבוים
lipiec - יולי
liść laurowy - לאָרבער בלאַט
liść - בלאַט /
lista - רשימה
listopad - נאָוועמבער
lis - פֿוקס
litera - אות /
litewski - ליטוויש
Litwa - ליטע
lit - ליטיום
lizać - לעקן
lm - מצ
locha - ליאָכע , חזירטע
lodowiec - גלעטשער
łódzki - לאָדזשער
Łódź - לאָדזש
lód - אײַז ; אײַזקרעם
logarytm - לאָגאַריטם
łokieć - עלנבויגן
lokomotywa - לאָקאָמאָטיוו
lombard - לאָמבאַרד
Londyn - לאָנדאָן
łopata - לאָפּעטע
lorens - לאָרענציום
łosoś - לאַקס
lotnisko - אַעראָפּאָרט
lot - פֿליג
łowicki - לאָוויטשער
lp - אצ
Lublin - לובלין
łucznik - פֿײַלן־בויגער
ludność - באַפֿעלקערונג
ludowy - פֿאָלקסטימלעך
ludzki - מענטשיש ; מענטשלעך
ludzkość - מענטשהייט
lutet - לוטעציום
luty - פֿעברואַר
Lwów - לעמבערג
łyżeczka - טיילעפֿל
łyżka do butów - שוכלעפֿל
łza - טרער
maca - מצה
macica - מוטערלײַב
macierz - מאַטריקס
magnez - מאַגנעזיום
majonez - מאַיאָנעז
majtki - מײַטקעס
maj - מײַ
makaron - לאָקש
mak - מאָן
malaria - מאַלאַריע
malarstwo - מאָלערײַ
malarz - מאַליער , מאָלער
malina - מאַלענע
małpa - מאַלפּע ; אויף ,שטרודל ,מאַלפּע
mały - קליין
mama - מאַמע
mamusia - מאַמעלע , מאַמעניו
mandolina - מאַנדאָלין
mapa - קאַרטע , מאַפּע
marcowy - מאַרצאָווע
margaryna - מאַרגאַרין
marihuana - מאַריכואַנע
marionetka - מאַריאָנעט
marmolada - מאַרמעלאַד
marmur - מאַרמער מאַרמל
marokański - מאַראָקאַניש
Maroko - מאַראָקאָ
marszałek - מאַרשאַל
marzec - מאַרץ
marzenie - חלום
marzyć - חלומען
masarnia - יאַטקע
masaż - מאַסאַזש
maślanka - מאַסלינקע , פּוטערמילך
masło - פּוטער
mason - פֿרײַמײַער
maszyna - מאַשין
matematyczny - מאַטעמאַטיש
matematyka - מאַטעמאַטיק
matematyk - מאַטעמאַטיקער
maturzysta - אַביטוריענט
mauretański - מוריניש
mechanizm - מעכאַניזם ,מאַשינעריע ,מאַשינערײַ
meczet - מעטשעט
meitner - מײַטנעריום
męka - פּײַן ,יסורים
Meksyk - מעקסיקע
melancholia - מעלאַנכאָליע
melodia - מעלאָדיע
melon - מעלאָן
memorandum - מעמאָראַנדום
menażeria - מענאַזשעריע
mendelew - מענדעלעוויום
menora - מנורה
Merkury - מערקור
męski - מענלעך ; מאַסקולין
metafora - מעטאַפֿאָר
metalowy - מעטאַלן
metal - מעטאַל
meteorologia - מעטעאָראָלאָגיע
meteor - מעטעאָר
metoda - שיטה
metro - אונטערבאַן
mewa - מעווע
mianownik - נאָמינאַטיוו
miara - מאָס
miau - מיאַו
mieć głowę na karku - האָבן אַ קאָפּ אויפֿן קאַרק
mieć muchy w nosie - האָבן פֿליגן אין דער נאָז
miecz - שווערד
międzynarodowy - אינטערנאַציאָנאַל
Międzyrzec Podlaski - מעזעריטש
między - צווישן
miejski - שטאָטיש
miękki - ווייך
miesiąc - מאָנאַט , חודש
miesięcznik - חודשניק
mięsień - מוסקל
mięsny - פֿליישיק ; יאַטקע
mięso - פֿלייש
mieszkać - וווינען
mieszkanie - דירה
mięta - מינץ
mikrofon - מיקראָפֿאָן
miłość - ליבע ; ליבשאַפֿט
mina - העוויה
minuta - מינוט
miód - האָניק
miotła - בעזעם
miska - שיסל
mistrz - מײַסטער
mleko - מילך
mniej więcej - מער־ווייניקער
móc - קענען
modlić się - דאַוונען
modlitwa - תּפֿילה
modystka - פּוצערקע , פּוצמאַכערין
moher - מאָרע
Mojżesz - משה
mój - מײַן
mokry - נאַס
molo - מאָל
mól - מאָל
Monachium - מינכן
monoteizm - מאָנאָטעיִזם
moralność - מאָראַל
mors - ים־פֿערד
Morze Bałtyckie - באלטישער ים
Morze Śródziemne - מיטלענדישער ים
morze - ים
mosiądz - מעש
Moskwa - מאָסקווע
mostek - בריקל
most - בריק
moszna - כּיס
motyl - פֿלאַטערל , באַבעטשקע , באַבעלע
motyw - מאָטיוו
mowa jest srebrem, a milczenie złotem - שיין שווײַגן איז שיינער ווי שיין רעדן, רעדן איז זילבער - שווײַגן איז גאָלד
mowa - רעדע
mówić na ty - דוצן
mówić - רעדן
mózg - מוח ; זשוזשען
możliwość - מיגלעכקייט ; פֿעיִקייט
możliwy - מיגלעך
mrówka - מוראַשקע
mróz - פֿראָסט
musztarda - מושטאַרדע , זענעפֿט
muzeum - מוזיי
muzyka - מוזיק
myć - וואַשן
mydło - זייף
myśleć - טראַכטן , קלערן
myśl - געדאַנק
myszka - מײַזל
mysz - מויז
my - מיר
mżawka - רעגנדל
nagle - פּלוצעם
nagroda - פּריז
naiwny - נאַיוו
naleśnik - בלינצע
namiot - געצעלט
na pewno - אויף געוויס , אויף זיכער
napięcie - וואָלטאַזש
naprawdę - טאַקע , באמת , אויף אַן אמת , אין דער אמתן
narodowość - נאַציאָנאַליטעט
narodziny - געבורט
narzędzie - מכשיר
narzekać - קלאָגן
naszyjnik - האַלדזבאַנד
natręt - נודניק , כאָלערע
nauczyciel - לערער
nauka - וויסנשאַפֿט
naukowiec - וויסנשאַפֿטלער
naukowy - וויסנשאַפֿטלעך
nawyk - געוווינהייט
nawzajem - גם־אַתּם
nazywać - הייסן
negatywny - נעגאַטיוו
neodym - נעאָדימיום
neologizm - נעאָלאָגיזם
neptun - נעפּטוניום
nerka - ניר
nerwowy - נערוועז
n.e. - נ״ק
nic - גאָרנישט , גאָרניט
nić - פֿאָדעם
niebezpieczeństwo - סכּנה
niebieski - בלוי
niebo - הימל
niedziela - זונטיק
niedźwiedź - בער
niegodziwiec - רשע
nienawidzić - פֿײַנט האָבן
nie od razu Kraków zbudowano - די וועלט איז אויך ניט באַשאַפֿן געוואָרן אין איין טאָג , משיח ווערט ניט אין איין נאַכט געבוירן געוואָרן , ניט אין איין טאָג איז דער בית־המיקדש געבויט געוואָרן , קראָקע איז ניט אין איין טאָג געבויט געוואָרן
niepodległość - אומאָפּהענגיקייט
niepodległy - אומאָפּהענגיק
niepokoić - באַאומרויִקן
nieprzytomny - פֿאַרחלשט
nieść - טראָגן
niesprawiedliwie - אומגערעכט
nieszczęście - צרה ; צער , אומגליק , שלימזל
niewolnik - שקלאַף
nie wszystko złoto, co się świeci - ניט אַלץ וואָס גלאַנצט איז גאָלד
niezależność - אומאָפּהענגיקייט
niezapominajka - פֿאַרגעסניטל
nieznany - אומבאַקאָנט
nie- - ניט
nie - ניין ; נישט
nigdy - קיין מאָל
nikiel - ניקל
nikt - גאָרנישט , גאָרניט
nobel - נאָבעליום
nocny - נאַכטיק
noc - נאַכט
noga - פֿוס ; פֿוסבאָל
nominować - נאָמינירן
nora - לאָך , נאָרע
nos - נאָז
notes - סאָבילטאַזש
notować - פֿאַרצייכענען
nowojorski - ניו־יאָרקער
Nowy Jork - ניו־יאָרק
nowy - נײַ
nóż - מעסער
nudny - נודנע
obcas - אָבצאַס) אָפּצאַס) , קנאַפֿל
obecność - אָנוועזנהייט
obejmować - אַרומנעמען , האַלדזן ; פֿאַרנעמען
obiad - אָנבײַסן , מיטאָג , וואַרמעס
obiekt - אָביעקט
obietnica - צוזאָג
oblicze - געזיכט
obłuda - צבֿיעות
obmierzły - מיאוס
obóz - לאַגער
obraza - באַליידיקונג
obraz - בילד ; שירמע ; פֿאָרשטעלונג ; אימאַזש
obrobienie - באַאַרבעטונג
obróbka - באַאַרבעטונג
obrona - פֿאַרטיידיקונג
obsesja - שליטה
obwiniać - באַשולדיקן
Ocean Atlantycki - אַטלאַנטיק
Ocean Spokojny - פּאַציפֿיק , פּאַציפֿישער אָקעאַן , שטילער אָקעאַן
ocean - אָקעאַן
ocet - עסיק
och - װײ
ochota - גערנקייט ,באַגער ,חשק
ochrona - באַשיצונג , שוץ ; לײַבוואַך
oczywiście - אַוודאי
odchodzić - אַוועקשפּאַנען
odcień - ניואַנס
odcisk palca - פֿינגערדרוק
odkurzacz - שטויבמאַשין
odmiana - בייגונג , פֿלעקסיע
odpowiadać - ענטפֿערן ; ענטפֿערן
odpowiedzialność - פֿאַראַנטוואָרטלעכקייט , אַחריות , אחריות
odpowiedź - ענטפֿער
odtąd - פֿון איצט אָן
odzyskiwać - צוריקקריגן
ogień - פֿײַער
ogier - אָגער
ogórek - אוגערקע
ogród - גאָרטן
ojciec - פֿאָטער ; טאַטע
Ojcze nasz - אונדזער פֿאָטער
ojczym - שטיפֿפֿאָטער
okno - פֿענצטער
okop - אַקאָפּע
oko - אויג
okresowy - פּעריאָדיש
okres - פּעריאָד ; צײַט
okropny - שרעקלעך
okrucieństwo - אַכזריות
okrutny - אַכזריותדיק
okulary przeciwsłoneczne - זונברילן
okulary - ברילן
okulista - אויגן־דאָקטער
olcha - אָלכע
olej - אייל
oliwa - בוימל
ołówek - בלײַער
ołtarz - אַלטאַר , מזבח
ona - זי
oni - זיי
ono - עס
ONZ - פֿ״פֿ
on - ער
opium - אָפּיום
opłakiwać - באַטרויערן
opona - רייף ,גומערייף
opowiadać - דערציילן
optymizm - אָפּטימיזם
orać - אַקערן
Organizacja Narodów Zjednoczonych - די פֿאַראייניקטע פֿעלקער
organizacja - אָרגאַניזאַציע ; אָרגאַניזירן
organy - אָרגל
organ - אָרגאַן
Ormianin - אַרמענער
ormiański - אַרמעניש
orzeł - אָדלער
osa - וועספּ
osioł - אייזל
osoba - פּערזאָן
ostry - שאַרף
ostrzyć - שלײַפֿן
Oświęcim - אוישוויץ
otchłań - תּהום , אָפּגרונט
otwarty - אָפֿן
owad - אינסעקט
owal - אָוואַל
owca - שאָף ; שעפּס
owocowy - פֿרוכטיק
pajac - פּאַיאַץ
pająk - שפּין
Pakistan - פּאַקיסטאַן
pakować - פּאַקן
palec - פֿינגער
paliwo - ברענוואַרג
pallad - פּאַלאַדיום
palma - פּאַלמע
pamięć - זכּרון
pancerz - פּאַנצער
Panna - בתולה
Pan - אדוני
pan - רב ; רב ; רב ; רב ; רב
papierośnica - פּאָרטציגאַר
papieros - פּאַפּיראָס
papież - פּויפּס
paproć - פֿעדערגראָז
papuga - פּאָפּוגײַ
paradygmat - פּאַראַדיגמע
parafia - פּאַראַפֿיע
paralelny - פּאַראַלעל
para - פּאָרל ; פּאָר /
para- - פּאַרע , דאַמף
park - פּאַרק
Parlament Europejski - אייראָפּעיִשער פּאַרלאַמענט
parlament - פּאַרלאַמענט , כּנסתּ
partia - פּאַרטיי ; פּאַרטיע
partykuła - פּאַרטיקל
parytet - פּאַריטעט
Paryż - פּאַריז
parzyć - פֿאַרבריִען
pasażer - פּאַסאַזשיר
paser - פּאַסער
pasja - לײַדנשאַפֿט
pasować - פּאַסן ; פֿאַרבײַפֿאַרן
pasożyt - פּאַראַזיט
pas startowy - סטאַרטפּאַס
pasta do zębów - צאָנפּאַסטע
pasterka - פּאַסטעכין
pastuszka - פּאַסטושקע
październik - אָקטאָבער
pchła - פֿלוי
pedał - פּעדאַל , טרעטל
pełny - פֿול
penis - פּעניס , מענלעכער אבֿר
pępek - פּופּיק , נאָפּל
perła - פּערל
Persja - פּערסיע
perski - פּערסיש , פּערסיש
piana - פּינע
pianino - פּיאַנע
pianista - פּיאַניסט
piasek - זאַמד
piąta kolumna - פֿינפֿטע קאָלאָנע
piątek - פֿרײַטיק
pięciokąt - פֿינפֿעק
Pięcioksiąg - חומש
pieczarka - אַגאַריק
pieczeń - געבראָטנס
piec - אויוון ; באַקן
pieg - זומער־שפּרענקל , קלײַען
piekarz - בעקער , פּיעקער
piekło - גיהנום
piękny - שיין
pieniądz - געלט
pieprz - פֿעפֿער
pierdolić - טרענען
pierwsza pomoc - גיכע הילף
pierwsza wojna światowa - ערשטע וועלט־מלחמה
pięść - פֿויסט
piesek - הינטל
pieśń - ליד , פּיעסניע
pies - הונט
pietruszka - כּרפּס , פּעטרישקע
pijawka - פּיאַווקע
piła - זעג
piłka nożna - פֿוטבאָל
piorun - בליץ
piosenka - ליד
pisarz - שרײַבער
pismo - שריפֿט
pistolet - פּיסטאָלעט
Pitagoras - פּיטאַגאָראַס
piwnica - קעלער
piwo - ביר
płaca - פּיידע , לוין
plac - פּלאַץ , סקווער
plakat - פּלאַקאַט
plamka - שפּרענקל
planeta - פּלאַנעט
Platforma Obywatelska - בירגערלעכע פּלאַטפֿאָרם
płatność - אײַנצאָלונג , צאָלונג , אײַנצאָל
plecak - רוקזאַק
plecy - פּלייצע
plemię - שבֿט
plotkara - יענטע
plucha - פּליוכע
pluć - שפּײַען
pluskwa - וואַנץ
pluton - פּלוטאָניום
płyn - פֿליסיקייט
płyta - דיסק
p.n.e. - פֿ״ק
pobożny - פֿרום
pocałunek - קוש
pochodzenie - ייִחוס
pochodzić - קומען
pochwa - וואַגינע , מוטערשייד
pociąg - באַן , צוג
początek - אָנהייב
poczta - פּאָסט
podatkowy - שטײַערדיק
podciąć komuś skrzydła - אָפּהאַקן עמעצן די פֿליגל
podeszwa - זויל , פּאַדעשווע ; פּיאַטע
podkoszulek - לײַבל
podkowa - פּאָדקעווע
podłoga - פּאָדלאָגע
podniebienie - גומען
podpis - חתימה , אונטערשריפֿט ; קעפּל
podręcznik - האַנטבוך , לערנבוך
podróż - נסיעה
poduszka - קישן
podwójny - טאָפּל , צוויייִק , צווייענדיק
pod wpływem - אונטער אײַנפֿלוס
pod - אונטער
poeta - פּאָעט , דיכטער
poganin - פּאַגאַנער
pogański - פּאַגאַניש
pogoda - וועטער
pojedynczy - איינציק
pojutrze - איבערמאָרגן
poker - פּאָקער
połączenie - שײַכות , פֿאַרבינדונג , פֿאַרבונד
Polak - פּאָליאַק
policja - פּאָליציי
policzek - בעקל , באַק
polityczny - פּאָליטיש
polityka - פּאָליטיק
polityk - פּאָליטיקאַנט
Polka - פּאָלקע
północ - האַלבע נאַכט ; צפֿון
Północ - צפֿון
polon - פּאָלאָניום
Polska - פּוילן
polski - פּויליש ; פּויליש
półtora - אָנדערטהאַלבן
Południe - דרום
południe - מיטאָג , האַלבער טאָג ; דרום
półwysep - האַלבאינדזל
pół - האַלבן
pomagać - העלפֿן
pomarańcza - מאַראַנץ
pomarańczowy - אָראַנזש
pomidor - פּאָמידאָר
pomijać - אויסלאָזן
pomoc - הילף
poniedziałek - מאָנטיק
ponieważ - ווײַל , וואָרן , מחמת
popielniczka - אַשטעצל
popiół - אַש
popołudnie - נאָכמיטאָג
poprawny - אמת
popularny - פּאָפּולער
pop - פּאָפּ
pora roku - צײַט פֿון יאָר
porcja - פּאָרציע
porównanie - פֿאַרגלײַך
portfel - טײַסטער , בײַטל , פּאָליאַרעס , פּוליאַרעס
portugalski - פּאָרטוגייזיש
porucznik - לייטענאַנט
porzeczka - ווײַמפּערל
por - פּאָרע
pośpiech - יאָגעניש , אײַלעניש
pospolity - סקאַרבאָווע
potępiać - פֿאַרדאַמען
potrzeba - נויט
potrzebować - נייטיק האָבן ,דאַרפֿן ,באַנייטיקן זיך אין
potwierdzić - באַשטעטיקן , אוטווערדזשען
potwór - פֿאַרזעעניש
pouczać - באַלערן
powiedziałeś A, powiedz B - ווער עס זאָגט אַלף, מוז זאָגן בית
powierzchnia - אייבערפֿלאַך , אויבנאויף ; ''~ wody'' שפּיגל
powieść - ראָמאַן
powietrze - לופֿט
powstanie warszawskie - וואַרשעווער אויפֿשטאַנד
powstanie - פּאָווסטאַניע , אויפֿשטאַנד
powtarzać - איבערחזרן
pożądać - באַגערן
Poznań - פּױזן
późno - שפּעט
pożyczać - באָרגן
praca - אַרבעט ; אַרבעט ; ווערק ; אַרבעט ; אַרבעט
pracodawca - באַשעפֿטיקער
Praga - פּראָג
pragnąć - באַגערן
pragnienie - דאָרשט ; באַגער
prawa człowieka - מענטשנרעכט
prawda - אמת
prawdziwie - אמת
prawie - כּמעט
prawnik - יוריסט
Prawo i Sprawiedliwość - געזעץ און גערעכטיקייט
prawy - רעכט ; גערעכט
prazeodym - פּראַזעאָדימיום
premiera - פּרעמיערע
premier - פּרעמיער
prezent - געשאַנק , מתּנה , פּרעזענט
prezerwatywa - קאָנדאָם
prezydentura - פּרעזידענטשאַפֿט
prezydent - פּרעזידענט
prima aprilis - פּרימאַ־אַפּריליס
próba - רעפּעטיציע , פּראָבע ; פּרוּוו
problematyczny - פּראָבלעמאַטיש
problem - פּראָבלעם
próbować - פּרוּוון , פּרובירן
procent - פּראָצענט
procesja - פּראָצעסיע
proch strzelniczy - פּולווער
proch - פּראָשיק ; פּולווער
produkcja - פּראָדוקציע
profit - פּראָפֿיט , רווח
projekt - פּראָיעקט
promet - פּראָמעטיום
promień - שטראַל ; ראַדיוס
prom - פּראָם
proroctwo - נבֿואה
proroczy - נבֿיאיש
prorokini - נבֿיאה
prorok - נבֿיא
prosić - בעטן
prostytucja - זנות , פּראָסטיטוציע
prostytutka - פּראָסטיטוטקע
proszek - פּראָשיק
proszę - ביטע
protaktyn - פּראָטאַקטיניום
prowokacja - פּראָוואָקאַציע
prowokować - פּראָוואָצירן , צערייצן
próżnia - וואַקוּום
pruć - טרענען
prysznic - דוש
przeciąg - צוג
przecinek - קאָמע
przeciwciało - אַנטיקערפּער
przede wszystkim - דער עיקר , דערעיקרשט , קודם־כּל
przedpołudnie - פֿאַרמיטאָג
przedwczesny - צופֿריִיִק
przedwczoraj - אייערנעכטן
przejechać - איבערפֿאָרן
przekątna - דיאַגאָנאַל , אַלכסון
przemoc - גוואַלד
przemysł - אינדוסטריע
przepraszam - מוחל זײַן
przesadzać - מגזם
przeszłość - פֿאַרגאַנגענהייט , אַמאָל
przewodnik - פֿירער ; וועגווײַזער ; דורכפֿירער ; מדריך
przychodzić - קומען
przyjaciel - חבֿר
przykład - משל /
przymiotnik - אַדיעקטיוו
przymrozek - געפֿריר
przypadek - בייגפֿאַל
przypominać - דערמאָנען
przysłówek - אַדווערב
przysłowie - שפּריכוואָרט
przysługa - טובֿה
przystanek - אָפּשטעל
przyszłość - וועט־זײַן , צוקונפֿט
przyzwoity - לײַטיש
psalm - מיזמור , תּהילים , קאַפּיטל
pseudonim - פּסעוודאָנים
psi - הינטיש
pstrąg - פֿאָרעל
psychiatra - פסיכיאטר , פּסיכיאַטער
psychiatria - פסיכיאטריה , פּסיכיאַטריע
psychiczny - פּסיכיש , גײַסטיק
psychologia - פּסיכאָלאָגיע
psycholog - פּסיכאָלאָג
pszczoła - בין
pszenica - ווייץ
ptak - פֿויגל
pudełko - פּודעלע
pudel - פּודל
puder - פּודרע , פּודער
Puławy - פּולאַוו
pumeks - פּימס
purpurowy - פּורפּעלן
pustynia - מידבר
puszka - פּושקע
pysk - פּיסק
pytanie - פֿרעג
rabin - רבֿ , רבי
radio - ראַדיאָ ; ראַדיאָ
radość - פֿרייד ; פֿאַרגעניגן ; שׂימחה
rad - ראַדיום
raj - גן־עדן
ramię - אָרעם
rana - וווּנד
rano - אין דער פֿרי ; אינדערפֿרי
raptem - ראַפּטום
rasowy - ראַסנדיק
raz - איין מאָל ; איין מאָל ; איין מאָל
Rebeka - רבקה
ręcznik - האַנטעך /
regularny - רעגולער
rękawica - הענטשקע
ręka - האַנט
rekin - הײַפֿיש
religia - רעליגיע
renifer - רעניפֿער
ren - רעניום
Republika Czeska - טשעכישע רעפּובליק – טשעכיע
rewolucja - רעוואָלוציע
rezolucja - רעזאָלוציע
robić z igły widły - מאַכן פֿון אַ פֿליג אַ העלפֿאַנד
robić - מאַכן
robótka - געשטריקעכץ
robotnik - אַרבעטער
robot - ראָבאָט , גולמאַט
rodzajnik - אַרטיקל
rodzić - געבוירן ווערן
rodzic - טאַטע־מאַמע , עלטערן
rodzina - משפּחה
rodzynek - ראָזשינקע
rod - ראָדיום
rój - רוי
rok - יאָר
rolnik - פּויער
romantyczny - ראָמאַנטיש
rosa - טוי
Rosja - רוסלאַנד
roślina - געוויקס
rosół - יויך
rower - ראָווער
równanie - גלײַכונג
również - אויך
równik - עקוואַטאָר
równoległy - פּאַראַלעל
róża - רויז
rozczarowanie - אַנטוישונג
rozdzielać - אָפּטיילן, פֿאַרטיילן, פֿונאַנדערשיידן, טיילן
rozkład jazdy - פֿאָרפּלאַן
rozmowny - באַריידעוודיק
rozmyślać - באַטראַכטן , קלערן
różnorodny - פֿאַרשיידנדיק
różny - פֿאַרשיידן
różowy - ראָז
rozrywka - פֿאַרווײַלונג
rozsądny - רעסאָנדנע
rozumieć - פֿאַרשטיין
rozum - פֿאַרשטאַנד
rubid - רובידיום
rum - ראָם
ruten - רוטעניום
rutherford - רוטערפֿאָרדיום
ryba - פֿיש
Ryby - פֿיש
rycerz - ריטער
ryż - רײַז
rząd - רעגירונג ; ראָנד
rzeczownik - סובסטאַנטיוו
rzemieślnik - בעל־מלאָכה , האַנטווערקער
rzemiosło - מלאָכה
Rzeszów - רײַשע
rzeźnia - סאַלהאָן , שלאַכטהויז , סקאָטאָבויניע
rzeź - שחיטה
rzucać się w oczy - וואַרפֿן זיך אין די אויגן
rzucać - וואַרפֿן
rzymski - רוימיש
Rzym - רוים
sabotaż - סאַבאָטאַזש
sabotować - סאַבאָטירן
Sąd Ostateczny - יום־הדין
sagan - סאַגאַן
saksofon - סאַקסאָפֿאָן
salamandra - סאַלאַמאַנדרע
salami - סאַלאַמי
samar - סאַמאַריום
samobójstwo - אַליינמאָרד
samogłoska - וואָקאַל , נקודה
samolot - אַעראָפּלאַן
samotny - איינזאַם ,עלנט
sam - אַליין ; גופֿא
sandał - סאַנדאַל ; צינדלהאָלץ ; צינדל
sarkazm - סאַרקאַזם
sąsiad - שכן
satelita - סאַטעליט , לבֿנהלע
Saturn - סאַטורן
scena - סצענע ; בינע
ściana - וואַנט
ścięgno - שפּאַנאָדער
ścierka - סציערקע
ścierwo - שטשערווע
ścieżka - סטעשקע , וועגל , שטעג
seaborg - סיבאָרגיום
sejf - סייף
Sejm - סיים
sękaty - סוקעוואַטע
seksualny - געשלעכטיק , סעקסועל
selen - סעלעניום
seler - סעלעריע
semicki - סעמיטיש
sen - שלאָף ; חלום
serce - האַרץ
sezon - סעזאָן ; סעזאָן ; סעזאָן
sfinks - ספֿינקס
sfrustrowany - פֿרוסטרירט
siano - היי
siarka - שוועבל
siatkówka - נעצבאָל ; נעצהײַטל
siebie - זיך
sieć - נעץ
Siedlce - שעדליץ
siedzieć - זיצן
sierpień - אויגוסט
sierp - סערפּ , , שערפּ
się - זיך , מען/מע /
sikać - פּישן
siła - כּוח
silny - שטאַרק
sinus - סינוס
siostra - שוועסטער
siostrzenica - פּלימעניצע
skała - פֿעלדז , שטיין
skamieniałość - פֿאָסיל
skandalista - סקאַנדאַליסט
skarpeta - סקאַרפּעט
sklepikarz - קרעמער
sklep - קראָם
skomplikowany - קאָמפּליצירט
Skorpion - סקאָרפּיאָן
skroń - שלייף
skryba - שרײַבער , סופֿר
skrzynia - אָרון , סקריניע
skrzypce - פֿידל
skrzypek - פֿידלער
skuteczny - עפֿעקטיוו
ślad - שפּור , פֿוסדרוק ; סליד , זכר ; שפּור
slang - סלענג
śląski - שלעזיש
śledziona - מילץ
śledź - הערינג
ślepy - בלינד
ślimak - פּוילע־רוילע , שנעק
śliwka - פֿלוים
słodki - זיס
słońce - זון
słonecznik - זונרויז
słoń - העלפֿאַנד
słowik - סאָלאָוויי
słownik - ווערטערבוך /
słowo - וואָרט
słuchać - הערן
słup - סלופּ
słyszeć - הערן
smaczny - געשמאַק
smakować - פֿאַרזוכן
smak - געשמאַק ; טעם
smętny - אומעטיק
śmierć - טויט
śmierdzieć - שטינקען
śmietana - סמעטענע
smok - שמאָק , פּיפּערנאָטער
śniadanie - פֿרישטיק , איבערבײַסן
śnieg - שנײ
sobą - זיך
sobie - זיך
sobota - שבת
socjalista - סאָציאַליסט
socjalistyczny - סאָציאַליסטיש
socjalizm - סאָציאַליזם
soczysty - זאַפֿטיק
sód - נאַטריום
sok - זאַפֿט , סאָק
sola - ים־צונג
solidarność - סאָלידאַריטעט , שאָלידאַרישקייט
sól - זאַלץ
Sopot - סאָפּאָט
sopran - סאָפּראַן
sosna - סאָסנע
sos - סאָס
sowa - סאָווע
spacer - שפּאַציר
spać - שלאָפֿן
spadać - פֿאַלן
spichrz - שפּײַכלער
śpiewać - זינגען
śpiewnik - לידערבוך
śpiew - געזאַנג
spódnica - האַלב קליידל
spojrzenie - אַרויסקוק ;קוק
spółgłoska - קאָנסאָנאַנט
sposób - אופֿן
spóźniać się - פֿאַרשפּעטיקן , פֿאַרשפּעטיקן זיך
sprawiedliwie - גערעכט
sprawiedliwość - גערעכטיקייט
Sprawiedliwy wśród Narodów Świata - חסידי־אומות־העולם
sprzedawać - פֿאַרקויפֿן
sprzedawca - פֿאַרקויפֿער
sprzedawczyni - פֿאַרקויפֿערין
sprzyjać - באַגינסטיקן
sraczka - דורכפֿאַל
srać - קאַקן
srebrny - זילבער
średnik - פּינטל־קאָמע
średniowiecze - מיטל־עלטער
środa - מיטװאָך
środkowy - מיטל
środowisko - סבֿיבֿה
śródziemnomorski - מיטלענדיש
śrubokręt - שרויפֿן־ציִער
ssać - זויגן ; סמאָקטשען
stać - שטיין
stadion - סטאַדיאָן
stała - קאָנסטאַנט
stal - שטאָל
Stany Zjednoczone - פֿאַראייניקטע שטאַטן פֿון אַמעריקע
stary - אַלט
stawiać - שטעלן ; אויפֿשטעלן
stodoła - שײַער
stolarz - סטאָליער
stolica - הויפּטשטאָט
stopa - פֿוס
stosunek - באַציִונג
stowarzyszenie - אַסאָציאַציע , בינדונג , פֿאַרבאַנד , פֿאַראייניקונג
stożek - קאָנוס
strachliwy - מוראוודיק
strach - מורא
straszny - מוראדיק
Strefa Gazy - עזה־שטרײַף , עזה־פּאַס
strona - זײַט
stront - סטראָנטייִום
stróż - סטראָזש , סטרוזש
strzała - פֿײַל
strzelać - שיסן
student - סטודענט ; לערנער – studiujący święte księgi
studia - לימודים
studiować - שטודירן
studnia - ברונעם
styczeń - יאַנואַר
styl - סטיל
suchy - טרוקן
sukces - הצלחה , באַגליק , סוקצעס
sukienka - קליידל
suknia - קלייד
sumienie - געוויסן
sutanna - סוטאַנע
światło - ליכט /
świątynia - טעמפּל
świat - וועלט
świeca - ליכט /
świecznik - לײַכטער
świerk - טענענבוים
świerszcz - גריל
święty - הייליקער
świnia - חזיר
świnka morska - ים־חזירל
świnka - חזירל ; מומס , חזירל
świństwo - חזירײַ
świt - באַגינען
sygnał - סיגנאַל
syjonizm - ציוניזם
syk - סיקעניש
symbol - סימבאָל
symfonia - סימפֿאָניע
symptom - סימפּטאָם
synagoga - שול
synonimiczny - סינאָנים
synonim - סינאָנים
synowa - שנור
syn - זון
sytuacja - סיטואַציע
szachownica - שאָכברעט
szachy - שאָך
szacunek - אוּוואַדזשעניע ,רעספּעקט ,דרך־ ארץ
szafka - שאַפֿקע
szaleństwo - טיפּשות
szalik - שאַליק
szambo - אָפּגאַנגגרוב
szampan - שאַמפּאַניער
szampon - שאַמפּו
szarańcza - היישעריק
szary - גרוי
szatan - שׂטן
szczaw - לאָבידע , שטשאַוו
Szczebrzeszyn - שעברעשין
szczególnie - באַזונדערש
szczególny - zvláštní, neobvyklý, speciální výjimečný
szczególny - באַזונדער
szczekać - האַווקען
szczerze - פֿראַנק ,אָפֿנהאַרציק
szczoteczka do zębów - ציינבערשטל
szczotka - באַרשט
szczupak - העכט
szczur - שטשור , ראַץ
szef - שעף , ראָש
szeroki - ברייט
szerszeń - פֿערדבין
szewc - שוסטער
szezlong - שעזלאָנג
szkielet - געביין , סקעלעט
szkło - גלאָז
Szkocja - שאָטלאַנד
szkoła podstawowa - פֿאָלקשול
szkoła - שולע , שול
szlafrok - באָדכאַלאַט
szlug - שלוג
sznurowadło - שוכבענדל
sznur - שטריק , שנור /; שרוך
szofar - שופֿר
szparag - שפּאַרזשע , שפּאַרגל
szpilka - שפּילקע
szpinak - שפּינאַט
szpital - שפּיטאָל /
szpunt - שפּונט
sztuka - קונסט ; שטיק ; שפּיל
sztylet - שטילעט
szuflada - שופֿלאָד
szum - גערויש
Szwecja - שוועדן
szwindel - שווינדל
szybki - שנעל , גיך
szybko - שנעל , געשווינד , גיך
szydełkować - העקלען, שטריקן
szydełko - העקל
Szydłowiec - שידלאָווצע
szyszka - שישקע
tabaka - טאַביקע , טאַבאַק
taboret - טאַבורעט
taca - טאַץ
tajga - טײַגע
tak sobie - נימער־ערגער
taksówka - טאַקסי
tak - אַזוי ; יאָ
talerz - טעלער
tandetny - טאַנדעט
tango - טאַנגאָ
tani - וואָלוול , ביליק ; טאַנדעט
tapeta - טאַפּעטן , שפּאַליר
Tarnów - טאָרנע
tata - טאַטע
tatuś - טאַטעשי
tchórz - פּחדן , טכויר ; טכויר
teatr - טעאַטער
techniczny - טעכניש
technokracja - טעכנאָקראַטיע
technokratyczny - טעכנאָקראַטיש
tęcza - רעגן־בויגן
tekst - טעקסט
telefoniczny - טעלעפֿאָניש
telefon komórkowy - מאָביל־טעלעפֿאָן
telefonować - טעלעפֿאָנירן
telefon - טעלעפֿאָן
teleskop - שפּאַקטיוו
telewizja - טעלעוויזיע
telewizor - טעלעוויזאָר
temat - טעמע , מאָטיוו
tempo - טעמפּ
temu - מיט ... צוריק
ten sam - זעלביק , זעלב
teologia - טעאָלאָגיע
teraz - איצט , אַצינד
termometr - טערמאָמעטער
terrorysta - טעראָריסט
terrorystyczny - טעראָריסטיש
teściowa - שוויגער
teść - שווער
tęsknić - בענקען
tęsknota - בענקשאַפֿט , בענקעניש
testament - צוואה
tkanka - געוועב
tlen - אָקסיגען
tłumacz - איבערזעצער
tolerancja - טאָלעראַנציע
topnieć - צעגיין
Tora - תּורה
tornister - רענצל
tort - טאָרט
tost - טאָסט
towarzyszyć - באַגלייטן
towar - סחורה
trąba - שנוק
tracić - אָנווערן , פֿאַרלירן ; דערלייגן , צולייגן
tradycja - טראַדיציע
tragedia - טראַגעדיע
tragiczny - טראַגיש
tragikomedia - טראַגיקאָמעדיע
tramwaj - טראַמווײַ
transformator - טראַנספֿאָרמאַטאָר
tratować - טרעטן
trawa - גראָז
trawnik - גראָזגאָרטן
trefny - טרייפֿן ; טרייף
trochę - אַ ביסל
Troja - טרויע
trójkąt - דרײַעק
troska - קלאַפּאָט
troszeczkę - אַ ביסעלע
trucizna - סם
trudny - שווער
truizm - טרויִזם , פֿאַרשטייט־זיך
trujący - סמיק
trumna - טרונע
trupa - טרופּע
truskawka - טרוסקאַווקע
trzęsienie ziemi - ערד־ציטערניש
trzeźwy - ניכטער
tulipan - טולפּאַן
tumult - טומל
tuńczyk - טונפֿיש
Turcja - טערקײַ
tuzin - טוץ
tu - דאָ
twardy - האַרט ; שווער
twarz - פּנים
twój - דײַן
tybetański - טיבעטיש
tygrys - טיגער
tylko - נאָר
tył - הינטן
typografia - טיפּאָגראַפֿיע
typ - טיפּ
tytoń - טאַביקע
ty - דו
ubezpieczenie - פֿאַרזיכערונג , סטראַכירונג , אַסעקוראַציע
uchodźca - פּליט
uchodźczyni - פּליטה
uciekać - אַנטלויפֿן ,אַוועקלויפֿן
uczciwie - בנאמנות
uczeń - תּלמיד
uczyć - לערנען זיך
udo - דיך
układ okresowy pierwiastków - פּעריאָדישע סיסטעם פֿון כעמישע עלעמענטן
układ okresowy - פּעריאָדישע טאַבעלע , פּעריאָדישע סיסטעם
ułamek - בראָכצאָל , תּשבורת ; בראָכטייל
ułaskawienie - באַגנאַדיקונג
ulica - גאַס
uliczka - געסקע
ulubiony - באַליבט
umysł - מוח
Unia Europejska - אייראָפּעיִשער פֿאַרבאַנד
uniwersytet - אוניווערסיטעט
upał - היץ
uparciuch - עקשן
uparty - פֿאַרעקשנט
uprawiać - באַאַרבעטן
urna - אורנע ; קלפֿי
urząd - אַמט
USA - פֿש״אַ
ustawa - געזעץ
usta - מויל
utopia - אוטאָפּיע
utrzymywać - טענהן
uwertura - אוּווערטור
Uzbekistan - אוזבעקיסטאַן
użytkownik - באַניצער
wagary - אָפּציִערײַ
waga - וואָג
Waga - וואָג
wałek do ciasta - וואַלגערהאָלץ
walet - פּויער
Walia - וויילז
walizka - וואַליזקע , וואַליזע , טשעמאָדאַן
walka - קאַמף , געשלעג , געראַנגל
waluta - וואַלוטע
wampir - וואַמפּיר ; וואַמפּיר
wanilia - וואַניל
wapń - קאַלציום
warkocz - צאָפּ
Warszawa - וואַרשע
warszawiak - וואַרשעווער
warszawianin - וואַרשעווער
warszawski - וואַרשעווער
wartość - ווערט / ; שאַץ
warzywo - גרינס
wąski - שמאָל
Waszyngton - וואַשינגטאָן
wąs - וואָנצע
wątpliwość - ספֿק
wątpliwy - ספֿקדיק
wątroba - לעבער
Watykan - וואַטיקאַן
ważny - וויכטיק , וואָגיק , חשובֿ ; גילטיק
wąż - שלאַנג
wczesny - פֿריִיִק
wczorajszy - נעכטיק
wczoraj - נעכטן
wdowa - אַלמנה
wdychać - אָטעמען
wegetarianin - וועגעטאַריער
wegetariański - וועגעטאַריש
węgiel - קוילנשטאָף ; קויל /
węgorz - אייל
wełna - וואָל ; וואָל
welon - דעקטוך
wena - ווענע
Wesołych Świąt - פֿרײלעכע ניטל
węzeł - קנופּ
wiadro - עמער
wiatr - ווינט
widelec - גאָפּל
widły - ווידלע
widz - צוקוקער
Wiedeń - ווין
wiedza - וויסן
wiedzieć - וויסן
wiejski - דאָרפֿיש
wiek - יאָרהונדערט
wielbłąd - קעמל
Wielka Brytania - גרױסבריטאַניע
Wielkanoc - קייסעך ''katolicyzm''; פּאַסכע ''prawosławie''
wielkoduszny - ברייטהאַרציק
wielojęzyczny - עטלעך־שפּראַכיק
wieloryb - וואַלפֿיש
wielunianin - וויעלונער
wieluński - וויעלונער m
Wieluń - וויעלון
wiersz - ליד
wierzba - ווערבע
wieśniak - פּויער , כלאָפּ
wieś - דאָרף
wiewiórka - וועווערקע
wieża Babel - בבֿל
wieża - טורעם
wigilia - ערבֿ
wikiholik - וויקיהאָליקער
Wikipedia - וויקיפּעדיע
Wikisłownik - וויקיווערטערבוך /
Wikiźródła - װיקיביבליאָטעק
wiklina - פֿלעכטוואַרג
wilkołak - ווילקאָלאַק
wilk - וואָלף
Wilno - ווילנע
winda - ליפֿט
winnica - ווײַנגאָרטן
winny - שולדיק
wino - ווײַן
wiosna - פֿרילינג
wisieć - הענגען
Wisła - ווײַסל
wizjer - לעכל
wizyta - וויזיט
wkrótce - באַלד
władca - הערשער , מושל
właściciel - בעל־הבית
własny - אייגן
Włocławek - וולאָצלאַוועק
włóczęga - וואַגאַבונד , וואַנדערער , שלעפּער
włoski - איטאַליעניש ; איטאַליעניש ; הערל
włos - האָר
woda - וואַסער
wojna domowa - בירגערקריג , בירגער־מלחמה
wojna - מלחמה
wojskowy - מיליטעריש
wokół - אַרום
wola - ווילן
wolnomularz - פֿרײַמײַער
wół - אָקס
wosk - וואַקס
wózek inwalidzki - רעדערשטול
wózek - וואָגן
woźnica - בעל־עגלה
wróbel - שפּערל
wrogi - פֿײַנדלעך
wrona - קראָ
wróżka - פֿעע
wrzesień - סעפּטעמבער
wschodzić - אויפֿגיין
wschód - אויפֿגאַנג ; מיזרח
wspaniałomyślny - ברייטהאַרציק
współczesny - הײַנטצײַטיק
wstydzić się - שעמען זיך
wstyd - חרפּה , בושה , שאַנד , בזיון
wszystko - אַלץ , אַלצדינג
wtedy - דעמלט , דעמאָלט , דאַן
wtorek - דינסטיק
wtrącać - אַרײַנמישן
wulkaniczny - וווּלקאַניש
wulkan - וווּלקאַן
wybaczać - פֿאַרגעבן
wybory - וואַלן
wybór - אָפּקלײַב
wycieczka - אויספֿלוג ,עקסקורסיע
wyjątek - ויסנעם
wyjeżdżać - אַוועקפֿאָרן ,אַרויספֿאָרן
wykałaczka - צאָנשטעכער
wykrzyknik - אויסרוף־צייכן ; אינטעריעקציע
wykształcony - קולטורעל
wyłącznie - דווקא
wynagrodzenie - פּיידע
wysokie napięcie - הויכוואָלטאַזש
wysoko - הויך|הויכ…&amp;rlm;
wyspa - אינדזל
wystawa - וויטרינע , ווײַזפֿענצטער ; אויסשטעלונג
wytrwałość - אויסדויער
wywiad - אינטערוויו ; אויסשפּיר
wyznanie - אמונה , נאמנה ''lub nie żydowskie'' דענאָמינאַציע ; מודה
wy - איר
wzdłuż - בײַ
zabawka - צאַצקע , שפּילכל
żaba - זשאַבע
żabka - זשאַבקעלע
ząb - צאָן
zachód - &amp;rlm;אונטערגאַנג ; מערבֿ
Zachód - מערבֿ־וועלט
żądać - פֿאָדערן
żądło - שטאָך
żagiel - זעגל
zagłada - אומקום , פּאָהיבל
zagrożenie - סכּנה
zaimek - פּראָנאָם
zając - האָז
zakonnica - מאָנאַשקע
załącznik - צוטשעפּעניש
zaleta - זכות ,מעלה
żal - טרויער
zamek błyskawiczny - בליצשלעסל
zamek - שלאָס ; שלעסל , בליצשלעסל
zapaleniec - פֿאַרברענטער
zapałka - שוועבעלע
zapalniczka - אָנצינדער
zapamiętywać - אײַנחזרן
zapominać - פֿאַרגעסן
zarabiać - פֿאַרדינען
żargon - זשאַרגאָן
żarłok - פֿרעסער
żarówka - לעמפּל
żartować - וויצלען זיך ,חכמהן ,שפּאַסן
zasrany - פֿאַרקאַקט
zawodzić - יאָמערן
zawód - פּראָפֿעסיע ; אַנטוישונג
zazdrość - קינאה
zazwyczaj - בדרך־כּלל
zbędny - אומנייטיק
żbik - וואַלדקאַץ
zboże - תּבֿואה
zbrodnia katyńska - קאַטינער הריגה
zdrada - בגידה
zdrowie - געזונט
zdrowy - געזונט
żeby - כּדי
zegarek - זייגערל
zegarmistrz - זייגער-מאַכער , זייגער־מאַכער
zegar słoneczny - זונזייגער
zegar - זייגער
żelazko - פּרעסײַזן , פּרעסל
żelazo - אײַזן
zemsta - נקמה
żeński - ווײַבלעך , פֿעמינין
zeszyt - העפֿט
zez - שיקלען
Zgierz - זגערזש
zgryzota - צער
zielony - גרין
Ziemia - ערד
ziemniak - בולבע
zima - ווינטער
zimny - קאַלט
złamać - צעברעכן
złodziej - גנבֿ , לאַטכער
złość - כּעס , געבייזער
złotówka - גילדן
złoty - גאָלד ; גילדן
zmartwienie - צער ,צרה ,ד אגה ,טרויער ,ערגערניש
zmęczony - מיד , פֿאַרמאַטערט
zmiana - ענדערונג , בייטונג ; אַרבעטערגרופּע
zmieniać - איבערבײַטן ,וואַריִיִרן
zmysł - חוש
znaczek pocztowy - מאַרקע
znaczenie - באַדײַטונג
znać - קענען
znajomy - באַקאַנטער
znany - באַוווּסט
zob. - זען
żołądek - מאָגן
żółty - געל
żółw - טשערעפּאַכע
zołza - יענטע
żona - פֿרוי , ווײַב
z powrotem - צוריק
z reguły - בדרך־כּלל
źródło - קוואַל
zrozumienie - פֿאַרשטענדעניש ;פֿאַרשטאַנד
zsiadłe mleko - זויערמילך
ZSRR - פֿסס״ר
zupa - זופּ
Związek Socjalistycznych Republik Radzieckich - פֿאַרבאַנד סאָוועטישע סאָציאַליסטישע רעפּובליקן
związek - בונד
związywać - צובינדן , פֿאַרבינדן ; בינדן
zwierzę domowe - גלעטלינג
zwierzę - חיה , בעל־חי
zwłoki - טויטער , ברמינן , מת
zwolennik - אָנהענגער
zwyciężać - געווינען
zwyrodnialec - דעגענעראַט
życie - לעבן
żyć - לעבן
żydowski - ייִדיש
żyd - ייִד
Żyd - ייִד
żylak - געדראָלענע אָדערן
żyła - אָדער
żyletka - גאָלמעסערל
żyrafa - זשיראַף
żyrandol - הענגלײַכטער , זשיראַנדאָל
zysk - רווח , פּראָפֿיט ; נוץ , נוצן
żywy - לעבעדיק , שלאָגיק ; זשוואַווע , שלאָגיק
-ż - זשע
