0. - 0a, 0.
10. - 10a
1. - 1a
2. - 2a
3. - 3a
4. - 4a
5. - 5a
6. - 6a
7. - 7a
8. - 8a
9. - 9a
AA - AA
Aaron - Aarono
abakus - abako; abako
abandon - forlaso
abażur - abaĵuro, lampoŝirmilo
abażurek - abaĵureto, lampoŝirmileto
ABC - aboco
abchaski - abĥaza
Abchaz - abĥazo
Abchazja - Abĥazio
abduktor - abduktoro
abdykacja - abdiko, eksiĝo
abdykować - abdiki
Abelard - Abelardo
Abel - Habelo
aberracja - aberacio
Abidżan - Abiĝano
abiogeneza - abiogenezo
Abisyńczyk - abiseno
Abisynia - Abisenio, Abisenujo
abiturient - abituriento
Ab - Oba
abonament - abono
abonent - abonanto
aborcja - abortigo
Aborygen - aborigeno
Abraham - Abrahamo
Abruzja - Abruzo
absces - absceso
absolutny - absoluta
absolutyzm - absolutismo
absorbent - absorbilo
absorpcja - absorbo; absorbo
abstrahować - abstrakti; abstrakti
abstrakcja - abstrakto, abstraktaĵo; abstraktado
abstrakcyjny - abstrakta; abstrakta; abstraktisma, abstraktista
abstrakt - abstrakto, abstraktaĵo
abstynencja - abstinenco, abstino, abstineco, abstinado
abstynent - abstinenculo
absurd - absurdo, absurdaĵo
Abudża - Abuĝo
abudżańczyk - abuĝano
abudżanka - abuĝanino
Abu Zabi - Abu-Dabio
Abwehra - Abwehr
aceton - acetono
acetylen - acetileno
Achilles - Aĥilo
adadżio - adaĝo; adaĝa; adaĝe
Adalbert - Adalberto
Adam - Adamo
adamaszek - damasko
adapter - adaptilo
Addis Abeba - Adis-Abebo, Adis-Ababo
Adelajda - Adelajdo
adept - adepto; adepto
adiabata - adiabato, adiabata kurbo
adipocyt - adipocito
administrator - administranto, administratoro
admirał - admiralo; admiralo
Adolf - Adolfo
Adonis - Adoniso
adorować - adori
adres - adreso
adresat - adresato
Adriatyk - Adriatiko
adwent - advento
adwentysta - adventisto
adwokat - advokato
adwokat Boga - diadvokato
adwokat diabła - advokato de la diablo
aerodrom - aerodromo
aerodynamiczny - aerodinamika
aerodynamika - aerodinamiko
aerometr - aerometro
aeronauta - aeronaŭto
aeronautyka - aeronaŭtiko
aerostat - aerostato
afazja - afazio
afektacja - afekto, afektado
afekt - afekcio; afekcio
afektować - afekti
afektowany - afekta
afera - skandalo
afereza - aferezo
aferzysta - skandalisto
Afgańczyk - afgano
Afganistan - Afganio, Afganistano, Afganujo
Afganka - afganino
afgański - afgana
afiks - afikso
afirmacja - afirmacio
afirmować - afirmi
afisz - afiŝo
aforyzm - aforismo
Afrodyta - Afrodito, Afrodita
Afryka - Afriko
Afrykanin - afrikano
Afrykanka - afrikanino
afrykański - afrika
afta - afto
Agata - Agata
agat - agato
agawa - agavo
agenda - agendo
agent - agento; agento; agento
Ag - Ĥag
agitator - agitisto, agitanto
agnat - agnato
agnostycyzm - agnostikismo
agnostyczny - agnostika
agnostyk - agnostikulo
agonia - agonio
agorafobia - agorafobio
agrafka - agrafo
agresja - agreso; agreso
agresor - agresanto
agrest - groso
agresywny - agresema, agresiva
agronom - agronomo, agronomiisto
agronomia - agronomio
AIDS - aidoso
aikido - aikido, ajkido
akacja - akacio
akademia - Akademio; akademio
akademicki - akademia
akademik - akademiano; studento; studentejo
a - kaj; sed; a
akcent - akcento
akceptować - akcepti
akcja - akcio
akcjonariusz - akciulo
aklamacja - aklamo
akolita - akolito
akompaniament - akompano
akompaniator - akompananto
akompaniatorka - akompanantino
akompaniować - akompani
akord - akordo
akordeon - akordiono
akordeonista - akordionisto
Akra - Akrao
akr - akreo, akro
akrobata - akrobato
akryjczyk - akraano
akryjka - akraanino
akryjski - akraa
aksamit - velur
aksjomat - aksiomo
aksjomatyczny - aksioma
akt - akto; akto
aktor - aktoro
aktorka - aktorino
aktualny - aktuala
aktyn - aktinio
akumulator - akumulatoro, akumulilo
akupunktura - akupunkturo
akuszerka - akuŝistino
akwarium - akvario
akwedukt - akvedukto
Alabama - Alabamo
alabaster - alabastro
alarm - alarmo
Alaska - Alasko
alba - albo
Albańczyk - albano
Albania - Albanio, Albanujo
Albanka - albanino
albański - albana
Albert - Alberto
albinizm - albinismo
albinos - albino
albit - albito
albo - aŭ
album - albumo
albuminuria - albuminurio
alchemia - alĥemio, alkemio
alchemik - alĥemiisto, alkemiisto
aldehyd - aldehido
alegoria - alegorio
Aleksander - Aleksandro
alergen - alergeno
alergia - alergio
alergik - alergiulo
ale - sed
alfa - alfao
alfabet - alfabeto, aboco
alfabetyczny - alfabeta; alfabeta
Alfons - Alfonso
Alfred - Alfredo
algebra - algebro
Algier - Alĝero
algierczyk - alĝerano
Algierczyk - alĝeriano
Algieria - Alĝerio
algorytm - algoritmo
alians - alianco
alibi - alibio
Alicja - Alico
aligator - aligatoro
alimenty - alimentoj
aliteracja - aliteracio
alkohol - alkoholo
alkoholik - alkoholulo
alkoholizm - alkoholismo
alkoholowy - alkohola
aloza - alozo
alpaka - alpako
alpejski - alpa
alpinista - alpisto
Alpy - Alpoj
alt - aldo; aldisto
alternator - alternatoro
altówka - aldviolono, aldo
altruista - altruisto
ałun - aluno
aluzja - aludo
Am - Amo
amarantowy - amaranta; amaranta
amarylis - amarilido
amator - amatoro
Amazonia - Amazonio
amazonka - amazono
Amazonka - Amazono; amazono
amazoński - amazonia; amazona
ambasada - ambasado; ambasadejo, ambasadorejo
ambasador - ambasadoro
ambicja - ambicio
ambitny - ambicia
ambona - predikejo
ambra - ambro
Ambroży - Ambrozio
ambulans - ambulanco
ameba - amebo
Ameryka - Ameriko
ameryk - americio
Amerykanin - usonano
amerykanizacja - amerikanizacio
amerykański - amerikana
Ameryka Południowa - Sudameriko
ametyst - ametisto
ametystowy - ametista
amfibia - amfibio
amfiteatr - amfiteatro
amfora - amforo
Amman - Amano
ammańczyk - Ammanano
ammanka - Ammananino
amnestia - amnestio
amoniak - amoniako
amonit - amonito, amonit
amorficzny - amorfa
amper - ampero
amperogodzina - amperhoro
amperomierz - ampermetro
amplituda - amplitudo
ampułka - ampolo
amputacja - amputo
amputować - amputi
Amsterdam - Amsterdamo
amsterdamczyk - Amsterdamano
amsterdamka - amsterdamanino
Amu-daria - Amudarjo
amulet - amuleto
amunicja - municio
anachoreta - anakoreto
anagram - anagramo
anakonda - anakondo
analfabeta - analfabeto
analityczny - analiza; analiza
analityk - analizisto
analiza - analizo
analizować - analizi
analogia - analogio, analogeco
analogiczny - analoga, analogia
ananas - ananasujo; ananaso
anapest - anapesto
anarchista - anarkiisto, anarĥiisto
anarchizm - anarkiismo, anarĥiismo
Anastazja - Anastazio, Anastazia
Anastazy - Anastazio
anatom - anatomiisto, anatomo
anatomia - anatomio
anatomiczny - anatomia
Andaluzja - Andaluzio
Andora - Andoro; Andoro Malnova
Andorczyk - andorano
Andorka - andoranino
andorski - andora
Andromeda - Andromedo; Andromedo
Andrzej - Andreo
Andy - Andoj
anegdocista - anekdotisto
anegdota - anekdoto
anegdotyczny - anekdota
aneks - anekso
aneksja - aneksado, anekso
anektować - aneksi
anemometr - anemometro
anestezjolog - anestezisto; anestezisto
Angielka - Anglino
Anglia - Anglio, Anglujo
Anglik - anglo
Ania - Anjo
anilina - anilino
animusz - vervo, fervoro, kuraĝo
ani - nek; nek; nek; nek; nek
anioł - anĝelo; anĝelo
Anioł Pański - anĝeluso
anioł stróż - gardanĝelo
ankarczyk - Ankarano
ankarka - Ankaranino
Anna - Anno
ansa - rankoro
antagonizm - antagonismo
Antananarywa - Antananarivo
antananarywczyk - Antananarivano
antananarywka - Antananarivanino
Antek - Antoĉjo
antena - anteno
Antoni - Antonio, Antono
antrakt - interakto, paŭzo
antropologia - antropologio
antropomorfizm - antropomorfismo
antyczny - antika
antyk - antikvo; antikvaĵo
antykwariusz - antikvaĵisto
Antyle Holenderskie - Nederlandaj Antiloj
antymon - antimono
antypapież - antipapo
antysemita - antisemito
anyż - aniso
Ap - Apo
aparat - aparato
aparat fotograficzny - fotilo
apartament - apartamento
apel - alvoko
Apeniny - Apeninoj
apercepcja - percepto, apercepto
apetyt - apetito
apetyt rośnie w miarę jedzenia - dum la manĝado venas apetito
Apia - Apio
Apollo - Apolono; Apolono
apolog - apologo
apostata - apostato
apostrof - apostrofo
apoteoza - apoteozo, diigo
aprowizacja - provizado, aprovizado
apsyda - absido
apteka - apoteko
arab - araba ĉevalo
Arab - arabo
Arabia Saudyjska - Saŭda Arabio
arabski - araba
arachnofobia - araneofobio
Aragonia - Aragono
ar - aro
arbitralny - arbitra
arbuz - akvomelono; akvomelono
archaiczny - arkaika
archanioł - arkianĝelo
archeolog - arĥeologo
archeologia - arkeologio
Archimedes - Arkimedo
archipelag - insularo, arkipelago
architekt - arkitekto, arĥitekto, arkitekturisto, arĥitekturisto
architektoniczny - arkitektura, arĥitektura
architektura - arkitekturo, arĥitekturo
arcybiskup - ĉefepiskopo
arcydzieło - ĉefverko
arena - areno; areno
argentan - arĝentano
Argentyna - Argentino
argon - argono
argument - argumento
aria - ario
arka - arkeo; arkeo
arkebuz - arkebuzo
arkusz kalkulacyjny - tabelkalkulilo
armata - pafilego, kanono
armia - armeo
arsen - arseno
arteria - arterio
Artur - Arturo
artykuł - artikolo
artysta - artisto
-arz - ist
as - aso; aso, asaro
asfalt - asfalto
asmarczyk - Asmarano
asmarka - Asmaranino
aspiryna - aspirino
astańczyk - Astanano
astanka - Astananino
astat - astato
asteroida - asteroido
asterysk - asterisko
astma - astmo
astmatyk - astmulo
astrolog - astrologo, astrologiisto
astrologia - astrologio
astrologiczny - astrologia
astronom - astronomo, astronomiisto
astronomia - astronomio
astronomiczny - astronomia
Asyria - Asirio
atak - atako; atako; atako
atawistyczny - atavisma
atawizm - atavismo
ateista - ateisto
ateizm - ateismo
ateńczyk - atenano
atenka - atenanino
Ateny - Ateno
atom - atomo
atrakcja - atrakcio, allogaĵo
atrakcyjność - allogeco
atrament - inko
atramentowy - inka; inkkolora
Aurora - Aŭroro, Aŭrora; Aŭroro, Aŭrora
Australia - Aŭstralio; Aŭstralio
Australijczyk - aŭstraliano
Australijka - aŭstralianino
australijski - aŭstralia
Austria - Aŭstrio, Aŭstrujo
autobiografia - aŭtobiografio
autobus - aŭtobuso
autobusowy - aŭtobusa
auto- - mem
autoportret - memportreto
autopsja - aŭtopsio
autor - aŭtoro
autostrada - aŭtostrado
autystyczny - aŭtisma
autyzm - aŭtismo
Azerbejdżan - Azerbajĝano
Azja - Azio
Azjata - aziano
Azjatka - azianino
azot - azoto
azyl - azilo; azilo
Ba - Bar
baba - virinaĉo
babcia - avino
babsztyl - virinaĉo
bać się własnego cienia - timi sian propran ombron
Badenia-Wirtembergia - Baden-Virtembergo
bagażnik - pakaĵujo
bagaż - pakaĵo, pakaĵaro, bagaĝo
bagietka - bastonpano
bagnet - bajoneto
bagno - marĉo
Bahrajn - Barejno
Bahrajńczyk - barejnano
Bahrajnka - barejnanino
Bahrańczyk - barejnano
Bahranka - barejnanino
bahrański - barejna
bajka - fablo, fabelo
bajt - bitoko
bakelit - bakelito
bakłażan - melongeno; melongeno
bakłażanowy - melongena
bąk - tabano; granda botaŭro; turbo
bakteria - bakterio
bakteryjny - bakteria
bak - vangharoj
bal - balo
baldachim - baldakeno
balet - baleto
balia - lavujo, lavkuvo
balkon - balkono
ballada - balado
balustrada - balustrado
bałwan - neĝhomo
bambus - bambu
banan - banano
bananowy - banana
Bangladesz - Bangladeŝo
bańka mydlana - sapveziko
bank - banko
bankomat - bankaŭtomato
baptyzm - baptismo
baranina - ŝafaĵo
Baran - Ŝafo; Ŝafo
baran - virŝafo
Barbara - Barbara
barchan - fusteno
bardzo - tre
Bartłomiej - Bartolomeo
bar - trinkejo; bario; baro
baskijski - eŭska, vaska; la eŭska, la vaska
bastion - bastiono; bastiono
bawełna - kotonujo, kotonarbo, gosipio; kotono
bawić - amuzi
bażant - fazano
bazar - bazaro
Bazyli - Bazilo
bęben - tamburo
bekas - skolopo
Belg - belgo
Belgia - Belgio
Belgijka - belgino
belgijski - belga
Belgrad - Beogrado
belgradczyk - beogradano
belgradka - beogradanino
belgradzki - belgrada
belka - trab; vekt
bemol - bemolo
Benedykt - Benedikto
Benin - Benino
Benińczyk - beninano
Beninka - beninanino
beniński - benina
benzyna - benzino
berkel - berkelio
Berlin - Berlino
berlińczyk - berlinano
berlinka - berlinanino
berliński - berlina
Berlin Zachodni - Okcidenta Berlino
Bernard - Bernardo
Berta - Berto
beryl - berilio
beton - betono
bezalkoholowy - senalkohola
bezbarwny - senkolora
bezbożnictwo - sendieco, sendiismo
bezbożnik - sendiulo
bezbożność - sendieco, sendiismo
bezdzietny - seninfana
beżowo - sablokolore
beżowy - sablokolora
bezpiecznik - fuzeo
bezpieczny - eksterdanĝera, sekura; sendanĝera
bez - siringo; sen
bezwartościowy - senvalora; senvalora
białko - ovblanko; proteino
Białoruś - Bjelorusio, Belorusujo, Belorusio, Bjelorusujo
białostocki - bjalistoka
biały - blanka
Białystok - Bjalistoko
Biblia - Biblio
biblijny - biblia
biblioteka - biblioteko, libraro
biblista - bibliisto
biblistka - bibliistino
bić - bati
biec - kuri
biedak - povrulo
biedny jak mysz kościelna - malriĉa kiel muso preĝeja
biedny - povra
biedronka - kokcinelo
biegać - kuri
bieg - kuro; rapidumo
biegun - poluso; poluso
biel - blanko; alburno
bieługa - huzo
biernik - akuzativo
bierzmować - konfimacii, konfirmi
bierzmowanie - konfimacio, konfirmo
bigos - bigoso
bilet - bileto
biskup - episkopo
biuro matrymonialne - svatagentejo
biuro - oficejo
biust - busto
biustonosz - mamzono, brustotenilo
bizmut - bismuto
błąd - eraro
błękit - bluo
bliski - proksima
Bliski Wschód - Mezoriento, Meza Oriento
blisko - proksime
blizna - cikatro
Bliźnięta - Ĝemeloj; Ĝemeloj
blok - bloko; bloko, blokado; bloko
blok mieszkalny - blokdomo
blond - blonda
blondyn - blondulo
blondynka - blondulino
błotnik - kotŝirmilo
błoto - koto
bluszcz - hedero
błyskawica - fulmo
boa - boao; boao
bób - fabo
bóbr - kastoro
bocian - cikonio
bociani - cikonia
Bóg dał, Bóg wziął - Dio donis, Dio prenis
bóg - dio
Bóg - Dio
bogini - diino
bohater - hero
bohr - borio
ból - doloro
boleć - dolori
bolesny - dolora, doloriga
Boliwia - Bolivio
Boliwijczyk - boliviano
Boliwijka - bolivianino
boliwijski - bolivia
bombarda - bombardilo
boraks - borakso
bor - boro
Borys - Boriso
Boże Narodzenie - Kristnasko
boży - dia
brać - preni
brakować - manki
brama - pordego; pordego
bramka - pordeto; golejo; golo
bramkarz - golejisto, golulo
bratanek - nevo, fratido
braterstwo - frateco; frateco
brat - frato
bratowa - bofratino
brąz - bronzo; bronzaĵo; bruno; bronzepoko
brązowy - bruna; bronza
Brazylia - Brazilo
brew - brovo
broda - mentono; barbo
brokuł - brokolo
brokułowy - brokola
brom - bromo
broń - batalilo
bronować - erpi
broszura - broŝuro
browar - bierfarejo
brudnopis - malneto
brukiew - napo
bruk - pavimo
brukselka - burĝonbrasiko, bruselbrasiko; brukselanino
brunatny - bruna
Brunon - Bruno
brylant - brilianto
Brytyjczyk - britujano
Brytyjka - britujanino
brytyjski - brita; brita
brzęczeć - zumi
brzoskwinia - persiko
brzoza - betulo
brzuch - ventro, abdomeno
brzuszek - ventreto
brzydkie kaczątko - malbela anasido
brzydki - malbela
buchalter - librotenanto
buda - budo; hundujo
Budapeszt - Budapeŝto
budować - konstrui
budowla - konstruaĵo
budżet - buĝeto
budżetowy - buĝeta
budzić - veki; vekiĝi
budzik - vekhorloĝo
buk - fago
bukiet - bukedo; bukedo
Bułgaria - Bulgario
bulwa - tubero; terpiro, tubera helianto, topinamburo
burak - beto
Burkina Faso - Burkino
bursztyn - sukceno
burza - tempesto
burzyć - muĝi
butelka - botelo
butik - butiko
but - ŝuo
być - esti
byk - bovo
Byk - Taŭro; Taŭro
Była Jugosłowiańska Republika Macedonii - Iama Jugoslavia Respubliko Makedonio
cal - colo
całka - integralo
całkiem - tute
całkowity - tuta, kompleta, plena
całość - tuto
cały - tuta
car - caro
carski - cara
cebula - bulbo
cech - korporacio
cedr - cedro
cegła - briko
Cejlon - Cejlono; Cejlono
cejloński - cejlona; cejlona
cela - ĉelo
cel - celo; celo
cellulit - celulito
celownik - dativo
cena - kosto, prezo
cenotaf - cenotafo
centralny - centra
centrum - centro
centurion - centestro
cer - cerio
cerować - stebi
cesarz - imperiestro
cesarzowa - imperiestrino; imperiestrino
cez - cezio
chamski - triviala
chaos - ĥaoso
charakter - karaktero
chart - leporhundo
chcieć - voli
chęć - volo
chemia - kemio/ĥemio
chemiczny - kemia, ĥemia
Chińczyk - ĉino
Chinka - ĉinino
Chińska Republika Ludowa - Popolrespubliko Ĉinio
chiński - ĉina
chińszczyzna - volapukaĵo
Chiny - Ĉinio
chirurgia - kirurgio, ĥirurgio
chirurgiczny - kirurgia
chirurg - kirurgo
chleb - pano
chlew - porkostalo
chłopiec - knabo
chlor - kloro
chmiel - lupolo
chmielowy - lupola
chmura - nubo
chodnik - trotuaro
chodzić - iradi, marŝi
choinka - kristnaska arbo
cholera - ĥolero
chomik - hamstro
chorał - ĥoralo
chór - ĥoro, koruso; ĥoraĵo, ĥoro; ĥorejo; ĥoro
choroba - malsano
Chorwacja - Kroatio, Kroatujo
chorwacki - kroata
Chorwatka - kroatino
Chorwat - kroato
chować - kaŝi; enterigi, entombigi
ChRL - PRĈ
chrom - kromo
chrystadelfiański - kristadelfiana
Chrystus - Kristo
chrzan - kreno
chrząstka - kartilago
chrząszcz - skarabo
chrześcijanin - kristano
chrześcijaństwo - kristanismo; kristanaro
chrzest - bapto
chuj - kaco
chusta - portotuko, beboportotuko
chwila - momento
chytry - ruza
ciąć - haki, tondi, tranĉi
ciągle - ankoraŭ
ciało - korpo
ciało niebieskie - astro
ciamajda - sentaŭgulo
ciastko - krakeno
cicha woda brzegi rwie - akvo silenta subfosas la bordon
ciekawostka - kuriozaĵo
ciekawy - scivola; interesa
cielę - bovido
cielisty - karnokolora
ciemność - mallumo
cień - ombro; ombro; ombro
ciepły - varma
cierpieć - suferi
cierpliwość - pacienco
cieszyć - ĝoji; ĝui
cietrzew - tetro
ciężki - peza
ciocia - onklino
cios - bato
ciśnienie - premo
ćma - nokta papilio, faleno
cnota - virto
codziennie - ĉiutage
codzienny - ĉiutaga
co - kio
cokolwiek - kio ajn, io ajn
co najmniej - almenaŭ
córka - filino
coroczny - ĉiujara
coś - io
cotygodniowy - ĉiusemajna
cuchnąć - malbonodori, odoraĉi
cud - miraklo
cudowne dziecko - mirinfano
cudzoziemiec - alilandano, alilandulo
cukierek - bombono
cukiernica - sukerujo
cukier puder - pulvorsukero
cukier - sukero; sukero; sukero
ćwierć - kvarono
ćwierćnuta - kvaronnoto
ćwikła - betaĵo ruĝa
cyberprzestrzeń - kiberspaco
cyferblat - ciferplato
cyfra - cifero
cyfrowy - cifera; cifereca
cykada - cikado
cynamon - cinamo
cyna - stano
cynk - zinko
cynober - vermiljono; cinabro
Cyprian - Cipriano
Cypr - Kipro
cyranka - marĉanaso, kerkedulo
cyrkiel - cirkelo
cyrkon - zirkonio
Cyryl - Cirilo
cytra - citro
cytryna - citrono
cywil - civilulo
cywilizacja - civilizo, civilizacio
cywilny - civila; civila
czador - ĉadoro, ĉador
czajka - vanelo
czajnik - tekruĉo
czapka - ĉapo
czapla - ardeo
czapli - ardea
czarna dziura - nigra truo
czarna jagoda - mirtelo
czarna magia - nigra magio
czarnooki - nigrokula
czarny - nigra
czasem - kelkfoje
czasopismo - revuo
czasownik - verbo
czas przyszły - futuro
czas - tempo
czas to pieniądz - temp' estas mono, temp' estas valoro simile al oro
czaszka - kranio
Czech - ĉeĥo
Czechosłowacja - Ĉeĥoslovakio
Czechy - Ĉeĥio, Ĉeĥujo; Bohemio, Bohemujo
czeczotka - flamkardelo
czego Jaś się nie nauczy, tego Jan nie będzie umiał - kion Joĉjo ne ekkonos, tion Johano ne konos
czekać - atendi
czekolada - ĉokolado; trinkĉokolado
czekoladowy - ĉokolada; ĉokoladkolora
czeladnik - submajstro
czepiec - kufo
czereśnia - merizarbo; merizo
czereśniowy - meriza
czerń - nigro
czerstwy - malfreŝa
czerwcowy - juni
czerwiec - junio
czerwień - ruĝo
czerwony - ruĝa
czesać - kombi
część - parto; parto
cześć - saluton
czeski - ĉeĥa
często - ofte
Czeszka - ĉeĥino
czkawka - singulto
członek - membro; membro
człowiek - homo
człowiek strzela, Pan Bóg kule nosi - homo pafas, Dio trafas
czosnek - ajlo
czwartek - ĵaŭdo
czy - ĉu
czyściec - Purgatorio
czysty - ĉasta
czytać - legi
dać - doni
dach - tegmento
Dagestan - Dagestano
Dakota Północna - Norda Dakoto
dalej - plu
daleki - malproksima
dama - damo, reĝino; damo, kavalirino
dan - danno
dandys - dando
dane - datumo
Dania - Danio, Danujo, Danlando
danie - manĝaĵo, plado, manĝometo
daremny - vana
Dariusz - Dario
darmo - senkoste, senpage
dauhańczyk - dohano
dauhanka - dohanino
dauhański - doha
dawca - donanto
Dawid - Davido
dawny - pasinta, eksa, malnova
dbać - zorgi
debiut - debuto
decydować - decidi
defekt - difekto, manko
definicja - difino
degradować - degradi
deizm - deismo
dekada - dekado, tagdeko; jardeko
dekoracja - dekoracio
delfin - delfeno
Delfin - Delfeno
demagogia - demagogio
demokracja - demokratio
Demokratyczna Republika Wyspy Świętego Tomasza i Wysp Świętego Tomasza i Książęcej - Demokrata Respubliko de Sao-Tomeo kaj Principeo
Demokryt - Demokrito
demon - demono
denar - denaro
denerwować - ĉagreni
dentysta - dentisto
denuncjować - denunci
deptak - piedira zono
deszcz - pluvo; pluvo
deszczyk - pluveto
detal - detalo
detalista - detalisto, detalvendisto
dętka - aertubo
diabeł - diablo
diament - diamanto
Dionizy - Denizo
dlaczego - kial
dla - por; por
dlatego - tial
dłoń - manplato, polmo
długi - longa
Dn - Dan
dno - fundo
do - al; al; ĝis
dobranoc - bonan nokton
dobry - bona
dobry wieczór - bonan vesperon
dobrze - bone
dodatek - aldono, aldonaĵo, akcesoraĵo
dodatkowy - akcesora
dodawać - aldoni; adicii
doić - melki
dojechać - alveturi
dojrzewanie - adolesko
dokąd - kien
dokądś - ien
dokładny - ekzakta, preciza, strikta
doktorant - doktoriĝonto
doktor - doktoro
dokument - dokumento
dolar - dolaro
dolmen - dolmeno
dom - domo; hejmo
domek - dometo
domino - domeno
domofon - pordotelefono
domokrążca - vendisto migranta
domowy - doma
dom publiczny - bordelo
Donald - Donaldo
dopełniacz - genitivo
dopiero - nur; nur; nur
dorosły - penkreska, adolta, matura; plenkreskulo, adolto
dosłownie - laŭtekste, laŭvorte
dosłowny - laŭvorta, laŭlitera, laŭteksta
dostarczać - liveri; alporti
dostawać - ricevi
dostęp - aliro
dostępny - akcesebla
dotacja - dotaĵo
dotyczyć - koncerni
dotyk - tuŝo
do widzenia - ĝis revido
dowód - pruvo; pruvo
drabina - ŝtupetaro
drabinka - ŝtuparo, ŝtupara kapto
dr - d-ro, d-ino
dręczyć - turmenti
drewniany - ligna
drewno - ligno
drink - drinkaĵo
drobnostka - bagatelo
Droga Mleczna - Lakta Vojo, Lakta vojo
droga - vojo
drogi - multekosta; kara
drogowskaz - vojmontrilo
drozd - turdo
druga wojna światowa - dua mondmilito
drukarka - printilo
drzewo - arbo
drzwi - pordo
duch - fantomo; animo; spirito
dudek - upupo
dudy - sakŝalmo
dumny - fiera
Duńczyk - dano
Dunka - danino
duński - dana
dusza - animo; spirito
duży - granda
dwór - kortego
dworzec - stacidomo
dwukropek - dupunkto
dwupłat - biplano
dwuznaczny - ambigua
dyletant - amatoro
dym - fumo
dymić - fumi
dynamika - dinamiko
dyrektor - direktoro
dyskretny - diskreta
dysleksja - vortblindeco, disleksio
dystrykt - distrikto
dysza - ajuto
dywan - tapiŝo
Dz - Ago
dziad - avo
dziadek - avo
działać - agi; funkcii
dzicz - sovaĝularo; sovaĝejo
dziczyzna - ĉasaĵo
dziecięcy - infana
dzieci i ryby głosu nie mają - infanoj kaj fiŝoj voĉon ne havas; infanoj kaj fiŝoj voĉon ne havas
dziecinny - infana; infana
dzięcioł - pego
dziecko - infano
dziedziczyć - heredi
dziękować - danki
dziękuję - dankon
dzielić - dividi
dzień dobry - bonan matenon, bonan tagon
dziennikarz - ĵurnalisto
dziennik - ĵurnalo
dzień - tago; tago
dziesięciolecie - jardeko
dziewczyna - knabino
dziewica - virgulino
dzik - apro
dziki - sovaĝa
dziób - beko; pruo
dzisiaj - hodiaŭ
dzisiejszy - hodiaŭa
dziwka - putino
dżudo - ĵudo
dżul - ĵulo
dźwięk - sono
EBOiR - EBRE
EBOR - EBRE
edredon - molanaso
Edward - Eduardo, Edvardo
edytować - redakti
Ef - Efe
efekt uboczny - kromefiko
Egipcjanin - egipto, egiptujano
Egipcjanka - egiptino, egiptujanino
egipski - egipta
Egipt - Egiptio, Egiptujo
ego - egoo
egoista - egoisto, egoismulo
egzystencjalizm - ekzistadismo, ekzistencialismo
egzystować - esti
-ek - et
ekscelencja - episkopa moŝto
eksplozja - eksplodo
Ekwador - Ekvadoro
elektrolit - elektrolito
elektron - elektrono
elektrownia - elektrejo, centralo, elektrocentralo
elektryczność - elektro
elektryczny - elektra
elektryk - elektristo
elokwentny - elokventa
Elżbieta - Elizabeto
emerytura - pensio
Emilia - Emilia
Emilka - Eminjo
emocja - emocio
energia - energio
enigma - enigmo
entuzjazm - entuziasmo
epikureizm - epikuranismo
epolet - epoleto
era - erao
Eris - Eriso
Ernest - Ernesto
Erytrea - Eritreo
eschatologia - eskatologio
esperanto - Esperanto
Est - Est
Estonia - Estonio, Estonujo
eta - eto
eter - etero
Etiopczyk - etiopo
Etiopia - Etiopio, Etiopujo
Etiopka - etiopino
etiopski - etiopa
etymologia - etimologio; etimo, etimologio
etyn - etino
Europa - Eŭropo
Europejczyk - eŭropano
Europejka - eŭropanino
europejski - eŭropa
eutanazja - eŭtanazio
ewolucja - evoluo; evoluo, evolucio
Ezd - Ezr
Ez - Jeĥ
Ezop - Ezopo
fagot - fagoto
fajka - pipo
faks - fakso
fantom - fantomo
fascynować - fascini
feminizm - feminismo
fenek - feneko
Fidżi - Fiĝio, Fiĝioj
figa - fig
Filipiny - Filipinoj
filiżanka - taso
film - filmo; filmo
filozofia - filozofio
filtr - filtrilo
Fin - finno
Finka - finnino
Finlandia - Finnlando
finlandyzacja - finnlandiĝo
fiński - finna
fioletowy - violetkolora
firma - firmao, firmo
fizyczny - fizika
fizyka - fiziko
flaga - flago
flaming - flamengo
flet - fluto
Flm - Fil
Florencja - Florenco
flota - floto, ŝiparo
Flp - Flp
fluor - fluoro
fobia - fobio
foka - foko
fok - ĵibo
fortel - artifiko, ruzo, ruzaĵo
fortepian - fortepiano
fort - fortreso
fosa - fosaĵo
fosfor - fosforo
foton - fotono
fragment - fragmento
frajer - trompeblulo
Franciszek - Francisko
Francja - Francio, Francujo
francuski - franca; la franca lingvo, la franca
Francuz - franco
Francuzka - francino
Franek - Fraĉjo
fundament - fundamento; fundamento
funkcja stanu - stato-funkcio
fuzja - kunfandiĝo; fuzio
gadatliwy - parolema
gad - reptilio
Ga - Gal
galaktyka - galaksio
gałąź - branĉo
Galicia - Galegio
Galicja - Galicio
gałka muszkatołowa - muskato
galon - galono
gapić się - okulaĉi
gardło - faringo, gorĝo
garnek - poto
Garo - Garoj
gąsienica - raŭpo
gąsior - viransero
gasnąć - estingiĝi
gawron - frugilego
gaz - gaso
gaz musztardowy - mustarda gaso
gdakać - kokinbleki, kluki
gdy - dum, kiam
gdzie diabeł nie może, tam babę pośle - kie diablo ne povas, tien virinon li ŝovas
gdzie - kie
gęgać - anserbleki
geografia - geografio
geologia - geologio
german - germaniumo
gęś - ansero
gęsi - ansera
gęsina - anseraĵo
gest - gesto
gęstość - denseco; denso, denseco; denso, denseco
getto - geto
ginąć - perei
gitarzysta - gitaristo
gitarzystka - gitaristino
głębia - profundo, profundeco; profundo; profundeco, profundeco; profundo
głęboki - profunda; profunda; profunda
głęboko - profunde
głębokość - profundo, profundeco
glin - aluminio
globalne ocieplenie - tutmonda varmiĝo
globalny - tutmonda
głód - malsato
głodny - malsata
glon - algo
głośny - laŭta
głos - voĉo
głowa - kapo
główny - ĉefa
głuchoniemy - surdmuta; surdmutulo
głuchy - surda; surdulo
głupawka - ridatako
głupiec - malsaĝulo, stultulo
głupi jak but - malsaĝa kiel ŝtipo
głupi - malsaĝa, stulta
głuszec - urogalo
gmina - komunumo
gniazdo - nesto
gnić - putri
gnida - pedikovo
gniew - kolero
Gniezno - Gniezno
gnu - gnuo
goban - go-tabulo
godzina - horo
go - goo, vejĉio
goista - goludanto
goistka - goludantino
gołąb - kolombo
goleń - kruro
golf - golfo
gol - golo
gonić - peli
goniec - kuriero; kuriero
gorączka - febro
góra - monto
górnik - ministo
górnolotny - altfluga, altefluga
Góry Skaliste - Roka Montaro
gorzki - maldolĉa, amara
gotować - boligi; kuiri; boli
grabić - rasti
grabie - rastilo
grać - ludi; ludi
gracz - ludanto
grad - hajlo
graf - grafo; grafo
grafik - grafikisto
gramatyka - gramatiko
granat - grenado; grantujo, granatarbo; granato; grenato
granatowy - malhelblua
granica - limo
granit - granito
grasejować - kartavi
grejpfrut - grapfruktujo, grapfruktarbo; grapfrukto
grób - tombo
groch - pizo
gromadzić - amasigi, akumuli; amasiĝi
gronostaj - ermeno
groszek - latiro
grosz - groŝo
grota - groto
grozić - minaci; minaci
grubiański - triviala
gruby - dika
grudzień - decembro
grupa - grupo
grusza - pirujo, pirarbo
gruszka - piro
gruziński - kartvelia
gruźlica - ftizo, tuberkulozo
gryka - poligon
gryźć - mordi
grzbiet - dors
grzebać - enterigi; enterigi, entombigi
grzebień - kombilo
grzechotnik - krotalo
grzywa - kolhararo, kolharoj
gust - gusto
guziec - verukapro
guzik - butono; butono
gwałcić - seksperforti, seksatenci
gwałt - seksperforto, seksatenco
gwiazda - stelo; stelulo, stelo; stelo
gwiazdka - steleto
Gwinea Równikowa - Ekvatora Gvineo
gwizdać - fajfi
haftka - agrafo
haftować - brodi
Ha - Hab
Haiti - Haitio
hak - hoko
hala - halo; alpo
hamburger - hamburgero
hamulec - bremso
handel - komerco
handlowy - komerca
hangar - hangaro
has - hasio
hasło - pasvorto
haszysz - haŝiŝo
hazard - hazardludo
Hbr - Heb
Helena - Helena, Heleno
herbata - teo
herbatnik - biskvito
hetman - hetmano; damo
hiacynt - hiacinto
Hi - Ijo
Hiob - Ijob
hipopotam - hipopotamo
hipoteka - hipoteko
historia - historio; historio
historyczny - historia
historyk - historiisto
hiszpanka - hispana gripo
hiszpański - hispania
Holandia - Nederlando
Holenderka - nederlandanino
Holender - nederlandano
holenderski - nederlanda
homar - omaro
Hongkong - Honkongo
honor - honoro; honoro
Horus - Horuso
horyzontalny - horizontal
horyzont - orizonto
hotel - hotelo
hrabia - grafo
HTML - HTML
hura - hura
huśtawka - balancilo
hybryda - hibrido
hycel - hundkaptisto
hydrologia - akvoscienco
hymn - himno
ibis - ibiso
ich - ilia
idiota - idioto
iguana - igvano
i - kaj
ile - kiom
ilość - kvanto
imię - persona nomo, antaŭnomo, nomo; nomo
imiesłów - participo
im - ju... des, ju... tiom
Indie - Barato, Bharato
Indonezja - Indonezio
Indonezyjczyk - indoneziano
Indonezyjka - indonezianino
indonezyjski - indonezia
indyk - meleagro
infiks - infikso
inflacja - inflacio
informatyczny - informatika
informatyk - komputilisto
inny - alia; alia; aliulo
instytut - instituto
intensywność - intenseco
interes - afero; negoco
interlokutor - interparolanto
internet - Interreto
Internet - Interreto
inżynieria - inĝenierarto
inżynier - inĝeniero
ipsylon - upsilono
iracki - iraka
Irakijczyk - irakano
Irakijka - irakanino
Irak - Irako
iść - iri
islam - islamo
Islandia - Islando
istnieć - ekzisti
Itaka - Itako
itd. - ktp.
itr - itrio
Izabela - Izabelo
Iz - Jes
-izm - ism
izolatka - izolejo
izolowany - izolita
Izrael - Israelo
jabłecznik - pomkuko; pomvino
jabłko - pomo
jabłoń - pomujo, pomarbo
jądro - testiko; atomkerno; ĉelkerno, nukleo; kerno
jagoda - bero
jajko - ovo
jajnik - ovujo, ovario
jajo - ovo
jajowaty - ovoforma
jaka płaca, taka praca - kia pago, tia ago
jaka praca, taka płaca - kia ago, tia pago
jaki - kia; kia
jakikolwiek - kia ajn, ia ajn
jak - kiel; poefango
jakkolwiek - kiel ajn, iel ajn
jako - kiel
jak żółw - testude
jałmużna - almozo
jałowiec - junipero
jałówka - bovidino
jama - anfrakto; anfrakto
ja - mi
Janina - Johana
Jan - Johano
Japończyk - japano
Japonia - Japanio, Japanujo
Japonka - japanino
japoński - japana
jarząbek - tetrao
jarzębina - alizarbo, alizujo; alizo
jarzmo - jugo
Jaś - Joĉjo
jaskier - ranunkol
jaskinia - groto
jaśniepan - moŝtulo
jasny - hela; klara
jastrząb - akcipitro
jaszczurka - lacerto
Jdt - Jut
jechać - veturi, iri
jednak - tamen
jednorożec - unikorno, unukornulo
jednostka - unuo; unuo, mezurunuo
jedwabnik - silkraŭpo
jedynak - solinfano
jedyny - sola, ununura
jedzenie - manĝo; manĝaĵo
jego - lia; ĝia
jej - ŝia
jeleń - cervo
jemioła - visko
jen - eno
Jerzy - Georgo
jeść - manĝi
jesień - aŭtuno
jesion - frakseno
jeśli wejdziesz między wrony, musisz krakać jak i one - inter lupoj kriu lupe
jeszcze - ankoraŭ; ankoraŭ; ankoraŭ; ankoraŭ
jętka - efemero
jeżeli - se
jeż - erinaco
jezioro - lago
Jezus - Jesuo
język - lango; lingvo; lango
językowy - lingva
jidysz - jida lingvo
J - Joh
Jk - Jak
Jl - Joe
Joanna - Johana
jodełka - abieto
jodła - abio
jogurt - jogurto
Jon - Jon
Jowisz - Jupitero; Jupitero
Joz - Jos
Jr - Jer
jubiler - juvelisto
judaizm - judaismo, judismo
Jud - Jud
judo - ĵudo
Jugosławia - Jugoslavio
Julia - Juliino
jura - ĵurasio
jutro - morgaŭo; morgaŭ
już - jam
kabaczek - kukurbo
kabaret - kabareto
kabuki - kabuko
kac - postebrio
kaczątko - anasido
kaczka - anaso
Kaczor Donald - Donaldo Anaso
kaczor - viranaso
kadłub - fuzelaĝo
kadm - kadmio
kaganiec - buŝumo
Kair - Kairo
kajak - kajako
kakadu - kakatuedoj
kakao - kakao
kąkol - lolo
kaktus - kakto
kalafonia - kolofono
kalarepa - tigobrasiko, brasikrapo
kalcyt - kalcito
kalendarz - kalendaro; kalendaro
kalenica - firsto
kaliforn - kaliforniumo
kalina - viburn
kaloria - kalorio
kalosz - galoŝo, pluvboto
kamasz - gamaŝo
Kambodża - Kamboĝo
Kambodżanin - kamboĝano
Kambodżanka - kamboĝanino
kambodżański - kamboĝa
kameleon - ĥameleono, kameleono
kamera - kamero
Kamerun - Kamerunio; Kameruno
kamień - ŝtono
kamizelka - kamizolo
Kanada - Kanado
kanalia - kanajlo
kanapa - kanap
kanapka - kanapo
kandela - kandelo
kangur - kanguruo
kania - milvo
kapać - guti
kapelusz - ĉapelo
kaplica - kapelo
kapsel - kapsul
kaptur - kapuĉo
kapucyn - kapuceno
kapusta - brasiko
karabin - fusilo
karakuł - karakulo
karaluch - blato
kardynał - kardinalo
kark - nuko
karmel - karamelo
karmić - manĝigi, nutri
karmnik - birdomanĝejo
karnawał - karnavalo
karo - karoo; karoa
Karolina - Karolino
Karol - Karolo, Karlo
karp - karpo
karygodny - puninda
kastrować - kastri
kasyno - kazino
kasza - kaĉo
kaszel - tuso
kaszleć - tusi
Kaszmir - Kaŝmiro
katalog - katalogo; katalogo; dosierujo
Katalonia - Katalunio
katarakta - katarakto
Katarczyk - katarano
Katarka - kataranino
Katar - Kataro
katar - kataro, nazkataro; nazmuko; kataro
katarski - katara
Katarzyna - Katerino
katastrofa - katastrofo
kat - ekzekutisto
katolik - katoliko
kawa - kafo
kawałek - fragmento
kawaler - fraŭlo; kavaliro
kawiarnia - kafejo
kawka - monedo, korveto; kafeto
każdy - ĉiu
kelner - kelnero
kelwin - kelvino
Kenia - Kenjo
kichać - terni
kiedy - kiam
kiedykolwiek - kiam ajn, iam ajn
kiełbasa - kolbaso
kiełb - gobio
kieliszek - glaso
kielnia - trulo
kierat - ĉevalmuelejo
kierować - direkti
kierownictwo - gvidado
kierunek - direkto
Kijów - Kievo
kilka - kelkaj
kilogram - kilogramo
Kirgistan - Kirgizujo, Kirgizio, Kirgistano
kirys - kiraso
kiur - kuriumo
kiwi - kivo; kivio
klacz - ĉevalino
klakson - hupo
kłamać - mensogi
kłamca - mensogulo, mensoganto
klamka - anso, klinko
kłamstwo - mensogo
Klara - Klaro
klatka - kaĝo
klawesyn - klaviceno
klawisz - klavo
kleić - glui
klej - gluo
kler - pastraro
kleszcz - iksodo
klimat - klimato
klin - kojno, kejlo; kojno, kejlo
kloc - ŝtipo
klon - acero
klucz - ŝlosilo
knajpa - drinkejo
knot - meĉo
kobalt - kobalto
kobieta - virino
kobra - kobro
kochać - ami
kochać kochajmy się jak bracia, rachować rachujmy się jak Żydzi - ni amu nin frate, sed ni kalkulu akurate
kochany - amato
koci - kata
kocioł - kaldrono
kocur - virkato
kogut - virkoko
Koh - Koĥ
kokos - kokoso
kolacja - vespermanĝo
kolano - genuo, genu
kołchoz - kolĥozo
kołdra - kusenego
kolega - kolego
kolej - fervojo
kolejka - vico, vosto; rektvica memoro
kolejowy - fervoja
kolekcjonować - kolekti
koliber - kolibro
Kol - Kol
kołnierz - kolumo
Kolonia - Kolonjo
koło - rado
kolor - koloro
kolorowy - kolora
kołtun - pliko
Kolumbia - Kolombio
Kolumbijczyk - kolombiano
Kolumbijka - kolombianino
kolumbijski - kolombia
kolumna - kolono; kolumno
kołysanka - lulkanto
kołyska - lulilo
komar - kulo
komentować - komentari, komenti
kometa - kometo
komfort - komforto, lukso
komfortowy - komforta
komiks - bildliteraturo
kominek - kamen
kominiarka - skimasko
komin - kamentubo
komisja - komisiono, komisio
komoda - komodo
komoku - substela punkto
komora gazowa - gasĉambro, gaskamaro
komórka - ĉelo
kompas - kompaso
kompletny - kompleta, senmanka
kompost - kompoŝto
kompres - kompreso
kompromitować - kompromiti; kompromitiĝi, kompromiti sin
komputer - komputilo.
komunikacja - komunikado
komunikat - komunikaĵo
komunista - komunisto
komunizm - komunismo
koncern - konzerno
koń - ĉevalo
kończyć - fini
konewka - akvumilo, verŝilo
koniczyna - trifolio
konik - ĉevaleto
konkurs - konkurso
koński - ĉevala
konstantynopolitańczykowianeczka - konstantinopolanineto
Konstantynopol - Konstantinopolo
kontrabas - kontrabaso
koń trojański - troja ĉevalo
kontur - konturo
kontynent - kontinento
kontynuować - daŭrigi
konwalia - konvalo
kopać - piedbati
kopalnia - minejo
Kopenhaga - Kopenhago
kopenhaski - kopenhaga
kopenhażanin - kopenhagano
kopenhażanka - kopenhaganino
koper - aneto
koperta - koverto
kopiować - kopii
kopuła - kupolo
kopyto - hufo
kora - arboŝelo
Koran - Korano
korek - korko, korktirilo; ŝtopilo; korko; trafikŝtopado
korespondencja - korespondaĵo
Kor - Kor
kormoran - kormorano
Korsyka - Korsiko
kort - tenisejo
koryto - trogo; fluejo
korzeń - radiko; radiko
kosa - falĉilo
kość - osto; ĵetkubo
kos - merlo
kostka - osteto; maleolo; plektro
kosztować - kosti; gustumi
koszula - ĉemizo
koszykówka - korbopilkado
kot - kato
kowadło - amboso
kowal zawinił, a Cygana powiesili - tajloro krimis, botisto pendas
koza - kapro
kozi - kapra
Koziorożec - Kaprikorno
Kpł - Lev
kradzież - ŝtelo
Kraj Basków - Eŭskio, Vaskio; Eŭska Aŭtonoma Komunumo
kraj - lando
Kraków - Krakovo
kran - krano
kraść - ŝteli
krater - kratero
krawat - kravato
krawiec - tajloro
krążownik - krozoŝipo, krozŝipo
kreda - kreto
kręgosłup - spino, vertebraro
kręgowiec - vertebrulo
krem - pomado, kremaĵo
kreskówka - kartuno, desegnofilmo
kret - talpo
krew - sango
Krl - Reĝ
Krn - Kro
krochmalić - ameli
kroić - tranĉi
krokodyl - krokodilo
krok - paŝo
krokus - krokuso
królestwo - regno
króliczy - kunikla
królik - kuniklo
królowa - reĝino
król - reĝo
król strzelców - golreĝo
kromka - panpeceto
kropka - punkto
kropla - guto, akvero ''''
kroplomierz - gutigilo, pipeto
krótki - mallonga
krótkowzroczność - miopeco
krowa - bovino
krowa, która dużo ryczy, mało mleka daje - kiu multe parolas, ne multe faras
krowi - bovina
krtań - laringo
krucjata - krucmilitoj, krucistaj militoj, krucistaj ekspedicioj
kruczy - korva
kruk - korvo
kruk krukowi oka nie wykole - korvo al korvo okulon ne pikas
krużganek - portiko, galerio
krwotok - hemoragio
krykiet - kriketo
krypton - kriptono
krytyka - kritiko
kryzys - kriz
krzak - arbusto
krzem - silicio
krzesło - seĝo
krztusiec - kokluŝo
krzyczeć - krii
krzyk - krio
krzywa - kurbo
krzyżak - krucaraneo
krzyż - kruco
Krzyż Południa - Suda Kruco
ksiądz - pastro
książę - princo; duko; princo
książka - libro
Księga Rodzaju - Genezo, Unua libro de Moseo
księżyc - luno
Księżyc - Luno
kształt - formo
kto - kiu; kiu
kto rano wstaje, temu Pan Bóg daje - matena horo estas plena de oro
który - kiu
ktoś - iu
Kuba - Kubo
Kubańczyk - kubano
Kubanka - kubanino
kubański - kuba
Kubuś Puchatek - Winnie-la-Pu
kucharz - kuiristo
kuchnia - kuirejo
kuć żelazo, póki gorące - forĝu feron dum ĝi estas varmega
kufel - bierglasego, bierkruĉo
kukurydza - maizo
kula - kuglo; kuglo; lambastono
kulomb - kulombo
kumulować - akumuli, amasigi; amasiĝi
kupować - aĉeti
kura - koko
kurator - kuratoro
kurczak - kokido; kokaĵo
kurczę - kokido
kurier - kuriero
kuropatwa - perdriko
kurwa - putino
kusić - tenti
kuzynka - kuzino
kuzyn - kuzo
kwadrans - kvaronhoro
kwartał - jarkvarono, kvaronjaro, trimonato, trimestro
kwas - acido
kwas azotowy - azotacido
kwasić - acidigi; acidiĝi
kwaśny - acida
kwiat - floro; floro
kwiecień - aprilo
kwitnąć - flor
kworum - kvorumo
kwota - kvoto
Łaba - Elbo
łabędź - cigno
łabędziątko - cignideto
łabędzi śpiew - kanto de cigno
labrys - labriso
łacina - latino, latina lingvo
lać - verŝi; pluvegi
łączyć - konekti, kombini, kunigi; konekti, kombini, kunigi; konekti, kombini, kunigi; konekti, kombini, kunigi
łąka - herbejo
laktaza - laktazo
lama - lamo; lamao
łamaniec językowy - langrompilo
lampa - lampo
lampart - leopardo
łańcuch - ĉeno; ĉeno; montĉeno, ĉeno; ĉeno; ĉeno
łapać - kapti
laptop - tekkomputilo, tekokomputilo
larwa - larvo
las - arbaro, arbarego
laser - lasero
latarka - poŝlampo
lato - somero
łatwo - facile
łatwy - facila
Laura - Laŭra
lawa - lafo
laweta - afusto
lawina - lavango
łazienka - banĉambro
lazur - lazuro
Lazurowe Wybrzeże - Bordo Lazura
Lb - Nom
lecieć - flugi; flugi/iri per aviono
lekarstwo - kuracilo, medicinaĵo, resanigilo, sanigilo
lekarz - kuracisto
lekcja - leciono
lekki - malpeza
leksyka - vortprovizo
lektyka - portoseĝo
lemoniada - limonado
leniwiec - bradipo
len - lino; linaĵo
leń - maldiligentulo, pigrulo
Leon - Leono
lepki - algluiĝema
leśniczówka - forstistejo
leśniczy - forstisto
leszcz - bramo
lewa - preno
lewarek - levilo
lew - leono
Lew - Leono; Leono; Leono
lewo - maldekstre
leworęczny - maldekstrulo
lewy - maldekstra
leżeć - kuŝi
Liban - Libano
liberia - livreo
lichwa - procentego, uzuro
liczba mnoga - multenombro, plurnombro, pluralo
liczba - nombro
liczba pojedyncza - ununombro
liczebnik - numeralo
lilak - siringo
lilia - lilio
lina - ŝnurego, ŝnuro
linia - linio; linio; linio; linio; linio; linio
linijka - liniilo
linoleum - linoleumo
lipa - tilio
lipiec - julio
lira - liro
lir - liro
liść - folio
liścień - kotiledono
listonosz - leterportisto
listopad - novembro
lis - vulpo
litera - litero
lit - litio; lido
Litwa - Litovio, Litovujo
lizać - leki
Łk - Luk
Lm - Lam
lniany - lina
locha - porkino
lód - glacio; glaciaĵo
lodołamacz - glacirompilo
lodowiec - glaĉero
łodyga - tigo
łódź - boato
łódzki - lodza
Łódź - Lodzo
log - logo
logo - logotipo, emblemo
łokieć - kubuto; ulno
lokomotywa - lokomotivo
Lombardia - Lombardujo
Londyn - Londono
łopata - ŝpato, fosilo
łoś - alko
łosoś - salmo
lot - flugo; flugvojaĝo
lotnictwo - aviado
lotnisko - aerodromo, flughaveno
Łotwa - Latvio, Latvujo
łóżko - lito
lub - aŭ
lubić - ŝati
lubieżny - voluptema
Lublin - Lublino
lucerna - luzerno
łucznictwo - arkpafado
łuczniczka - arkistino, arkpafistino
łucznik - arkisto, arkpafisto
lud - popolo; popolo
Ludwik - Ludoviko, Luizo, Luiso
ludzkość - homaro
Łukasz - Luko
Łuk. - Luk
łuk - pafarko; arkaĵo; arko
Luksemburg - Luksemburgo
lunatyk - lunatiko
lupa - lupeo
łuska - skvamo; kuglingo, kartoĉmantelo
lustro - spegulo
luteranin - luterano
luteranizm - luterismo, luteranismo
luteranka - luteranino
lutet - lutecio
łut - lodo
lut - lutaĵo
lutnia - liuto
lutować - luti
lutownica - lutilo
luty - februaro, Februaro
lwica - leonino
lwi - leona
łydka - suro
łyżka do butów - ŝukorno
łyżka - kulero
łza - larmo
maca - maco
machać - svingi
macica - utero
macierz - matrico
macocha - duonpatrino
maczeta - maĉeto
mądrej głowie dość dwie słowie - saĝa kapo duonvorton komprenas, por saĝulo sufiĉas aludo
mądrość - saĝo, saĝeco
mądry - saĝa
MAEA - IAEO
magazyn - magazeno, stokejo
magia - magio
magiczny - magia
mag - magiisto, sorĉisto
magnes - magneto
magnez - magnezio
magnolia - magnolio
majeranek - majorano
majestatyczny - majesta
maj - majo
mąka - faruno
makaron - makaronio, nudelo
mak - papavo
Małgorzata - Margareta
malina - frambujo; frambo
mało - malmulte
małpa - simio; heliko, ĉe
małpi - simia
mały - malgranda
małżeństwo - edzeco; geedzoj
małżonek - edzo; geedzo
mama - panjo
mandolina - mandolino
mangan - mangano
mankiet - manumo
manometr - manometro
mapa - karto, mapo
marcepan - marcipano
marcepanowy - marcipana
marchew - karoto
Marek - Marko
Maria - Mario, Maria
Marianna - Mariana
marmur - marmor, marmoro
marszałek - marŝalo
marsz - marŝo
marszruta - marŝlinio
martwić - aflikti, ĉagreni
marzec - marto
marzyć - revi
masa krytyczna - sojla maso
masa - maso
maska - masko
maślanka - buterlakto
masło - butero
mason - framasono
maszt - masto; masto
maszyna - maŝino
matematyczny - matematika
matematyka - matematiko
matematyk - matematikisto
materac - matraco
materacyk - matraceto
materialny - materia, materiala
materia - materio; materio
Mateusz - Mateo
matka chrzestna - baptopatrino
matka - patrino
Mat. - Mat
mąż - edzo
Mch - Mak
mdleć - sveni
Mdr - Saĝ
mechanika - meĥaniko, mekaniko; meĥaniko, mekaniko; meĥaniko, mekaniko; meĥaniko, mekaniko
mech - musko
meczet - moskeo
męczyć - turmenti; lacigi
medalion - medaliono
medal - medalo
mędrzec - saĝulo
meduza - meduzo
medytować - mediti
meksykański - meksika
Meksyk - Meksiko, Meksiklando, Meksikio; Meksiko, Meksikurbo; Meksiko, Meksikoŝtato
meloman - muzikamanto
melon - melono
Merkury - Merkuro; Merkuro
męski - vira
metafora - metaforo
metal - metalo; metalroko
metanol - metanolo
meteoryt - meteorŝtono, aerŝtono, meteorito, aerolito
metr kwadratowy - kvadrata metro, kvadratmetro
metr - metro
metro - metroo
mewa - laro, mevo
mężczyzna - viro
mgła - nebulo
mianownik - nominativo
miasto - urbo
miau - miaŭ
miażdżyca - aterosklerozo
Michał - Mikelo
mieć - havi
miecz Damoklesa - damokla glavo
miecz - glavo
miedź - kupro
Międzynarodowa Agencja Energii Atomowej - Internacia Atomenergia Organizo
Międzynarodowy Dzień Kobiet - internacia tago de virinoj
miejsce - loko
miejska legenda - urba legendo
miękki - mola
mierzyć - mezuri; almezuri
miesiąc - monato
mięsień - muskolo
mięso - viando
mieszkać - loĝi
mieszkaniec - loĝanto
mieszkanie - loĝejo
mięta - mento
miętus - lojto
migdał - migdalujo, migdalarbo; migdalo
migdałowy - migdala; migdala
mila - mejlo
miliarder - miliardulo
miliardowy - miliarda
milioner - milionulo
miłość - amo
miłostka - ameto
Mi - Miĥ
mimo - malgraŭ
mina - mino
minister - ministro
minuta - minuto
miód - mielo; medo
mirt - mirto
Mk - Mar
mleć - mueli
mleko - lakto
Ml - Mal
młody - juna
młodzież - junularo
młotek - martelo
młynarz - muelisto
młyn - muelejo
móc - povi
moc - povumo
mocz - urino
model - modelo
modlić się - preĝi
mój - mia
Mojżesz - Moseo
molibden - molibdeno
mól - tineo
moment - momento
Monachium - Munkeno
Monako - Monako
monarchia - monarkio
moneta - monero
Monika - Monika, Moniko
monofizytyzm - monofizidismo, monofizismo
monument - monumento
mopsica - mopsino
mopsik - mopseto
mops - mopso
morderstwo - murdo, mortigo
morela - abrikotujo, abrikotarbo; abrikoto
morelowy - abrikota
morski - mara
morświn - foceno
Morze Bałtyckie - Balta Maro
Morze Kaspijskie - Kaspia Maro, Kaspia maro, Kaspio
morze - maro
mosiądz - latuno, flava kupro
moskiewski - moskva
Moskwa - Moskvo
moskwianin - moskvano
moskwianka - moskvanino
most - ponto
motor - motoro
motorówka - motorboato
motyl - papilio
mowa jest srebrem, a milczenie złotem - parolo estas arĝento, oron similas silento
mówić - paroli
może - eble
mózg - cerbo
możliwy - ebla
mrówczy - formika
mrowisko - formikejo
mrówka - formiko
mrówkojad - formikomanĝulo
mrównik - orikteropo terporko
mróz - frosto
mrugać - palpebrumi
msza - meso
mszyca - afido
Mt - Mat
mucha - muŝo
mugol - muglo
mulcz - mulĉo
muł - mulo; ŝlimo
mumia - mumio
mus - devigo
musieć - devi
muślin - muslino
muszla - konko
musztarda - mustardo
musztarda po obiedzie - mustardo post la manĝo
muzykalny - muzikema
muzyk - muzikisto
myć - lavi
mydelniczka - sapujo
mydlić komuś oczy - sapumi la okulojn, nebuligi la okulojn
mydło - sapo
mylny - erara
my - ni
myśleć - pensi
myśl - penso
Myszka Miki - Miĉjo Muso
mysz - muso
mżawka - pluveto
nadawca - adresanto
nadgarstek - karpeo
nad - super
nadużywać - trouzi, misuzi
nadzieja - espero
naga prawda - nuda vero
nagi - nuda
nagroda - premio
nairobijski - najroba
Nairobi - Najrobo
naj- - plej
naleśnik - patkukko
namawiać - tenti
namiot - tendo
Na - Naĥ
napastnik - agresanto
napisać - skribi
napletek - prepucio
napój - trinkaĵo
napomnienie - admono
napotny - ŝvitiga
narcyz - narciso; narciso
Narcyz - Narciso; Narciso
naród - nacio
narzeczona - fianĉino
narzędnik - ablativo
narzekać - plendi
nasiono - semo
następnie - post
nastolatek - dekkelkjarulo
na - sur
nasz - nia
natura - naturo
nauczyciel - instruisto
nauczycielka - instruistino
nauka - scienco
naukowiec - sciencisto
naukowy - scienca
nawałnica - tempesto
nawet - eĉ
nawias - krampo
nawyk - alkutimaĵo
nazwa - nomo
nazwisko - familnomo
Ne - Neĥ
neologizm - neologismo
neon - neono; neonlampo
Nepal - Nepalo
nic - nenio; nenio
niebezpieczeństwo - danĝero
niebieski - blua
niebo - ĉielo
nie chwal dnia przed zachodem słońca - ne laŭdu la tagon antaŭ vespero
niedokrwistość - anemio
niedziela - dimanĉo
Niedziela Palmowa - Palmofesto, Palmodimanĉo
niedźwiedzica - ursino
niedźwiedzi - ursa
niedźwiedź - urso
niektóry - kelka; kelka
nie ma róży bez kolców - kie lumo ekzistas, ankaŭ ombro troviĝas
Niemcy - Germanio, Germanujo
Niemiecka Republika Demokratyczna - Germana Demokratia Respubliko
niemowlę - bebo, suĉinfano
nie - ne
nieoczekiwanie - neatendite
niepodległość - sendependeco
nieść - porti
nieskomplikowany - malkomplika
nieskromny - malmodesta
niespodziewany - neatendita
nieszpułka - mespilujo, mespilarbo; mespilo, mespilbero
nietoperz - vesperto
nieurodzaj - fuŝrikolto, malbonrikolto
niewiele - nemulte
niewolnik - sklavo
nie wywołuj wilka z lasu - ne elvoku lupon el la arbaro
niezapominajka - miozoto
niezbędny - necesa
nigdy - neniam
nigdzie - nenie
nikiel - nikelo
nikt - neniu
niob - niobio
niski - malalta
niuans - nuanco
nizina - malaltebenaĵo
Nizina Padańska - Padio
niż - ol
noc - nokto
noga - piedo
Norwegia - Norvegio, Norvegujo
nosić - porti; porti
nos - nazo
notatnik - agendo
Nowa Zelandia - Nov-Zelando
nów - novluno
nowożeniec - novedzo
Nowy Jork - Novjorko; Nov-Jorkio
nowy - nova
Nowy Orlean - Nov-Orleano
Nowy Rok - Novjaro
nóż - tranĉilo
nożyczki - tondilo
nucić - zumi
nuda - enuo
nudny - enuiga, teda
nudzić - tedi, enuigi; enui
numer - numero; numero; numero
numerować - numeri
Numidia - Numidio
nur - kolimbo
oba - ambaŭ
obaj - ambaŭ
obejmować - ĉirkaŭpreni
Obj - Apo
obóz - tendaro
obraza - insulto
obraz - pentro, pentraĵo
oburącz - ambaŭmane
obwiniać - akuzi
obywatel - civitano
Ocean Arktyczny - Arkta Oceano
ocean - oceano
ocet - vinagro, aceto
octan - acetato
oczko - okuleto; maŝo
odcień - nuanco; nuanco
odcinek - streko; segmento
odcisk - kalo
odcisk palca - fingrospuro, fingropremaĵo
od - de
odlew - muldaĵo
odpowiadać - respondi
odpowiedzialność - respondeco
odpowiedź - respondo
odwaga - kuraĝo
odważnie - kuraĝe, brave
odważny - kuraĝa, brava
odwiedzać - viziti
odwrotność - inverto
ogień - fajro
ogłoszenie - avizo
ognisko - fokuso
ogólnokrajowy - tutlanda
ogólnonarodowy - tutnacia
ogólnoświatowy - tutmonda
ogół - tuto
ogon - vosto
ogórek - kukumo
ogród - ĝardeno
ojciec chrzestny - baptopatro
ojciec - patro
Ojcze nasz - Patro nia, Sinjorpreĝo
ojczym - duonpatro
ojczyzna - patrujo
okazja - okazo
okno - fenestro; fenestro
okoń - perko
oko - okulo; okulo
okrutny - kruela
okrzyk - ekkrio, ĝojkrio
okular - okulvitro
okulary - okulvitroj
okulary przeciwsłoneczne - sunokulvitroj
olcha - alno
olej - oleo
oliwa - olivoleo
oliwka - olivarbo, olivujo; olivo
oliwkowy - olivkolora; oliva, olivuja, olivarba
ołówek - krajono
ołów - plumbo
ołtarz - altaro
omdlenie - sveno
omnibus - omnibuso
om - omo
omowy - oma
onanizm - onanismo
ona - ŝi
one - ili
oni - ili
on - li
ono - ĝi
opactwo - abatejo
opat - abato
opłata - pago
oprócz - krom
organizm - organismo
orgia - orgio
ortografia - ortografio
orzech - nukso
orzeczenie - predikato
orzeł - aglo
orzeszek - nukseto
oś - akso; akso
osa - vespo
ósemka - oko
osiągnięcie - atingo
osika - tremolo
osioł - azeno
oskarżać - akuzi
oskarżony - akuzita; akuzito
oślina - azenaĵo
osłomuł - hino
osm - osmio
osoba - persono
osobnik - ulo
ostatni - lasta
ostry - akra
ostryga - ostro
ostrzyć - akrigi
Oświęcim - Aŭŝvico
oszczep - ponardego
oszukańczy - trompa
oszukiwać - trompi
oszustka - trompantino, ĉarlatanino
oszust - trompanto, ĉarlatano
otchłań - abismo
oto - jen; jen; jen; jen; jen
otwarty - malfermita
otwierać - aperti, malfermi
otwór - truo; buŝo; buŝo
otyłość - korpulenteco
owacja - ovacio
owad - insekto
owal - ovalo
owca - ŝafo
Owernia - Aŭvernjo
owieczka - ŝafeto
owies - aveno
owoc - frukto; frukto
Oz - Hoŝ
ozonowy - ozona
ozon - ozono
pacha - akselo
pachnieć - odori
pachołek - bolardo
pączek - burĝono
padać - fali
pagórek - monteto
pająk - araneo
pajęczy - aranea
pajęczyna - araneaĵo
pakować - paki
palec - fingro, manfingro, piedfingro
Palermo - Palermo
Palestyna - Palestino
palić - bruligi; fumi; bruli
palindrom - palindromo
paliwo - brulaĵo, bruligaĵo, fuelo
palma - palmo
palmtop - poŝkomputilo
pandemia - pandemio
panna - fraŭlino
Panna - Virgulino
pan - sinjoro
państwo - ŝtato, regno
panteon - panteono; diaro, panteono; panteono
papieros - cigaredo
papierośnica - cigaredujo
papier - papero
paproć - filiko
papuga - papago
parafianin - paroĥano
parafia - paroĥo; paroĥanaro
Paragwaj - Paragvajo
paragwajski - paragvaja
para - paro; paro; paro; paro; vaporo
parasol - ombrelo
parkować - parki
park - parko
parowóz - vaporlokomotivo
parter - partero, teretaĝo
Paryż - Parizo
parzystość - pareco
parzysty - para; para; para; para
paser - ricelisto
pasieka - abelejo
pasierbica - vicfilino
pasierb - vicfilo
pasować - konveni
pasożyt - parazito
pastel - paŝtelo; paŝtelo, paŝtelaĵo
pasterka - noktomeza meso; ŝafistino
pastylka - pastelo
pasza - furaĝ
pas - zono
pasztet - pasteĉo
patelnia - pato
pat - pato
Patryk - Patriko
Paulina - Paŭlina
Paweł - Paŭlo
pawi - pava
paw - pavo
październik - oktobro
paznokieć - ungo
pazur - ungo, ungego; ungego
pchła - pulo
pchli targ - pulbazaro
pelikan - pelikano
pełnia - plenluno
pełny - plena
pens - penco
pępek - umbiliko
pergola - pergolo
perła - perlo
peron - kajo, perono
peryskop - periskopo
perz - agropiro, hundherbo
pesymistyczny - pesimisma
pewien - certa; sekura
piasek - sablo
piątek - vendredo
pić - trinki; drinki
piec - bakujo, forno; baki, rosti
pieczarka - agariko; ĉampinjono
piekarz - bakisto
piekło - infero
piękny - bela
pieniądz - mono
pień - trunko
pieprz - piprujo, piprarbeto; pipro
pieprzyć - pipri
pierścień - fingroringo; ringo
pierś - mamo
pierwsza wojna światowa - unua mondmilito
pies - hundo
pieśń - kanto
pies ogrodnika - la hundo de ĝardenisto, ĝardenista hundo
piętro - etaĝo
pigwa - cidonio
pijak - drinkemulo
pijany - ebria; ebriulo
pijawka - hirud
pikieta - pikedo
pik - piko
piłeczka - pilketo; segileto
piłka nożna - piedpilko
piłka - pilko; pilkoludo
piłka ręczna - manpilkado
piłkarka - piedpilkistino, futbalistino; manpilkistino
piłkarski - piedpilka, futbala
piłkarz - piedpilkisto, futbalisto
pióro - plumo
piorun - tondro
piosenka - kanto
Piotrek - Peĉjo
Piotr - Petro
Piotruś - Peĉjo
pi - pi; pio
piramida - piramido; piramido
pisać - skribi
pisklę - birdido
pistacja - pistako; pistakujo
pistolet - pistolo
piwnica - kelo
piwny - biera
piwo - biero
piżmak - ondatro, fibero
placek - flano
płacić - pagi
plac - placo
płaczka - ploristino
płakać - plori
plama - makulo
plamka - punkto
planeta - planedo
plan - plano
płaski - plata
plaster - plastro, pretpansaĵo, kuracbendo
płaszczka - rajo
plateau - altebenaĵo
płatek - neĝero
Platforma Obywatelska - Civitana Platformo
Platon - Platono
platyna - plateno
płaz - amfibio
plaża - plaĝo
plecak - dorsosako
płeć - sekso
plecy - dorso
plik - dosiero
plotkować - klaĉi
płuco - pulmo
pluskwa - cim
płynąć - naĝi; flui
płynny - flua, fluaĵa
pływać - naĝi
pływaczka - naĝistino
Pnp - Kan
pobożny - pia, religia
pochyłość - deklivo
pociąg - trajno, vagonaro
pocić się - ŝviti; ŝviti
pocisk - kuglo
Poczdam - Potsdamo
poczta - poŝto; poŝtejo; poŝtaĵoj
poczwarka - krizalido
podatek - imposto
podatkowy - imposta, fiska
podbój - konkero
podbródek - mentono
podbrzusze - abdomeno
podczas - dum
podczerwień - transruĝo
podczerwony - transruĝa
poddasze - subtegmento
podłoga - planko
podmiot - subjekto
podniebienie - palat
podnosić - levi; leviĝi
podróżować - vojaĝi
podróż - vojaĝo
podstęp - artifiko, ruzo, ruzaĵo
pod - sub; al sub
poduszka - kuseno
podziemny - subtera
podziw - admiro
pogoda - vetero
pojazd - veturilo
pojutrze - postmorgaŭ
pokal - pokalo, bierglaso
pokój - paco; paco; paco; ĉambro
pokrzywa - urtiko
pokrzywka - urtiketo; urtikario
pokwitowanie - kvitanco
Polak - polo
pół - duono
polędwica - lumbaĵo
pole - kampo
policja - polico
policzek - vango
politechnika - politekniko
polityka - politiko
półka - breto
Polka - polino
północ - noktomezo; nordo
północny - norda; noktomeza
polon - polonio
polo - poloo
połowa - duono
połoz - kolubro
półpasiec - zostero, zostro
Polska - Pollando, Polujo, Polio
południe - tagmezo; sudo
południk - meridiano
południowy - tagmeza; suda
półwysep - duoninsulo
pomarańcza - oranĝo
pomarańcz - oranĝo
pomarańczowy - oranĝa/oranĝkolora; oranĝa
pomidor - tomato
pomoc - helpo
poniedziałek - lundo
ponieważ - ĉar
popiół - cindro
popołudnie - posttagmezo
po - post; po
poprzez - pere de
porcja - porci
poród - akuŝo
porodówka - akuŝejo
poronienie - aborto
porównywać - kompari
por - poreo; poro
portfel - monujo
port - haveno; flughaveno; havenurbo; pordo
portretować - portreti
portret - portreto
porządek - ordo
posag - doto
posiadać - posedi, havi
pospolity - triviala; triviala
potas - kalio
potaż - potaso
potem - post
potop szwedzki - sveda diluvo, sveda konkero
potrzebny - necesa
potrzebować - bezoni
pot - ŝvito
potwierdzić - jesigi
potykać się - faleti; bataleti
powiat - distrikto, poviato
powiedzieć - diri
powieszenie - ekpendiĝo
powietrze - aero
powitanie - saluto
powód - kaŭzo
powodować - kaŭzi
powodzenia - bonŝancon
powódź - inundo
powołanie - alvokiĝo
powrót - reveno; reveno
powstawać - naskiĝi; ribeli; ekstari
powtarzać - ripeti
poza - ekster
pożar - incendio, brulego
pozdrowienie - saluto
poziomy - horizontala
pozwalać - permesi
pozwany - akuzito
pożyczać - prunti
P - Pet
prababcia - praavino
pracować - labori
pracowity - laborema
praczka - lavistino
prąd - kurento; fluo
pradziadek - praavo
Praga - Prago
pralka - lavmaŝino
pra- - pra
prawa zwierząt - animalaj rajtoj, bestaj rajtoj, animala liberigo, besta liberigo
prawda - vero
prawdziwość - vereco
prawdziwy - vera
prawie - preskaŭ
prawnik - leĝisto
prawnuczka - pranepino, postnepino
prawnuk - pranepo
prawny - leĝa, jura
Prawo i Sprawiedliwość - Juro kaj Justeco
prawo jazdy - kondukpermesilo, stirpermesilo
prawo - leĝaro, leĝoj; leĝo; leĝo; dekstre, dekstro
praworęczny - dekstrulo
prawy - dekstra
prażyć - rosti
precz - for
prędkość - rapido
prefiks - prefikso, antaŭafikso
prehistoria - prahistorio
premier - ĉefministro
prezent - donaco
prima aprilis - ŝercotago
próba - provludo; provo; provo, provado
próbować - provi; gustumi
procent - procento
proces - procezo, proceso; proceso
profesor - profesoro; profesoro
profit - profito
proletariusz - proleto
promet - prometio
prom - pramo
proponować - proponi
prorocki - profeta
proroctwo - profetaĵo
prorok - profeto
prosić - peti
prosię - porkido
proso - milio
prostokątny - ortangula
prostokąt - ortangulo
prosty - rekta; facila; simpla
prostytutka - amoristino, amovendistino
proszek - pulvoro
protokół - protokolo
prowadzić - konduki
Prusy - Prusio
pryskać - ŝprucigi
prysznic - duŝilo; duŝo
przecinek - komo
przeciw - kontraŭ
przed - antaŭ
przede wszystkim - precip
przedmiot - objekto
przedostatni - antaŭlasta
przedpokój - antaŭĉambro
przedpołudnie - antaŭtagmezo
przedstawiać - prezenti; prezenti; prezenti|prezenti sin
przedszkolanka - vartistino, infanistino
przedwczoraj - antaŭhieraŭ
przędza - ŝpinaĵo
przejściówka - adaptilo
przemysł - industri
przenośny - portebla
przepaść - abismo
przepiórka - koturno
przepraszam - pardonu
prześcieradło - littuko, litotuko
prześladowanie - persekutado
przesmyk - terkolo, istmo
przewodnik - gvidanto, gvidisto; gvidanto; gvidanto, gvidisto; gvidlibro
przewyższać - superi; superi; superi
Prz - Sen
przy - apud
przybywać - alveturadi, alvenadi
przychodzić - veni
przychylny - favora
przyczyna - kaŭzo
przydział - kvoto
przygotowywać - prepari, pretigi
przyjaciel - amiko
przyjechać - alveturi
przykład - ekzemplo
przylot - alflugo
przymiotnik - adjektivo
przymiotnikowy - adjektiva
przynajmniej - almenaŭ
przynosić - alporti
przypadek - kazo
przypinać - alpingli
przypominać - memorigi; simili
przyprawiać - spici
przyroda - naturo
przysięgać - ĵuri
przysięga - ĵuro
przysłówek - adverbo
przysłowie - proverbo
przysługa - komplezo
przyśpieszać - akceli
przyśpieszenie - akcelo
przystanek - haltejo
przystawka - antaŭmanĝaĵo
przyswajać - alproprigi
przyszłość - futuro
przywódca - gvidanto
przywoływać - alvoki
Ps - Psa
pstrąg - truto
psy szczekają, karawana idzie dalej - hundo bojas, homo vojas, hundo bojas, pasanto vojas
pszczelarz - abelisto, abelbredisto
pszczoła - abelo
pszenica - tritiko
Ptah - Ptaho
ptak - birdo
ptasia grypa - birda gripo
puchacz - gufo
pudelek - pudeleto
pudel - pudelo
puder - pudro
pudło - skatolo; maltrafo
pułapka - kaptilo
pułapka na myszy - muskaptilo
pułkownik - kolonelo
pumeks - pumiko
punkt - punkto
pupil - favorato
purpurowy - purpura
pustelnik - ermito, anakoreto
pustułka - turfalko
pusty - malplena
pustynia - dezerto
puszyć się jak paw - pavi
Pwt - Rea
rabat - rabato
rabin - rabeno
rachatłukum - lukumo
rączka - tenilo
raczyć - bonvoli
radar - radaro
radon - radono
rad - radiumo
radziecki - soveta
raj - paradizo
raj podatkowy - impostparadizo
rajstopy - kalsonŝtrumpoj
Rak - Kankro
RAM - ĉefmemoro
ramię - brako; ŝultro
rana - vundo
ranić - vundi
ranny - vundito
rano - matene; mateno
raper - repisto
rapier - rapiro
rap - repo
razem - kune
raz - fojo
rdza - rusto
Rdz - Gen
reakcja - reakcio, reago
ręcznie - permane
ręcznik - viŝilo
regał - bretaro
regiment - regimento
regionalizm - regionismo
region - regiono
ręka - mano
rękawica - ganto
rękaw - maniko
rekin - ŝarko
reklama - reklamo
rekomendacja - rekomendo
rekomendować - rekomendi
religia - religio
religijny - religia
renifer - norda cervo, boaco, rangifero
ren - renio
Republika Czeska - Ĉeĥa Respubliko
Republika Federalna Niemiec - Federacia Respubliko Germanio
republika - republiko
Republika Wenecka - Venecia respubliko
respekt - respekto
restauracja - restoracio
rewolucja - revolucio
RFN - FRG
robak - vermo
robić - fari
rod - rodiumo
rodzić - naski, akuŝi; naskiĝi
rodzina - familio
rodzina językowa - lingva familio
rodzynek - sekvinbero
róg - korno; korno; korno
rok - jaro
rok przestępny - superjaro
Roksana - Roksano
rok świetlny - lumjaro
rolnictwo - agrokulturo, agrikulturo
rolniczy - agrikultura
rolnik - agrokulturisto, agrikulturisto
romb - rombo
ropucha - bufo
rosa - roso
Rosjanin - rusiano, rusujano, ruslandano; ruso
Rosjanka - rusianino, rusujanino, ruslandanino; rusino
Rosja - Rusio, Rusujo, Ruslando
roślina - planto, kreskaĵo, vegetaĵo
rosnąć - kreski
rosyjski - rusa, rusia, rusuja, ruslanda
rota - roto
rower - biciklo
równanie - ekvacio
równanie stanu - ekvacio de stato
również - ankaŭ
równik - ekvatoro
równina - ebenaĵo
różany - roza
Róża - Roza
róża - rozo, rozarbo, rozujo; rozo
rozgrzeszenie - absolvo
rozmawiać - interparoli
rozmowa - interparolo
rozmyślać - konsideri
różnica - diferenco
różnić - diferencigi; diferenci
różny - diferenca
różowy - rozkolora, roza
rozpacz - malespero
rozsądny - prudenta
roztwór - solvo, solvaĵo
rozum - intelekto
rozwód - eksedziĝo, divorco
rozwój - evoluo
rtęć - hidrargo
Rt - Rut
rubid - rubidio
rubin - ruben
rudzik - ruĝgorĝulo
rum - rumo
rura - tubo
ruta - ruto
ruten - rutenio
Rut - Rut
rutyna - rutino, rutozido, soforino; rutino
ryba - fiŝo
rybka - fiŝeto
Ryby - Fiŝoj
rycerz - kavaliro
rynek - bazaro; bazarejo; merkato
rynna - defluilo
rysować - desegni
ryż - rizo
rzadko - rare, malofte
rządzić - reĝi
rzecz - aĵo, objekto
rzeka - rivero
rzemiosło - metio
rzęsa - okulharo
rzeżączka - gonoreo
rzeźba - skulptarto; skulptaĵo
rzeźnia - buĉejo
rzodkiewka - rafaneto
Rz - Rom
rzucać - ĵeti
rzucać perły przed wieprze - ĵeti perlojn antaŭ la porkojn
rzymianin - romano
Rzymianin - romiano
Rzym - Romo; Romo, Romio
rzymski - roma; romia
sąd - juĝejo
Sąd Ostateczny - Lasta Juĝo
sądowy - juĝa
sądzić - juĝi
safian - marokeno
Saipan - Saipano
Saksonia - Saksio
sala - ĉambrego, halo
salamandra - salamandr
sałatka - salato
sałatkowy - salata
salon - salono
Salwador - Salvadoro
samar - samario
sam - mem
samobójstwo - sinmortigo
samochód - aŭto
samodzielny - memstara
samogłoska - vokalo
samolot - aeroplano, aviadilo
samo- - mem
sanki - glitilo, glitveturilo
sardela - sardelo, anĉovo
Sardynia - Sardio
sari - sario
sarkazm - sarkasmo
sarkofag - sarkofago
sarna - kapreolo
sąsiad - najbaro; najbaro
Saturn - Saturno; Saturno
scenarzysta - scenaristo
scenarzystka - scenaristino
scena - sceno; sceno, scenejo
ściągać - kuntiri; kuntiri
ściana - muro
ścięgno - tendeno
ścierać - viŝi
Sdz - Juĝ
seaborg - seborgumio
sędzia - juĝisto
Sejm - Sejmo
seks oralny - buŝa seksumado
seks - sekskuniĝo, koito
sekunda - sekundo
selen - seleno
seler - celerio
senator - senatano
sen - dormo
Senegal - Senegalio; Senegalo
senny - dorma; dormema
sepsa - sepso
sepulka - sepulko
sęp - vulturo
Serbia i Czarnogóra - Serbio kaj Montenegro
serce - koro
ser - fromaĝo
serowy - fromaĝa
sezon - sezono; sezono; sezono; sezono
siać - semi
siano - fojno
siarka - sulfuro
siarkowodór - hidrogena sulfido
siatkówka - volejbalo, flugpilkado, retpilkado
siebie - si
sieć - reto; pordo, retkapto, retkaptumo
siedzieć jak mysz pod miotłą - sidi kiel muso sub balailo
siedzieć - sidi
sień - vestiblo
sierpień - aŭgusto
sierp - rikoltilo
sierść - hararo, harego
się - si
sikać - pisi, urini
sikora bogatka - granda paruo
sikora - paruo
siła - forto; potenco
silikonowy - silikona
silnik - motoro
silny - fortika
siodło - selo
siostra - fratino
siostrzeniec - nevo, fratinido
skakać - salti
skand - skandio
składać - komposti
skład - magazeno; tenejo
składnik - ingredienco; adicianto
sklepikarz - butikisto
sklep - vendejo, butiko, magazeno
skłonny - inklina
skoczek - ĉevalo
skok - salto
skóra - haŭto; ledo
skórka pomarańczowa - oranĝa haŭto
Skorpion - Skorpio
skorupa - ŝelo
skorupa ziemska - terkrusto
skowronek - alaŭdo
skroń - tempi
skrzele - brankioj
skrzydło - flugilo; flugilo; flugilo; flugilo
skrzynia - kesto
skrzypce - violono
ślad - piedsigno, paŝosigno, sekvosigno; postsigno, spuro; spuro
Śląsk - Silezio
śledziona - lieno
ślepota - blindeco, amaŭrozo
ślepy - blinda; blindulo
ślimak - heliko, limako
śliwa - prunujo, prunarbo
śliwka - pruno
śliwkowy - pruna, prunarba; pruna; prunkolora
śliwowica - prunbrando
słodki - dolĉa
słońce - suno
Słońce - Suno
słonecznik - sunfloro
słoń - elefanto; virelefanto
słoniątko - elefantido
słonica - elefantino
słonik - elefanteto
słoniowy - elefanta
słony - sala
Słowenia - Slovenio
słowik - najtingalo
słownictwo - vortprovizo; terminaro
słownik - vortaro, leksikono; vortaro
słowo - vorto; vorto
słup - kolono, fosto
służyć - servi
smacznego - bonan apetiton
smażyć - friti
śmiać się - ridi
śmierć - morto
śmierdzieć - malbonodori, odoraĉi
śmietana - kremo
smoczek - suĉilo, suĉumo
smok - drako
Sm - Sam
śniadanie - matenmanĝo
śnić - sonĝi
śnieg - neĝo
sobą - si
sobie - si
sobota - sabato
So - Cef
socjologia - sociologio
soczewica - lento
sód - natrio
sokół - falko
sok - suko
sola - soleo
solić - sali
sól - salo; salo
sopran - soprano; sopranulo
sosna - pino
sosnowy - pina; pina; pina
sos - saŭco
sowa - strigo
Sowiet - sovetano
sowi - striga
spać - dormi
spacerować - promeni
spacja - spaceto; spacklavo, spacetklavo, spacostango
spadać - fali; foriri
spam - spamo
spanie - dormado
śpiący - dormanta; dormema
spichrz - grenejo
śpiewać - kanti
śpiewnik - kantolibro
spiker - parolisto
spinacz - paperfiksilo, paperklipo
spin - spino
splot - plekso
spod - el sub
spodenki - pantaloneto; pantaloneto
spódnica - jupo
spodnie - pantalono
spokojny - trakvila
społeczeństwo - socio, civito
spółgłoska - konsonanto
sportowy - sporta
sport - sporto
spotkanie - renkontiĝo
spowiedź - konfeso
sprawa - afero
sprawiać - kaŭzi
sprawiedliwość - justeco
Sprawiedliwy wśród Narodów Świata - Justuloj inter la popoloj
sprężyna - risorto
sprzedawać - vendi
sprzedaż - vendo
srebrny - arĝentkolora; arĝenta
srebro - arĝento
średnik - punktokomo
Sri Lanka - Sri-Lanko
sroczy - piga
środa - merkredo
Środa Popielcowa - Cindra Merkredo
środek - mezo
środkowy - centra
Śródziemie - Mez-Tero
sroka - pigo
srom - vulvo
śruba - ŝraŭbo; ŝipŝraŭbo
ssać - suĉi; mamsuĉi
stacja - stacio
stać - stari
stadion - stadiono
stal - ŝtalo
standard - normo
stan - stato; ŝtato
Stany Zjednoczone - Usono, Unuiĝintaj Ŝtatoj de Ameriko
starość - maljuneco
starożytny - antikva
stary - maljuna; malnova
starzec - maljunulo
statek - ŝipo
stawiać - starigi
staw - lageto; artiko
Stefan - Stefano
step - stepo
ster - direktilo
stolica - ĉefurbo
stół - tablo
stonka - terpoma skarabo
stonka ziemniaczana - terpoma skarabo, terpomskarabo
stonoga - onisko
stopa - futo
stop - alojo
stopień - ŝtupo; grado
stożek - konuso
strach - timo
strajk - striko
strażak - fajroestingisto
stres - streso
streszczenie - resumo
strofować - admoni
strona - paĝo; voĉo
strusi - struta
struś - struto
strychnina - striknino
strych - subtegmento
stryj - onklo
strzała - sago
Strzelec - Sagitario
studnia - puto
stwardnienie rozsiane - sklerozo multloka
styczeń - januaro
styl - stilo
subiekt - komiz
sufiks - sufikso
sufit - plafono
suka - hundino
sukces - sukceso
sukno - drapo
sułtanat - sultanlando
sum - siluro
supermarket - superbazaro
suponować - supoz
suseł - zizelo
sutek - cico
świadek Jehowy - atestanto de Jehovo
światło - lumo
światłowód - lumkonduktilo
świat - mondo
światowy - monda; monduma
świątynia - sanktejo
świeca - kandelo
świerk - piceo
świerszcz - grilo
święto - festo
święty - sankta; sanktulo
świeży - freŝa
świnia - porko
świnka morska - kobajo
świński - porka
świstak - marmoto
świt - aŭroro; aŭroro
swój - sia
Sycylia - Sicilio
sygnał - signalo
syk - siblo
sylur - silurio
syn - filo
sypialnia - dormoĉambro
syrop klonowy - acera siropo, acersiropo
syrop - siropo
Syr - Sir
szachista - ŝakisto, ŝakludanto
szachistka - ŝakistino, ŝakludantino
szach - ŝako; ŝakon!; ŝaho
szachy - ŝako
szafa - ŝranko
szafran - safrano; safrano
szakal - ŝakalo
szałamaja - sxalmo
szalotka - ŝaloto
szałwia - salvio
szampan - ĉampano
szarańcza - akrido
szarość - grizo
szary - griza
szczaw - okzal
szczęka - makzelo
szczery - sincera
szczotka - bros
szczupak - ezoko
szczur - rato
szczygieł - kardelo
szczypiornista - manpilkisto
szczyt - pinto
szef - ĉefo
szermierka - skermo
szeroki - larĝa
szerszeń - krabro
sześcian - kubo
szewc - botisto, ŝuisto
szklanka - glaso
szkło - vitro
szkoła - lernejo
szkoła podstawowa - bazlernejo, baza lernejo, elementa lernejo
szkolny - lerneja
szlachcic - nobelo
szlachetny - nobla
szlifierz - akrigisto
szminka - ŝminko
sznur - ŝnuro
szpadel - ŝpato, fosilo
szpak - sturno
szpat - spato
szpital - malsanulejo, hospitalo
szpulka - bobeno
szron - prujno
Sztokholm - Stokholmo
sztuka - arto
sztuki piękne - belarto
sztylet - ponardo
szubienica - pendumilo
szuflada - tirkesto
szum - bruo
szumieć - zumi brui
Szwabia - Ŝvaboj
szwagier - bofrato
szwagierka - bofratino; bofratino
Szwajcaria - Svislando, Svisujo, Svisio
Szwecja - Svedio, Svedujo
szybko - rapide
szybkość - rapideco; rapido
szybowiec - glisilo
szyć - kudri
szydło - aleno
Szydłowiec - Shidlovetto
szyja - kolo
tabaka - flartabako, naztabako, snuftabako
tabela - tabelo
tablica rejestracyjna - aŭtokodo
Tadeusz - Tadeo
Tadżykistan - Taĝikistano, Taĝikio
tajemnica - sekreto
tajemniczy - mistera
Tajlandia - Tajlando
Tajwan - Tajvano
taki - tia
tak - jes
taksówka - taksio
talent - talento; talentulo; talanto
talerz - telero
tal - talio, taliumo
tam - tie
tancerz - dancisto; dancanto
tantal - tantalo
Tanzania - Tanzanio
tapeta - tapeto
targ - bazaro
tata - paĉjo
Tb - Tob
tchórz - putoro
technet - teknecio
tęcza - ĉielarko
telefon komórkowy - poŝtelefono
telefon - telefono
tellur - teluro
temat - temo; radiko
tematyczny - tema
tengen - centra stelo
ten śmiać się śmieje, kto śmiać się śmieje ostatni - plej bone ridas, kiu laste ridas
Teodor - Teodoro
teoria - teorio
terb - terbio
Teresa - Tereza, Teresa
terminologia - terminaro
termin - termino; templimo, limtempo
termodynamika - termodinamiko
tęsknić - sopiri
testament - testamento
Tes - Tes
Tezeusz - Tezeo
Timor Wschodni - Orienta Timoro
Tirana - Tirano
tirańczyk - tiranano
tiranka - tirananino
tirański - tirana
tkalnia - teksejo
tkanina - teksaĵo, ŝtofo
tlen - oksigeno
tło - fono
tłuczek - pistilo
tłumacz - tradukisto; tradukisto
tłuszcz - graso
Tm - Tim
tok pisin - piĝina lingvo
tolerancja - toleremo
Tomasz - Tomaso
tombak - tombako
tom - volumo
topaz - topazo
topnieć - degeli
topografia - topografio
topola - poplo
topór - hakilo
torfowisko - torfejo
torf - torfo
tornister - tornistro
tor - torio
tort - torto
towar - varo, komercaĵo
towarzyszyć - akompani
trąba - tubjo; kirloventego, trombo; rosto
tracić - perdi; ekzekuti
trąd - lepro
trądzik - akno, akneo
tragedia - tragedio
tragiczny - tragedia; tragika
tramwajowy - trama
tramwaj - tramo
transport - transporto
trans - tranco
traumatologia - traŭmatologio
trawa - herbo
trochę - malmulte, malgrande
trolejbus - trolebuso
tron - trono
troskliwy - zorgema, zorgoplena
troszczyć się - zorgi
trucizna - veneno
trujący - venena
trunek - alkoholaĵo
trupa - trupo
truskawka - frago
trymestr - trimestro, trimonato, jarkvarono, kvaronjaro; trimestro, trimonato
trzecia wojna światowa - tria mondmilito
Trzeci Świat - tria mondo
trzeźwy - sobra
trzmiel - burdo
Tt - Tit
tu - ĉi tie, tie ĉi
tukan - tukano
tulipan - tulipo
tul - tulio
tumult - tumulto
Tunezja - Tunizio
turban - turbano
turkawka - turto
turkusowy - turkisa
tur - uro
Turyn - Torino
tusz - tuĉo; duŝo
tuż - preskaŭ
twardy - dura
twaróg - kazeo
twarz - vizaĝo
twierdzić - afirmi
twój - via, ''rzadziej'' cia
tybetański - tibeta
Tybet - Tibeto
tydzień - semajno; semajno
tygrysica - tigrino
tygrysi - tigra
tygrys - tigro
tylko - nur
typografia - tipografio
tytoń - nikotiano, tabako; tabako
Tyt - Tit
tytuł - titolo; titolo
ty - vi, ''rzadziej'' ci
ubogi - povra
ucho - orelo
uczeń - lernanto
uczestniczyć - partopreni
uczyć - instrui; lerni
udo - femur
Uganda - Ugando
Ugandyjczyk - ugandano
Ugandyjka - ugandanino
ugandyjski - uganda
układ okresowy - perioda tabelo
układ okresowy pierwiastków - perioda tabelo de la elementoj
układ planetarny - planedsistemo
Układ Słoneczny - Sunsistemo
ukleja - alburno
Ukraina - Ukrainio, Ukrainujo, Ukrajno
ul - abelujo
ulewa - pluvego
ulica - strato
ulicznica - stratulino
ultimatum - ultimatum
ultrafioletowy - transviola
ulubiony - preferata, plej ŝati|ŝatata
umierać - morti
umysł - menso
Unia Europejska - Eŭropa Unio
uniform - uniformo
uniwersalny - universal
uniwersytet - universitato
uparciuch - obstinulo
uparty - obstina
upiór - fantomo
uprzejmy - afabla
Ural - Uralo
uran - uranio
urbanista - urboplanisto
urna - urno; balotujo
urodziny - naskiĝtago; naskiĝo
Urugwajczyk - urugvajano
Urugwaj - Urugvajo
uśmiechać się - rideti
uśmiech - rideto
uspokajać - trankviligi; trankviliĝi
usta - buŝo
uszny - orela
uwertura - uverturo
uwodzić - delogi
uwodziciel - delogisto
uwodzicielka - delogistino
Uzbekistan - Uzbekio
uzurpować - uzurpi
używać - uzi
volapük - volapuko
wąchać - flari
wachlarz - ventumilo
Waga - Pesilo
waga - pesilo; pezo
wagary - lernej-evitado
wagon - vagono
Waldemar - Valdemaro
walec - cilindro
wałek do ciasta - rulknedilo, rulpremilo
walizka - valizo
waluta - valuto
wanad - vanado
wanienka - kuveto
wanna - bankuvo
wapń - kalcio
warga - lipo
warkocz - harligo
warstwa - tavolo
Warszawa - Varsovio
Warta - Varto
warunek - kondiĉo; kondiĉoj
warzyć - bierfari
wasal - vasalo, feŭdulo
wąski - mallarĝa
wąs - lipharoj
wasz - via
Waszyngton - Vaŝingtono
wątroba - hepato
wątrobianka - hepatkolbaso, hepata kolbaso
wat - vato, ŭato
Watykan - Vatikano; Vatikano
ważka - libelo
ważny - grava
wąż - serpento
ważyć - pesi; pezi
wchodzić - eniri
wczoraj - hieraŭ; hieraŭo, antaŭtago
wdowa - vidvo
wdowiec - vidvo
wędlina - ŝink
według - laŭ
wegetarianizm - vegetarismo
węgiel - karbono
węgorz - angilo
Węgry - Hungario, Hungarujo
welin - veleno
wełna - lano
w - en
Wenecja Euganejska - Veneto
Wenecja - Venecio
Wenezuela - Venezuelo
Wenezuelczyk - venezuelano
Weronika - Veronika
Wersal - Versajlo
wesele - nupto
Wesołych Świąt - ĝojan Kristnaskon; feliĉan Kristnaskon
wesz - pediko
weterynarz - bestkuracisto
węzeł gordyjski - gordia nodo
węzeł - nodo, banto; nodo, knoto
wężowy - serpenta
wiadro - sitelo
wiara - kredo
wiatrak - ventmuelejo
wiatrówka - aerpafilo
wiatr - vento
wiciokrzew - lonicero
widelec - forko
widmo - fantomo; spektro
widzieć - vidi
więc - do
wieczorny - vespera
wieczór - vespero
Wiedeń - Vieno
więdnąć - velki
wiedza - scio
wiedzieć - scii
wiek - aĝo; jarcento
wielbłąd - kamelo
wielbłądzi - kamela
wiele - multe
Wielka Brytania - Britujo, Britio, Unuiĝinta Reĝlando; Britio, Granda Britio
Wielkanoc - Pasko
Wielki Wybuch - Praeksplodo
wielkoduszny - grandanima
wieloryb - baleno
wieniec laurowy - laŭrokrono; laŭrokrono
wieprzowina - porkaĵo
wierny - fidela; fidela
wiersz - versaĵo; verso
wierzba - saliko
wierzyć - kredi
wieśniak - vilaĝano, kamparano
wieś - vilaĝo, kamparo
Wietnam - Vjetnamio, Vjetnamujo
wiewiórka - sciuro
wieża - turo; turo
więzienie - malliberejo, prizono
więzień - malliberulo
wieżowiec - nubskrapulo
Wikipedia - Vikipedio
wikipedysta - Vikipediisto
Wikisłownik - Vikivortaro
Wikiźródła - Vikifontaro
wilczyca - lupino
wilczy - lupa
Wilhelm - Vilhelmo
wilk - lupo
wilk syty i owca cała - ke la lup' estu sata, kaj la ŝaf' ne tuŝata
winda - lifto
winny - kulp
winogrono - vinbero
wino - vino
wiolonczela - violonĉelo
wioślarka - remistino
wioślarstwo - remado
wioślarz - remisto
wiosło - remilo
wiosna - printempo
wisieć - pendi
Wisła - Vistulo
wiśnia - ĉerizo
wiśniowy - ĉerizuja; ĉeriza; ĉerizkolora
witraż - vitralo
władza - potenco
właśnie - ekzakte
własny - propra
Włoch - italo
Włochy - Italio, Italujo
Włodzimierz - Vladimiro
włos - haro
włoski - itala; la itala
Włoszka - italino
wnętrze - interno
wnuczka - nepino
wnuk - nepo
woda - akvo
Wodnik - Akvisto, Verŝisto; Akvisto, Verŝisto
wodnik - akvofeo
wodny - akva
wodociąg - akvokondukilo
wodór - hidrogeno
wodospad - akvofalo, falakvo
wojenny - milita
wojewoda - vojevodo
województwo - vojevodujo, vojevodlando, vojevodio
wojna domowa - enlanda milito
wojna - milito
wołać - voki
woleć - preferi
wolfram - volframo
Wołga - Volgo
wolnomularz - framasono
wolność - libereco, libero
wolny - libera; lanta, malrapida; libera
wołowina - bovaĵo
worek - sako
wracać - reveni
wrażenie - impreso
wróbel - pasero
wróg - malamiko
wrona - griza korniko
wrota - pordo
wrotka - radŝuo
wróżka - feino
wrzątek - bolaĵo, ''o wodzie'' bolakvo
wrzesień - septembro
wrzód - ulcero
wrzutka - rebata kapto, muskaptilo
wschód - sunleviĝo; oriento
wściekły - furioza
wspaniałomyślny - grandanima
współautor - kunaŭtoro
współczynnik załamania - refrakta indico
Wspólnota Niepodległych Państw - Komunumo de Sendependaj Ŝtatoj
wspólny - komuna
wstydzić się - honti
wszyscy - ĉiuj
wszystko - ĉio
wtedy - tiam
wtorek - mardo
wujek - onklo
wulkan - vulkano
wybawca - savanto, savinto
wybierać - elekti
Wybrzeże kość Kości Słoniowej - Kotdivaŭro, Ebur-Bordo, Ebura Bordo
wychodzić za mąż - edziniĝi
wyć - hurli; hurli; hurli
wycieczka - ekskurso
wydawać - elspezi; eldoni
wydra - lutro
wyglądać - aspekti
wygląd - aspekto
wygodny - komforta
wyjątek - escepto
Wyj - Eli
wyjść - eliri; eliri
wykonalny - farebla, realigebla
wykrzyknik - krisigno; interjekcio
wylewać - elverŝi
wymowa - elparolo, prononco
wynajmować - lui, lupreni; luigi, ludoni
wypadek - incidento, okazo; akcidento
wypalać - kaŭterizi; baki
wyrok - juĝo
wysoki - alta
Wyspa Bożego Narodzenia - Kristnaskinsulo
wyspa - insulo
Wyspa Świętego Tomasza - Saotomeo, Sao-Tomeo
Wyspa Świętego Wyspy Świętego Tomasza i Wyspa Książęca - Sao-Tomeo kaj Principeo
wyspiarz - insulano
Wyspy Kanaryjskie - Kanarioj, Kanario Insuloj
Wyspy Owcze - Ferooj
wy - vi
wyznanie - konfesio; konfeso, konfidenco
wzdłuż - laŭlonge de; laŭlonge
wzmacniać - amplifi
wzrost - kresko; kreskado
y - y, ipsilono
żaba - rano
zabawka - ludilo, amuzilo
zabawny - amuza
ząb - dento
żabka - raneto
zachód - sunsubiro; okcidento
zaćmienie - eklipso
zaczynać - komenci
żaden - nenia
żądło - pikilo
zadowolony - kontenta
zagadka - enigmo
żagiel - velo
żaglowiec - velŝipo
zagranica - eksterlando
Zagrzeb - Zagrebo
zając - leporo
zakładnik - garantiulo
zakonnica - monaĥino
zakonnik - monaĥ, patro, monaĥo, monak, monako
zakon - orden
zakrywać - kovri
żal - bedaŭro
żałobny - funebra
zamach stanu - puĉo
Zambia - Zambio
Zambijczyk - zambiano
Zambijka - zambianino
zambijski - zambia
zamek - kastelo; seruro
zamknąć - fermi
zamykać - fermi
zapach - odoro
zapalenie - inflamo, brulumo; ekbruligo
zapalenie płuc - pneŭmonito, pneŭmonio
zapałka - alumeto
zapalniczka - fajrilo
zapominać - forgesi; forgesi
zarabiać - perlabori
Zaratusztra - Zaratuŝtro
zaratusztrianizm - zaratuŝtrismo
żargon - ĵargono
żarówka - ampolo
żartować - ŝerci
zarzut - akuzo, akuzaĵo
żarzyć się - fuzi
zasada - principo
zasadzka - embusk
zaskroniec - natriko
zasługiwać - meriti
zasłużony - merita
zatoka - golfo
zawiadomienie - avizo
zawierać - enhavi, ampleksi
zawód - profesio
zawodzić - hurli
zawsze - ĉiam
zazdrosny - ĵaluza
żbik - sovaĝa kato
zbiór - aro
zbłaźnić się - kompromitiĝi, kompromiti sin
zbliżać - alproksimiĝi
zboże - greno
zbyt - tro
z całego serca - tutkore
zdarzenie - okazo, incidento
zdrada - perfido
zdradzać - perfidi
zdrowie - sano
zdrowy - sana
zdun - fornisto
źdźbło - kulmo
żebraczka - almozulino
żebrak - almozulo, almozisto
zebra - zebro
zebu - zebuo
zefir - zefiro
zegar - horloĝo
zegarmistrz - horloĝisto
że - ke
żelazny - fera
żelazo - fero
żelbet - ferbetono, ŝtalbetono, subferigita betono, armita betono
z - el; kun
zero - nulo
zespół - muzikistaro
zeszyt - kajero
zgniły - putrinta; putrinta
zgrabny - svelta
zięba - fringo
zieleń - verdo
zielony - verda
ziemia - tero
ziemniak - terpomujo; terpomo
zima - vintro
zimna wojna - malvarma milito
zimorodek - alciono
zimowy - vintra
Zjednoczone Królestwo - Unuiĝinta Reĝlando
źle - malbone
złodziej - ŝtelisto
złość - kolero
złoto - oro; oro
złoty - ora; orkolora; zloto
zły - malbona
zmartwienie - afliktiĝo, aflikto
zmęczony - laca
zmieniać - ŝanĝi
zmierzch - krepusko
żmija - vipuro, vipero
zmrok - krepusko
zmuszać - devigi; devigi sin, sindevigi
znać - koni
znaczek pocztowy - poŝtmarko, signo de poŝto
znajdować - trovi; troviĝi
znak - signo; signo, signumo
znowu - ree
znudzony - enuigita
Zofia - Sofio, Sofia
żołądek - stomako
żółć - galo
żołnierz - militisto, soldato
żółtaczka - iktero
żółtko - ovoflavo
żółty - flava
żółwik - pugnokarambolo
żółwi - testuda
żółw - testudo
żona - edzino
zoologia - zoologio
zoolog - zoologo
zootechnika - zootekniko
Zosia - Sonjo, Sofinjo
źrebię - ĉevalido
źródło - fonto
źródłosłów - etimo
ZSRR - USSR
zszywka - krampo
żuaw - zuavoj; zuavo
żubr - eŭropa bizono
żuć - maĉi
żuk - geotrupo, sterkoskarabo, sterkskarabo
zupa - supo
żuraw - gruo
żurawina - oksikoko; oksikoko
żurek - acida faruna supo
Zuzanna - Susano
zwalniać - malakceli
Związek Radziecki - Sovetunio
Związek Socjalistycznych Republik Radzieckich - Unio de Sovetaj Socialismaj Respublikoj
zwierzę - animalo, besto
zwierzęcy - besta, animala
zwierzyna - ĉasaĵo
zwrotnik - tropiko
zwycięstwo - venko
zwyciężać - venki
zwyczajny - ordinara
zwykle - ordinare
zwykły - ordinara
życica - lolo
życie - vivo
żyć - vivi
życzenie - deziro
życzyć - deziri
żyd - judo
Żyd - judo
żydowski - juda
żyła - vejno
żyrafa - ĝirafo
żyrandol - lustro
żyroskop - giroskopo
żywić - nutri
żywność - nutraĵo
żywy - viva
