Aaron - هارون
Abadan - عبادان
abaja - عباءة
abakus - أباكوس
Abchazja - أبخازيا
abdykacja - تنازل
abdykować - تخلى, تنازل
abdżad - أبجد
Abel - هابيل
aberracja - زيغ
Abidżan - أبيدجان
Abisyńczyk - حبشي
Abisynia - الحبشة , الحبش
abisyński - حبشي
ablucja - وضوء ,غسل
abolicja - إلغاء
aborcja - إجهاض
abrahamowy - متعلق إبراهيم|بإبراهام بطريرك|البطريرك
Abraham - إبراهيم , الخليل
Abramczyk - أبرامتشيك
Abruzja - أبروتسو
absencja - عدم، انتفاء، تغيب، انعدام، لاوجود، فقدان، غياب
absolutnie - قطعا
absolutny - مطلق
absolwentka - خريجة
absolwent - خريج
absorbować - امتص
abstynencja - صيام
absurdalnie - بحماقة ,بسخف
absurd - لغو
Abudża - أبوجا
Abu Zabi - أبوظبي
aceton - أسيتون
ach - آه
Adam - آدم
Addis Abeba - أديس أبابا
adekwatny - لازم, ملائم, كاف, مكافئ
adipocyt - الخلايا الدهنية ,خلية دهنية
administracyjny - إداري
administrator - مدير
administrować - دبر
admiralicja - ‎أميرالية
adopcja - تبن
adoracja - توقير ,عبادة
adorować - هام
adrenalina - أدرينالين
adres - عنوان
adwersarz - عدو، خصم، غريم، ند
adwokat - محام
adyton - حرم
aerodynamika - ديناميكا هوائية
Afgańczyk - ‎أفغاني
Afganistan - أفغانستان
Afganka - أفغانية
afgański - ‎أفغاني
afirmacja - استحسان
aforyzm - مثل
Afrodyta - أفروديت
afrykanerski - أفريقانية أفريقاني
Afrykanin - أفريقي
Afrykanka - إفريقية
afrykański - أفريقي
Afryka Północna - شمالي أفريقيا ,شمال أفريقيا
Afryka - أفريقيا
agar - عود هندي
agat - عقيق
agawa - أغاف
agenda - أجندة
agent - ممثل
agnostycyzm - لاأدرية
agnostyczny - لاأدري, لا أدري
agnostyk - لاأدري, لا أدري
agresywny - عدواني, مناضل, عدائي
akacja - طلح, سلم, سنط, أكاسيا
akademia - أكاديمية
akademicki - دراسي ,أكاديمي ,مدرسي
akademik - أكاديمي
akcent - نبرة
akceptować - قبل
akcja - عمل
Akra - أكرا
akropol - أكروبوليس
aksamit - مخمل
aksjomatyczny - بديهي
aksjomat - بديهية
aktorka - ممثلة
aktor - ممثل
aktualny - حالي
aktyn - أكتينيوم
aktywność - نشاط ,فعالية ,حيوية
aktywny - نشيط
akt - شهادة
akumulator - بطارية مختزنة, بطارية
akwamaryn - أكوامارين
Akwitania - أكيتانيا, أكيتين
Alabama - ألاباما
Alan - آلان
Alaska - ألاسكا
Albańczyk - ألباني / الباني
Albania - ألبانيا
Albanka - البانية / ألبانية
albański - ألباني / الباني ; البانية
albatros - قطرس
albinos - الأمهق
albo - أو
album - ألبوم
alchemia - خيمياء ,الخيمياء
aleja - زقاق
Aleksandria - الإسكندرية
alembik - إنبيق
Aleppo - حلب
alergia - حساسية, أرجية
ale - لكن, أما
alfabetyczny - ابجدي
alfabet - ألفباء, أبجدية, ‎أبجد, حروف الهجاء
Al-Falludża - الفلوجة
alfa - ألفا
algebra - جبر
Alghero - ألغيرو
Algierczyk - جزائري
Algieria - الجزائر
Algierka - جزائرية
algierski - جزائري
Algier - الجزائر
Algol - رأس الغول
algorytm - الخوارزمية
Alicante - أليكانتي
Alicja - أليس
alkoholizm - إدمان كحولي , كحولية
alkoholowy - كحولي
alkohol - مشروب كحولي كحول
alkowa - قبة
Allah - الله
alleluja - هللويا, هليلويا
aloes - صبر
Alpy - جبال الألب
Al-Quds - القدس
altruista - غيري
altruistyczny - غيري
altruizm - إيثار, غيرية
Alzacja - ألزاس
amarylis - أمارلس
Amazonka - نهر الأمازون, أمازون
amazoński - أمازوني ; أمازوني
ambaras - روعة , اشكال
ambasada - ‎سفارة
ambasador - سفير
Ambroży - أمبروز
ambulans - سيارة إسعاف
ameba - أميبا
Ameryka Łacińska - أمريكا اللاتينية
Amerykanin - أمريكي
Amerykanka - أمريكية
amerykański - أمريكي
Ameryka Północna - أمريكا الشمالية
Ameryka Południowa - أمريكا الجنوبية
Ameryka - أمريكا
ameryk - أمريكيوم
ametyst - جمشت
amfetamina - أمفيتامين
amfiteatr - مدرج مسرحي ,مدرج
amfora - أمفورة
amharski - أمهرية
Amman - ‎عمان
amnestia - عفو عام ,عفو
amoniak - أمونياك
amper - أمبير
amplituda - مطال
amputacja - بتر
amputować - بتر
Amsterdam - أمستردام
Amu-daria - جيحون
Amur - نهر آمور ,آمور
analfabeta - أمي
analityczny - تحليلي, إعرابي
analiza - تحليل
analizować - دقیق ,حلل ,أعرب
analogia - قياس ,محاكاة
ananas - ‎أناناس
anarchia - فوضى
anarchista - فوضوي
anarchistyczny - فوضوي
anarchizm - لاسلطوية
Anatolia - أناضول
anatomiczny - تشريحي
Andaluzja - الأندلس, أندلوسيا, أندلسيا
Andora - أندورا
Andrzej - أندراوس
anegdota - نادرة
aneksja - إضافة
anemometr - مرياح
Angielka - إنجليزية
angielski - إنجليزي
angina - التهاب اللوزتين
angiografia - قثطرة شريانية , تصوير الأوعية
angiologia - طب الأوعية الدموية
Anglia - إنجلترا ,إنكلترة
Angola - أنغولا, أنجولا
anime - أنمي
animizm - إحيائية
anioł - ملاك , ملك
Ankara - أنقرة
ankieta - استبيان
antagonista - خصم
antagonistyczny - عدائي
Antananarywa - أنتاناناريفو
Antarktyda - أنتاركتيكا
antidotum - ترياق
Antigua i Barbuda - أنتيغوا وبربودا
antonim - نقيض
antropologia - علم الإنسان, أنثروبولوجيا
antropologiczny - أنثروبولوجي
antropolog - أنثروبولوجي
antykoncepcja - تحديد النسل
antylopa - ظبي
antymon - إثمد ,انتيمون ,كحل
antypatia - جفاء, كراهية
anulować - ألغى
anyż - يانسون
aorta - أبهر
aparat fotograficzny - آلة تصوير, كاميرا
aparat - أداة
apartheid - أبارتيد
apatyczny - متقاعس, متلكئ ,فاتر الشعور
apetyt - شهوة
aplikacja - برمجيات تطبيقية ; تطبيق
Apollo - أبولو
apostata - مرتد
apostazja - ردة ''''
aprobata - استحسان
apteczka pierwsza pierwszej pomocy - صندوق الإسعافات الأولية
aptekarski - صيدلي
aptekarz - صيدلي
apteka - صيدلية
arabeska - زخرفة عربية, أرابيسك
Arabia Saudyjska - السعودية
arabista - مستعرب , أخصائي عربية|بالعربية
arabistyka - الدراسات العربية
Arabka - عربية
arabski - عربي العربية
arab - حصان عربي , جواد عربي
Arab - عربي
arak - عرق
aramejski - آرامية آرامي
Ararat - جبل أرارات , أرارات
Arbela - أربيل, اربل
arbiter - حكم
arbuz - بطيخة, بطيخ أحمر, رقي
archaiczny - قديم, مهجور
archanioł - رئيس الملائكة
archeologia - علم الآثار
archeologiczny - أثري
archeolog - أثري
archipelag - أرخبيل
architektoniczny - معماري
architektura - عمارة
architekt - معمار
arena - حلبة
aresztować - اعتقل
aresztowanie - سجن ,اسر
Ares - آرس , آريز
Argentyna - الأرجنتين
Argentyńczyk - أرجنتيني
argentyński - أرجنتيني
argon - أرغون
Ariowie - آريون
Arizona - أريزونا
Arkansas - أركنساس
Arktyka - أركتيك
Armenia - أرمينيا
armia - جيش ,جند
arogancja - شموخ
arogancki - جبار, باذخ, عات, متغطرس, متكبر
aromaterapia - طب الروائح
aromatyczny - عطري, عاطر
arsen - زرنيخ
Artemida - أرتميس
arteria - شريان
artykuł - مقال, مقالة
artysta - فنان
artystka - ‎فنانة
artystycznie - فنيا
artystyczny - فني
Aruba - أروبا
Arwad - أرواد
aryjski - آري
arystokratyczny - أرستقراطي ,راق
Arystoteles - أرسطو, أرسطوطاليس, أرسطاطاليس
arytmetyczny - حسابي
asceta - زاهد
asfalt - أسفلت
Asmara - ‎أسمرة ; السمارة
aspiryna - ‎أسبرين
Astana - أستانا
astat - أستاتين
asteroida - كويكب ; دويري تحتي
asterysk - نجمة
astma - ربو
astrolabium - أسطرلاب
astrologiczny - فلكي
astrolog - منجم
astronomia - علم الفلك
astronomiczny - فلكي
astronom - عالم فلكي , فلكي
Asyria - آشور
Asyryjczyk - آشوري
Aszchabad - عشق آباد
atak serca - نوبة قلبية , احتشاء عضل القلب, جلطة قلبية
atak - مهاجمة ; إعتداء هجوم
atawizm - تأسل
ateista - ملحد , دهري
ateizm - إلحاد
Atena - آثينا
Ateny - أثينا
atlantycki - أطلسي
atłas - اطلس
Atlas - الأطلس, جبال الأطلس
atmosfera - هواء ,غلاف جوي
atomowy - ذري
atom - ذرة
atrakcyjność - جاذبية
atrakcyjny - جذاب, وسيم
atrament - حبر
aureola - هالة
Australia - أستراليا
Australijczyk - أسترالي
Australijka - أسترالية
australijski - أسترالي
austriacki - نمساوي
Austriaczka - نمساوية
Austriak - نمساوي
Austria - النمسا
autentyczny - حقيقي
autobus - حافلة, أوتوبيس, باص
autokracja - أوتوقراطية
autokratyzm - أوتقراطية
automatyczny - اوتوماتيكي
Autonomia Palestyńska - سلطة وطنية فلسطينية
autopsja - تحليل, تجربة, خبرة تشريح الجثة
autorytatywny - آمر
autorytet - نفوذ
autor - كاتب, مؤلف
autyzm - توحد
awersja - كره, مقت, بغض
awokado - أفوكادو
Azerbejdżanin - أذربيجاني
Azerbejdżanka - أذربيجانية
azerbejdżański - أذربيجاني
Azerbejdżan - أذربيجان
azerski - أذربيجاني
Azja Mniejsza - آسيا الصغرى
Azjata - آسيوي
Azjatka - آسيوية
azjatycki tygrys - نمر آسيوي
azjatycki - آسيوي
Azja - آسيا
Azory - الأزور
azotan - نترات
azot - نيتروجين
azyl - موئل ; لجوء, حق اللجوء
aż - حتى حتى
babcia - جدة
babka - لسان الحمل
bać się - خاف ,خشي, رعب, رهب ,خشي, ذعر
badać - بحث ,نظر
badanie - امتحان بحث ,نظر
badian właściwy - يانسون نجمي
badminton - تنس الريشة, بدمينتون
bagaż - أمتعة , رحل
Bagdad - بغداد
bagietka - رغيف فرنسي , باغيت , خبز فرنسي
bagnet - حربة
bahaizm - بهائية
Bahamy - البهاما
Bahrajn - البحرين
bajka - حكاية
bakelit - باكيليت
baklawa - بقلاوة
bakłażan - باذنجان
bakteria - بكتيريا ,جراثيم, جرثومة
bakteryjny - ‎جرثومي, ‎بكتيري
Baku - باكو
bałagan - فوضى
balet - الباليه
Bałkany - البلقان
balkon - شرفة , ‎بلكون , بلكونة
balon - بالون
balsam - ‎مرهم, بلسم
Bałtyk - بلطيق
Bamako - باماكو
bambus - خيزران
banan - موز, موزة
bandaż - ضماد , ضمادة
Bandżul - بانجول
Bangi - بانغي
Bangkok - بانكوك
Bangladesz - بنغلاديش
banjo - بانجو
bańka mydlana - فقاعة صابون
bank krwi - مصرف الدم
bankomat - صراف آلي
bankructwo - إفلاس , عجز
bankrut - مفلس
bank - مصرف
Baran - برج الحمل
baran - كبش
Barbados - بربادوس
Barbara - باربرا
Barcelona - برشلونة
bardzo - جدا
bard - شاعر
bark - كتف
Barnaba - برنابا
barokowy - باروكي
barter - نظام المقايضة
barwić - صبغ
barwienie - صباغة
barwnik - صباغ ,صبغة ,صبغ
barykada - سد بمتراس
bar - بار باريوم
basen - مسبح, بركة, حمام السباحة
Baskijka - بشكنشية
baskijski - باسكية باسكي
Bask - باسكي
baśń - أسطورة
bat - سوط
Bawaria - بافاريا
bawełna - قطن
bawić - لعب ,لها
bawół - جاموس
bazalt - بازلت
bazar - سوق, بازار
baza - قاعدة , أساس
Bazylea - بازل
beatyfikacja - تطويب
bęben - طبل
bednarz - صانع البراميل
Beduin - بدوي
Bejrut - بيروت
Belfast - بلفاست
Belgia - بلجيكا
belgijski - بلجيكي
Belgrad - بلغراد
Belg - بلجيكي
Belize - بليز
bengalski - بنغالية بنغالي
Benin - بنين
benzyna - بنزين
berberyjski - بربري
berberys - برباريس
Berber - ‎بربري
beret - بيريه
berkel - بركيليوم
Berlin - برلين
Bermudy - برمودا ,جزر برمودا
Berno - برن
beryl - بيريليوم ; بيريل
beta - بيتا
Betlejem - بيت لحم
beton - خرسانة
bezbożnik - الملحد
bezbożność - إلحاد ,كفر
bezbożny - ملحد, كافر
bezczelny - قليل الحياء
bezczynność - بطالة
bezdomny - مشرد
bezmiar - وسع
bezmózgi - سخيف
beznadzieja - إياس
beznadziejny - يائس
bezokolicznik - مصدر ,صيغة المصدر
bezowocny - باطل
beżowy - بيج
bezpieczeństwo - أمن ,أمان
bezpieczny - سليم, آمن, سالم
bezpośrednio - رأسا ,مباشرة
bezpośredni - مباشر مستقيم
bezrobocie - بطالة
bezrobotny - عاطل
bezsenność - أرق, سهد, سهاد
bezsensowny - فارغ, محال
bezstronny - حيادي
bezwartościowy - غس
bezwłosy - أصلع
bez - بدون ,دون
beż - بيج
Bhutan - بوتان
biała herbata - شاي أبيض
Białorusinka - بيلاروسية
Białorusin - بيلاروسي
białoruski - بيلاروسية بيلاروسي
Białoruś - روسيا البيضاء, بيلاروسيا
białozór - سنقر
biały fosfor - فسفور أبيض
biały - أبيض abjad , بيضاء bajda²
Biblia - الكتاب المقدس
bibliografia - ببليوجرافيا
biblioteka - مكتبة
biedak - ‎فقير
bieda - فقر, فاقة
biedny - فقير
bieganie - عدو
biegunka - إسهال
biegun - قطب
biel - أبيض
bierne palenie - تدخين سلبي
bierność - سلبية
bierny - سلبي
bieżący - آني, حالي, راهن, جار, حاضر
bikini - بكيني
bilet - تذكرة
biochemia - كيمياء حيوية
biodro - ورك
biologia - علم الأحياء , أحياء
biologiczny - بيولوجي
biotyczny - حيوي
Birma - بورما
biseksualny - منجذب إلى كلا جنس|الجنسين, خنثى, خنثوي, ثنائي الجنس
biskup - أسقف
Bissau - بيساو
Biszkek - بشكيك, بيشكك
bita śmietana - كريمة , قشدة
bitwa - معركة
bit - بت
biurko - مكتب
biuro - مكتب ,قلم
biustonosz - صدرية للثديين, مشد الصدر
bizantyjski - بيزنطي
bizmut - بزموت
blady - شاحب
błąd - خطيئة, خطأ, غلطة ,سقط ,غلط
błahy - تافه, بسيط, ضئيل, سفساف
blask - سنا ,شواظ
blaszany - نحاسي
błędne koło - حلقة مفرغة
błędny - خاطئ
błękit - لازوردية
Bliski Wschód - الشرق الأوسط, الشرق الأدنى
bliski - قريب ; ‎حميم متقارب
bliskość - قرب , كثب ; قربى
blisko - قريب ,عن كثب ,قرب
blizna - ندبة , ندب
bliźniaczka - توأمة
bliźniak - توأم
Bliźnięta - برج الجوزاء
błogosławieństwo - تبريك , مباركة , بركة ; سعادة , بركة
blog - مدونة
błona bębenkowa - طبلة الأذن
blondynka - شقراء
blondyn - أشقر
błoto - طين
bluza - بلوزة
błyskawiczny - خاطف
błysk - برق
błyszczeć - برق ,زهر, سنا, لمع
bóbr - سمور ,قندس
bób - فول
bocian - لقلق
bodziec - دفعة
bogactwo - ترف, غنى, وفرة, ثروة, عمران
bogaty - غني
bogini - إلاهة ,ربة, آلهة
Bogota - بوغوتا
Bóg - الله , الرب , مولى
bóg - إله , رب ,بعل
bohater - بطل
bohr - بوريوم
boja - عوامة
bójka - عراك
bojownik - مجاهد, مقاتل, مغوار, مكافح
bój - قتال
bokser - كلب البكسر ملاكم
boks - ملاكمة
bok - جانب
boleć - ألم ,وجع
Boliwia - بوليفيا , بوليفية
Boliwijczyk - بوليفي
Boliwijka - بوليفية
boliwijski - بوليفي
Bolonia - بولونيا
ból - ألم , وجع , مغص ''''
Bombaj - ممباي, مومباي
bombardowanie - قنبلة
bomba - قنبلة , عبوة , عبوة ناسفة , متفجرة
boraks - بورق
bordo - أحمر داكن
bor - بورون
Bosfor - البوسفور
boski - رائع إلهي
boskość - ‎ألوهية
Bośnia i Hercegowina - البوسنة والهرسك
Boston - بوسطن
bóstwo - إله ,رب ,بعل
botaniczny - نباتي
botanika - علم النبات
botanik - نباتي
Botswana - بوتسوانا
bot - بوت
Boże Narodzenie - عيد الميلاد ,كريسماس
brać - تناول ,أخذ ,إستمد
brakować - نقص
brak - نقص, فقدان
brama - بوابة
bramkarz - حارس مرمى
bratanica - ابنة الأخ
bratersko - أخويا
braterstwo - أخوة
Bratysława - براتيسلافا
brat - أخ
brawo - مرحى ,أحسنت
brązowy - برونزي بني, قهوي
Brazylia - البرازيل
Brazylijczyk - برازيلي
Brazylijka - برازيلية
brazylijski - برازيلي
brąz - برونز
Bretania - بريتاني
bretoński - بريتانية
brew - حاجب
Brno - برنو
brodaty - ملتح
broda - لحية ذقن
brokuł - بروكلي
brom - بروم
broń biała - سلاح أبيض
broń biologiczna - سلاح بيولوجي
bronić - ناصر, دافع
broń - سلاح
broszka - بروش
broszura - كراس, كتيب, كراسة
brudny - قذر ,وسخ موسخ
brud - قذر, تراب, نجس, سخام ,وسخ
Bruksela - بروكسل
brukselka - كرنب بروكسيل
Brunei - بروناي
brunetka - سمراء
brunet - أسمر
brutalność - وحشية, شراسة
brutalny - قاس وحشي
brutto - إجمالي
Brytyjczyk - بريطاني
Brytyjka - بريطانية
Brytyjskie Wyspy Dziewicze - الجزر العذراء البريطانية
brytyjski - بريطاني
brzeg - حافة, شفرة ,شط, عراق, ضفة
brzemienny - حبلى
brzmienie - صوت
brzoskwinia - خوخة, دراق
brzoza - بتيولا
brzuch - بطن
brzydki - شنيع, بشع, دميم, سمج, قبيح
brzydzić się - نفر
brzytwa - موسى
Budapeszt - بودابست
budda - بوذا
buddysta - بوذي
buddyzm - بوذية, البودية
budować - شاد, بنى
budowlany - بناء
budynek - عمارة , دار, بناء
budzić - صحا ,استيقظ
budzik - منبه
bufet - بوفيه
Bukareszt - بوخارست
bukiet - باقة
bukować - سجل
Bułgaria - بلغاريا
Bułgarka - بلغارية
bułgarski - بلغاري
Bułgar - بلغاري
bunkier - معقل
bunt - ثورة ; فتنة
burak - شمندر
burdel - ماخور
Burkina Faso - بوركينا فاسو
burmistrz - محافظ
bursztyn - كهرمان
Burundi - بوروندي
burza - عاصفة
burzyć - جأش
busola - بوصلة
butelka - قنينة, زجاجة
butny - متكبر
but - حذاء
buziak - قبلة
Bużumbura - بوجمبورا
Byblos - جبيل, بيبلوس
być - كان ,وجد
Byk - برج الثور
byk - ثور
były - سابق
bynajmniej - أصلا، بالمرة
bystry - لحن ,ذكي ,أريب, فطن
byt - كون
całkowicie - بالتمام, تماما
całość - جملة
całować - قبل
całowanie - تقبيل
cały - جميع
cal - إنش
Caracas - كراكاس
carat - قيصرية
cebula - بصل
cecha - نعت, صفة ,خلة ,خاصة
cedr libański - أرز لبناني
cedr - أرز
cegła - طوبة , لبنة , '''' طوب
cejloński - سيلاني
Cejlon - سيلان
cellulit - سيلوليت / السيلوليت
celować - استهدف
cel - هدف ,غاية ,نية ,نيشان, أمد
cement - إسمنت ,خرسانة
cena - ثمن, سعر
cennik - قائمة
cenny - قيم
centaur - قنطور
centralny - مركزي
centrum - قلب ,مركز ,وسط, محور
centymetr - سنتيمتر
cent - سنت
cenzura - رقابة
cera - بشرة
ceremonia - مراسم
certyfikat - شهادة
cer - سيريوم
cesarski - قيصري
cewka moczowa - إحليل
cez - سيزيوم
chałwa - حلاوة طحينية
Cham - حام
chan - خان
chaos - كاوس فوضى
chaotyczny - فوضوي
charakterystyczny - مميز
charakteryzować - صور
charakter - خلق
Chartum - الخرطوم, خرطوم
charytatywny - محسن, خيري
chcieć - أراد ,رغب, شاء, ود
chciwie - بطمع
chciwy - طماع, جشع, لهم, نهم, حريص, شره
chęć - رغبة
chemia organiczna - كيمياء عضوية
chemia - كيمياء
chemiczny - كيميائي
chemik - كيميائي
cherubin - كروب
chichot - قهقهة
Chile - تشيلي ,شيلي
Chińczyk - صيني
chinina - كينين
Chinka - صينية
Chińska Republika Ludowa - جمهورية الصين الشعبية
chiński - صيني
Chiny - الصين
chirurgia plastyczna - جراحة تجميل
chirurgia - جراحة
chirurgiczny - جراحي
chirurg - جراح
chleb - خبز
chłodny - فاتر
chłód - قر
chłopak - غلام
chłopiec - ولد , صبي
chłop - ‎فلاح ; مزارع
chlorofil - يخضور, كلوروفيل
chlor - كلور
chmura - سحابة سحاب , غيمة
chociaż - وأن, حتى لو
chodnik - رصيف
chodzenie - خطو
chodzić - مشى
choinka - شجرة الميلاد, شجرة عيد الميلاد
cholera - اللعنة ;كوليرا
cholerny - ملعون
cholesterol - كولسترول
chomik - أقداد
choroba Alzheimera - ‎مرض ألزهايمر
choroba von Willebranda - مرض فون ويليبراند
choroba - مرض ,داء
chorować - مرض
Chorwacja - كرواتيا
chorwacki - كرواتية كرواتي
Chorwatka - كرواتية
Chorwat - كرواتي
chory - مقرف مريض
chór - جوقة
chować - خمر
chromosom - صبغي ,كروموزوم
chrom - كروم
chronić - حمى, صان, وقى, حفظ
Chrystus - المسيح, يسوع
chrząstka - غضروف
chrząszcz - خنفساء
chrześcijanin - مسيحي
chrześcijanka - مسيحية
chrześcijański - مسيحي
chrześcijaństwo - مسيحية
chrzest - معمودية ,عماد
chudy - نحيل, نحيف
chuj - زبر
chusta - شال, ايشارب, وشاح
chusteczka - منديل ,محرمة
chwała - '''' تسبيحة , مجد ; عزة
chwalić - مجد, '''' حمد
chwila - لحظة , برهة
chytry - شاطر
ciąć - قطع ,قلم
ciąg arytmetyczny - متتالية حسابية
ciągle - بلا توقف
ciągnięcie - سحب
ciało niebieskie - جرم سماوي
ciało - جسم, جسد, بدن
ciasny - ضيق, حرج
ciasto - كعك فطيرة , , كعكة
ciąża - حمل, حبل
cicho - صه بهدوء
ciecz - ماء
cielę - عجل
ciemnoczerwony - أحمر داكن
ciemnoniebieski - كحلي
ciemność - عتمة, ظلام, قتام
ciemny - مظلم ,داكن ,غامق
cienki - رقيق
cień - ظل
ciepło - دفء, حرارة, حر, حمي, سخونة
ciepły - قلبي دافئ ,سخن, دفيء
cierpieć - تألم
cierpienie - ألم, عذاب, مضض, تألم, كرب
cieszyć - ‎حبر ,إستمتع ,فرح, استمتع
ciężarny - حبلى
ciężarówka - شاحنة
ciężar - حمل ,وزن ,ثقل
ciężki - ثقيل ; قاس ,صعب, شائك
ciocia - خالة عمة
ciotka - خالة
ciśnienie - ضغط
cisza - صمت
ćma - عثة
cmentarz - مقبرة , تربة , مدفن
cnota - فضيلة
codziennie - يوميا
codzienny - يومي
Connecticut - كونيتيكت
córka - ابنة, بنت
coroczny - سنوي
coś - شيء
co - ما ,ماذا
cuchnący - زخم
cudowny - رائع ,مذهل
cudzołóstwo - سفاح
cudzoziemiec - أجنبي
cudzysłów - علامة اقتباس
cud - عجيبة , أعجوبة , معجزة , عجب
cukiernia - صناعة الحلويات, دكان الحلواني
cukiernica - سكرية
cukier - سكر
cukinia - كوسا
cukrowy - سكري
cukrzyca - السكري
cukrzyk - مصاب بمرض سكري
ćwiczyć - مارس
ćwierć - ربع
cyfrowy - رقمي
cyklop - سايكلوب
cylindryczny - أسطواني
cynamon - قرفة
cyna - قصدير
cynk - خارصين, زنك
Cypr - قبرص
cyrkon - زركونيوم
cyrk - سيرك
cyrylica - كيريلية
cytadela - قلعة, قصبة
cytować - قبس
cytryna - ليمون , , لامون
cytrynowy - ليموني
cywilizacja - حضارة
cywilny - مدني
czador - شادور
Czadyjczyk - تشادي
Czadyjka - تشادية
czadyjski - تشادي
Czad - تشاد
czapka - قبعة
czarna dziura - ثقب أسود
Czarnogóra - الجبل الأسود
czarnoskóry - أسود ;أسود
czarnuszka siewna - حبة البركة
czarny humor - كوميديا سوداء
czarny rynek - اقتصاد تحتي ,سوق سوداء
czarny - أسود
czarownica - ساحرة
czarujący - ساحر ,فتان ,أخاذ
czasem - أحيانا ,تارة
czasopismo - مجلة
czasownikowy - فعلي
czasownik - فعل
cząsteczka - جزيء
czas to pieniądz - الوقت من ذهب
czaszka - جمجمة
czas - آن , وقت wakt , زمن zaman , زمان zaman , توقيت taukit
czciciel - العابد
czcić - عظم ,وقر ,أجل ,بجل, مجد
Czechosłowacja - تشيكوسلوفاكيا
Czechy - التشيك , تشيك
Czech - تشيكي
Czeczenia - الشيشان
czekać - انتظر, ترقب
czekanie - انتظار
czekolada - شوكولاتة
czek - صك
czereśnia - كرز
czerń - أسود
czerwiec - يونيو , حزيران
czerwony - أحمر
czesać - مشط
częściowo - إلى حد ما
część mowy - أجزاء الكلام
część - جزء ,شقة, تقسيم
cześć - مجد ; مرحبا
czeski - تشيكي
częstotliwość - تردد
często - غالبا
Czeszka - تشيكية
czkawka - فواق
członek - عضو ذكري عضو ;عضو
człowiek - آدم , إنسان
czołg - دبابة
czołowy - جبهي
czoło - جبين, جبهة
czosnek - ثوم
czucie - شعور, حاسة, حس
czuć - شعر, حس
czuły - حساس حنان, رقيق
czwartek - الخميس
czyj - لمن
czynić - فعل
czynnik - عامل
czynność - فعل
czynny - عامل
czynsz - إيجار
czyn - عمل
czystość - نظافة , طهارة ; طهارة
czysty - نظيف, زكي ; واضح, طاهر ,أبيض
czytać - قرأ
czytanie - قراءة
czytelny - مقروء
czy - هل
dąb - بلوط, سنديان
dach - سقف
dać - أعطى
Dakar - دكار, داكار
Dakota Północna - داكوتا الشمالية
Dakota Południowa - داكوتا الجنوبية
Daleki Wschód - الشرق الأقصى
daleki - قصي ,شاسع ,بعيد
dalekosiężny - بعيد الأثر
daleko - بعيدا
dalia - داليا
Dalmacja - دالماسيا
dalszy - أبعد أقصى
damasceńczyk - دمشقي
damasceński - دمشقي
Damaszek - دمشق ,شام, الشام
damski - نسائي ,أنثوي
dana - معلومات
dane - بيانات
Dania - الدنمارك
Daniel - دانيال
danie - طبق, صحن
daremny - باطل ,خائب
Dar es Salaam - دار السلام
data - تاريخ ,موعد
dawać - أعطى
dawanie - مناولة
dawca - مانح ,واهب
Dawid - داوود ,داود
dawniej - قبل
dążyć - هدف, قصد
dbać - نظر
dbały - مهتم
debatować - نظر
decybel - ديسيبل
decyzja - قرار, بت
deficyt - نقص, منقصة, نقصان
definicja - تعريف, تحديد
defraudacja - إختلاس
deklaracja - تصريح, بيان, إعلان
dekoracja - زخرفة , زخرف
dekoracyjny - زخرفي
dekorować - زين, حسن, زخرف
delegacja - وفد
delektować się - تذوق
delfin - دلفين ,دولفين ,دخس
deliberować - باحث
delikatny - دقيق, رقيق
delta - دلتا
Demeter - ديميتر
demokracja - ديمقراطية
Demokratyczna Republika Konga - جمهورية الكونغو الديمقراطية
demokratycznie - ديموقراطيا
demokratyczny - ديمقراطي
demolować - دمر
demoniczny - شيطاني
demonstracja - تظاهرة ,مظاهرة ,مسيرة ,احتجاج
demon - غول
denerwujący - مزعج
dentysta - طبيب الأسنان , طبيب أسنان
denuncjator - واش
depilacja - إزالة الشعر
deportacja - ترحيل
deprecjonować - بخس
depresja poporodowa - اكتئاب ما بعد الولادة
depresja - كآبة
deser - طبق حلو ,حلوى
deska - لوح
despota - باغ، مستبد، حاكم، طاغية، جائر
destabilizacja - زعزعة استقرار|الاستقرار
destrukcja - تدمير ,قضاء
destrukcyjny - مدمر
deszczowy - ماطر
deszcz - مطر
detal - تفصيل
dezorientacja - حيرة
diabeł - شيطان, إبليس
dialektyczny - حواري
dialekt - لهجة
dialog - حوار
diament - الماس
diaspora - شتات
diecezjalny - أبرشي
diecezja - ‎أبرشية
dieta - حمية , غذاء
dinar - دينار
dinozaur - ديناصور
dlaczego - لماذا, لم
dlatego - لأن
dla - عن
dłoń - كف
długi - طويل
długopis - قلم
długość - طول
dług - مغرم
doba - يوم
doberman - دوبرمان
dobranoc - ليلة سعيدة
dobre maniery - أدب ,آداب السلوك
dobroczynny - محسن, خيري ;نافع
dobroć - حنان ,طيبة ,حسن&amp;lrm; صلاح
dobrowolny - إختياري
dobro - خير ; ثراء ,غنى
dobry wieczór - مساء الخير
dobry - حسن , فاضل , جيد, خير, طيب
dobrze - حسنا ; بخير
dochód - دخل, مورد
doczesny - زمني
dodatek - إضافة , زائدة
dodatkowy - إضافي
dodawać - جمع ,شفع
dodawanie - جمع ;جمع ;جمع
Dodoma - دودوما
dojrzały - ناضج ,بالغ
dojrzewanie - مراهقة
dojść - أتى, بلغ
dokładnie - بالضبط, بدقة, أجل, تماما
dokładny - دقيق
dokonać - نفذ
doktor - دكتور
doktryna - تعاليم
dokument - مستند, وثيقة
dołączyć - أضاف, زاد
dolar - دولار
dolina - وادي ,واد
dolny - باطن ,أدنى ,سفلي ,أسفل ,تحتاني
dół - سفل
domena - ميدان, حلبة
dominacja - سيطرة
Dominikana - جمهورية الدومنيكان
Dominika - دومينيكا
dom - بيت, دار, منزل, موطن, مسكن
doniczka - ‎أصيص
Donieck - دونتسك
donośny - جهوري
Don - نهر الدون, دون
dopełniacz - إضافة
dopiero - فقط
doskonalenie - تقدم
doskonały - جيد, مثالي كامل
dosłownie - حرفيا ,بالحرف
dosłowny - حرفي
dostarczać - جهز ,زود ,ورد
dostępny - موجود
dostęp - ولوج
dotychczas - حتى الآن
dotykać - لمس
dotyk - لمس, مس, لامس
dowcip - نكتة , أضحوكة , مزاح, مداعبة, مزحة
do widzenia - مع السلامة
dowódca - آمر
dowód osobisty - بطاقة شخصية
dowodzić - برهن ;رأس
dowód - برهان
dozwolony - محلل, مرخص, حلال
dożywocie - السجن المؤبد
do - إلى, حتى
drabina - سلم
dramat - مأساة
dram - درام
drapacz chmur - ناطحة سحاب
drapieżnik - مفترس, ضار
dręczyć - كرب
dreszcz - إنتفاض
drewniany - خشبي
drewno - خشب , حطب ''''
drobny - طفيف
drób - دجاج
Droga Mleczna - درب التبانة
droga - طريق, درب
drogi - غالي غال ,مكلف
druga wojna światowa - الحرب العالمية الثانية
drukarka - طابعة
drukować - طبع
druk - طبع
drut - سلك
drużyna - فريق ,فرقة
drwić - استهزأ
drzazga - شظية
drżeć - إنتفض
drzemać - هجع
drzemka - نومة
drzewo arganowe - شجرة الأركان
drzewo - شجرة
drzwi - باب ; أبواب
Dubaj - إمارة دبي ; دبي
Dublin - دبلن
dubn - دوبنيوم
duchowy - روحي ,نفس ,روحاني
Duch Święty - الروح القدس
duch - خلد شبح ,نفس , نفس ,روح
dudek - هدهد
dudy - مزمار القربة
duma - أنفة شموخ, مباهاة, بذخ, تكبر
dumny - فخور
Dunaj - دانوب
Duńczyk - دانماركي
Dunka - دانماركية , دنماركية
duński - دانمركي ,دانماركي
dupek - أهبل
dusić - جأش
Duszanbe - دوشنبه
dusza - روح ,خلد ,نفس
dużo - كثيرا, كثير
duży - كبير
dwa - إثنان
dworzec - محطة
dwukropek - نقطتان
dwunastnica - عفج
dwupłat - طائرة ذات جناحين ,ذات السطحين
dwusieczna - منصف
dwutlenek węgla - ثنائي أكسيد الكربون
dymić - دخن
dym - دخان
dynamika - ديناميكا
dynamit - ديناميت
dynia - قرع, يقطين
dyplomata - دبلوماسي
dyplomatyczny - دبلوماسي
dyrektor - مدير
dyrygent - موصل
dysertacja - أطروحة
dyskietka - قرص مرن
dyskoteka - ديسكو
dysk twardy - قرص صلب
dyskusja - مناقشة, نقاش, بحث, درس
dyskutować - بحث ,باحث ,نظر ,ناقش
dysk - قرص
dysleksja - عسر القراءة
dysonans - تنافر
dyspensa - إِعفاء من التزام
dysproz - ديسبروسيوم
dysputa - جدل
dystans - بعد, مسافة, شقة, بون
dystrybucja - تقسيم
dystrykt - ولاية ,خط ,قسم ,دائرة, لواء
dysydent - خارج
dywan - سجادة
Dżakarta - جاكرتا ,جاكارتا
dżamahirijja - جماهيرية
Dżanin - جنين
dżem - مربى
dzeta - زيتا
dziadek - جد
działać - فعل
działalność - حركة
działanie - نشاط, فعل, عمل, حركة
dział - قسم ; إدارة
dziąsło - لثة
Dżibuti - جيبوتي
dziecięcy - طفولي
dziecko - طفل
dziedziczenie - وراثة
dziedzic - وارث
dziedziniec - ساحة , فناء
Dzieje Apostolskie - سفر أعمال الرسل
dzieje - تاريخ
dziękować - شكر szakara , - شكرا szukran
dziękuję - شكرا
dzielenie - قسمة
dzielić - نصف ; شاطر شارك
dzielnica - حارة
dzielny - شجاع, جسور, جريء
dzień dobry - صباح الخير
dziennikarstwo - صحافة
dziennikarz - صحفي, صحافي
dzień - نهار ,يوم
dziesiętny - عشري
dziewczę - عذراء
dziewczyna - بنت , فتاة , شابة
dziewczynka - صبية , طفلة
dziewica - بتول ,عذراء
dżihad - جهاد
dziki - وحشي ضار; '''' بور
dżinsy - جينز
dziobak - خلد الماء
dziób - منقار
dzisiaj - اليوم
dziura - ثقب ,خرم
dziwaczny - غريب
dziwka - عاهرة , قحبة
dziwny - نادر ,غريب ,دخيل
dżudo - جودو
dżungla - دغل, غابة, أجمة
dźwięk - صوت
dzwonek - جرس
dzwonić - إتصل
dzwon - جرس ,ناقوس
Edirne - أدرنة
edukacja - تعليم
edukacyjny - تربوي
Edynburg - إدنبرة
efekt uboczny - أثر جانبي
efekt - أثر, تأثير ,نفوذ
efemeryczny - زائل
Egipcjanin - مصري
Egipcjanka - مصرية
egipski - مصري
Egipt - مصر
egoista - أناني، أنوي
egoistyczny - أناني, أنوي
egoizm - غرور ,حب الذات ,أنانية, أنوية
egzaltacja - تعظيم
egzaminować - عجم ,امتحن
egzamin - امتحان
egzekucja - إعدام
egzystencjalizm - وجودية
egzystencja - كون ;كون
ejakulacja - قذف
ekologia - علم البيئة, إيكولوجية
ekologiczny - إيكولوجي
ekonomia - اقتصاد
ekonomiczny - اقتصادي
ekosystem - نظام بيئي
ekran - شاشة
ekskomunika - حرم , حرمان كنسي
ekskomunikować - حرم
ekspert - خبير ,اختصاصي
eksploatować - سخر
eksplozja - نسف , تفجير , انفجار
ekspozycja - عرض, تعرض ; معرض ; تفسير, شرح
ekspresja - لفظ, اعراب
eksterminacja - إبادة
ekstremum - غاية
Ekwadorczyk - إكوادوري
ekwadorski - إكوادوري
Ekwador - إكوادور / الإكوادور
elastyczność - لين ,لينة ,ليونة ,رخاوة
elegancja - كياسة, ظرافة, أناقة
elegancki - ظريف
elekcja - انتخابات ,انتخاب
elektrolit - كهرل
elektroliza - تحليل كهربائي
elektroniczny - إلكتروني
elektronika - إلكترونيات
elektron - كهرب ,إلكترون
elektryczność - كهرباء, كهربائية
elektryczny - كهربائي
elektryk - كهربائي
elektryzować - كهرب
elementarny - أولي ,جوهري
element - عنصر ,مكون
elita - نخب
elokwentny - لسن
Elżbieta - إليصابات
emeryt - متقاعد
Emilia-Romania - إميليا رومانيا
emiracki - إماراتي
Emiraty - الإمارات
emir - أمير
emisja - قذف
emocja - عاطفة ,خلجة
emocjonalny - عاطفي
empiryczny - تجريبي
encyklopedia - موسوعة
endokrynologia - علم الغدد الصماء
energia - طاقة
entropia - إنتروبيا
entuzjazm - حماسة, حرارة, غلواء, حماس, حمية
enzym - إنزيم
epikureizm - أبيقورية
epilepsja - صرع
epoka kamienia łupanego - عصر حجري قديم
epoka - دهر, جيل
epsilon - إبسيلون
era - دهر
erb - إربيوم
Ereb - ايريبوس
erekcja - انتصاب , نعوظ ; إقامة
erogenny - جنسي
Eros - إيروس
erotyzm - شبق
erudycja - معرفة واسع|واسعة
Erytrea - إرتريا, إريتريا
erytrocyt - خلية الدم الحمراء ,كريدمة
Erywań - يريفان
Erzurum - أرضروم
eschatologia - إسخاتولوجيا ,علم الأخرويات
esperanto - إسبرانتو
estetyka - أستاطيقا, جماليات
Estończyk - ‎أستوني
Estonia - إستونيا
Estonka - إستونية
estoński - ‎أستوني
etanol - إيثانول
etap - مرحلة
eta - إتا
eter - إيثر
Etiopczyk - إثيوبي
Etiopia - إثيوبيا
etiopski - إثيوبي
etniczny - جنسي, قومي
etologia - إيثولوجيا ,علم السلوك الحيواني
etyczny - خلقي ,أخلاقي
etyka - أخلاق
etykieta - آداب السلوك , اتيكيت لصاقة
etymologia - تأثيل , اشتقاق
eufemizm - تلطيف لغوي
Eufrat - الفرات
Euklides - أقليدس
Eurazja - أوراسيا
Europa Zachodnia - أوروبا الغربية
Europa - أوروبا
Europejczyk - أوروبي
Europejka - أوروبية
europejski - أوروبي
europ - يوروبيوم
euro - يورو
ewangeliczny - إنجيلي
Ewa - جدة , حواء
ewolucja - تطور
Ezdrasz - عزير
Ezop - إيسوب
ezoteryczny - باطني ,سري ,خفي
fabryka - معمل, مصنع
fajka - غليون, شبك
faks - فاكس
faktura - فاتورة
fakt - واقع, حقيقة
fala - موجة
fallus - قضيب
falować - تردد, موج
fałszywy prorok - المسيح الدجال ,الدجال
fałszywy - باطل, كاذب, خاطئ
fałsz - زور ,كذب
fantastyczny - خيالي
fan - معجب
faraon - فرعون
farba - طلاء ,لون ,دهان
farerski - فاروية فاروي
farmaceuta - صيدلي , أجزائي
farmaceutyczny - صيدلي
farmacja - صيدلة
farmakologia - صيدلة
farma - حرث, عزبة, مزرعة
farsz - حشو
fasola - لوبيا ,لوبياء
fasolka szparagowa - فاصوليا
faszysta - فاشي, فاشستي
faszystowski - فاشي, فاشستي
faszyzm - فاشية
Fatima - فاطمة
faza - مرحلة, طور
Federacyjna Republika Brazylii - جمهورية الفدرالية البرازيلية
feminizm - أنثوية
fenek - فنك
Fenicjanka - فينيقية
Fenicja - فينيقيا
fenicki - فينيقي ; لغة فينيقي|فينيقية
festiwal - مهرجان ,موسم
fez - طربوش
Fez - فاس‎
fiasko - فشل
Fidżi - فيجي
figa - تينة
fikcyjny - خيالي ,قصصي ,تخيلي ,خرافي ,مختلق
Filadelfia - فيلادلفيا
filar - دعامة, عمود
filia - فرع
Filipińczyk - فلبيني
filipiński - فلبيني
Filipiny - الفلبين
filiżanka - فنجان
filmowy - سينمائي
film - فيلم ; شريط
filologia - فقه اللغة
filolog - لغوي
filozofia - فلسفة
filozoficzny - ‎فلسفي
filozof - ‎فيلسوف
filtr - ‎مرشح
finansowy - مالي
Finka - فنلندية
Finlandia - فنلندا
finlandyzacja - فنلدة
fiński - فنلندي
Fin - فنلندي
fiołek - بنفسج
fioletowy - ‎بنفسجي
firanka - ‎ستارة
firma - شركة
fizyczny - ‎بدني, ‎مادي, ‎فيزيائي
fizyka - فيزياء
fizyk - ‎فيزيائي
fi - في
flaga - راية ,علم
flaszowiec - قشطة
flet - ناي , مزمار
flora - نبات ,فلورا
Florencja - فلورنسا
Floryda - فلوريدا
flota - أسطول
fluor - فلور
foka - فقمة
folder - مجلد, مجلد ملفات
fontanna - نافورة
forint - فورنت مجري
formalność - شكليات
formalny - متكلف متكلف
forma - صورة , أسلوب
fortel - حيلة
fortepian - بيانو
fort - حصن , قلعة
fosfor - فوسفور ,فسفور
fotel - كرسي
fotografia - تصوير
fragmentacja - كسر
fragment - كسرة
Francja - فرنسا
francuski pocałunek - قبلة فرنسية
francuski - فرنسي
Francuzka - فرنسية
Francuz - فرنسي
frans - فرانسيوم
frytka - بطاطس مقلية
fryzjer - حلاق
fryzura - تسريحة
Fudżi - فوجي
fundacja - مؤسسة
fundament - أساس
fundusz - صندوق
funkcja - دالة وظيفة, دالة
funkcjonować - عمل
funt - جنيه
furia - حمية
gąbka - إسفنج
Gabon - الغابون
Gaborone - جابورون
Gabriel - جبريل
gadanie - ثرثرة
gadanina - لغو
gadatliwy - ثرثار
gadolin - غادولينيوم
gaduła - ثرثار
Gad - جاد
gad - زاحف
galaktyka - مجرة , تبانة
galicyzm - غاليسسم
gałka muszkatołowa - جوزة الطيب
gal - غاليوم ,جاليوم
Gambia - غامبيا
gameta - مشيج
gamma - غاما
garaż - كراج
garderoba - ملابس ; دولاب
gardło - حلق
gardzić - أنف, إحتقر
garnitur - بدلة
gaśnica - ‎مطفأة الحريق
gąszcz - دغل
gatunek - نوع ,تشكيلة
gatunkowy - جنسي
Gaza - غزة
gazela - غزال
gazeta - صحيفة , جريدة
gaz musztardowy - غاز الخردل
gaz - غاز
Gdańsk - غدانسك
gdy spieszyć się człowiek spieszyć spieszy, to cieszyć się diabeł cieszyć cieszy - العجلة من الشيطان
gdy - ‎حينما, ‎عندما, حين
gdzieś - ‎في مكان ما
gdzie - ‎أين, &amp;lrm; حيث
gej - مثلي
generał - جنرال , عماد
genetyka - علم الوراثة
geneza - أصل
geniusz - نبوغ ,عبقرية ;نابغة ,عبقري
Genua - جنوة
geodeta - قياس, جيوديسي
geodezja - جيوديسيا
geodezyjny - جيوديسي
geografia - جغرافيا , جغرافية
geograficzny - جغرافي
geologia - جيولوجيا
geometria - هندسة رياضية
gepard - فهد ,الفهد الصياد
germański - جرماني
german - جرمانيوم
gęstość - ‎كثافة
gęsty - ‎كثيف, سميك
getto - غيتو
Ghana - غانا
Gibraltar - جبل طارق ,جبرلتار
giętki - لين
gigantyczny - جبار ,عملاق
gigant - مارد
gimnastyczny - جمبازي
gimnastyka - جمباز, ‎رياضة بدنية, تمارين رياضية
ginekologia - علم أمراض النساء
gips - ‎جبس, جص
gitara - قيثارة
gładki - أسيل, ناعم
gleba - تربة
głębia - عمق
głęboki - ‎عميق
głęboko - ‎بعمق
gliceryna - جليسرول
glina - طين
glin - ألومنيوم
globalizacja - عولمة
globalnie - عالميا
glob - كرة
głodny - ‎جائع ,جوعان
głód - جوع
głośnik - مكبر الصوت
głośny - صاخب, صيت ,جهوري
głosować - صوت, نخب
głosowanie - اقتراع
głos - صوت
głowa - رئيس رأس
główny - ‎رئيسي ,أولي ,قيادي
głuchoniemy - أصم أبكم
głuchy - ‎أطرش, أصم
głupek - زمال ,أحمق
głupiec - أبله
głupi - غبي, أحمق, ‎مغفل, سخيف, بليد, أبله
głupota - حماقة غباء أفن, بله
gniazdko - ‎مقبس
gniazdo - عش
gniewnie - بحدة
gniew - غضب, غيظ ,حنق ,حفيظة, سخط
gnuśny - فاتر الشعور
gnu - نو
godność - كرامة
godzina - ساعة
gołąb - حمام , حمامة
golarka - ‎ماكينة حلاقة
gołębica - حمامة
golf - غولف
golić - حلق
gol - ‎هدف
gorąco - دفء ,حرارة ,حار ,سخونة
gorący - حار , ساخن
gorączka - ‎حمى
góra lodowa - جبل جليدي
góra - جبل, طور
górnik - عامل منجم
gorset - كورسيه
górski - جبلي
goryl - غوريلا
gorzki - ‎مر
górzysty - جبلي
gość - ‎ضيف , زائر , نزيل
gospodarczy - ‎اقتصادي
gospodarstwo - ‎مزرعة
gospodarz - رب البيت
gospodyni - ربة البيت
gotować - ‎طبخ&amp;lrm; غلى
gotowanie - ‎طبخ, غليان
gotówka - نقود, نقد
gotowy - مهيأ
gotycki - قوطي
goździk - قرنفل ; كبش قرنفل , قرنفل
gracz - لاعب
grać - تلعب
grad - ‎برد
grafika - صورة
gramatyczny - نحوي
gramatyka - نحو ,علم النحو
gram - ‎غرام
granatowy - كحلي
granat - ‎رمانة ;رمان ; لعل ,جارنيت
granica - ‎حد ,حدود
graniczny - ‎حدودي
graniczyć - تلامس ,حد ,جاور ,لامس
gratis - ‎مجانا
grawitacja - ثقالة, جاذبية
gra - لعب ,لعبة
Grecja - اليونان
grecki - إغريقي , يوناني , يونانية ; لغة يوناني|يونانية
Greczynka - إغريقية, يونانية
grejpfrut - ‎كريفون, ‎جريب فروت
Grek - يوناني
Grenada - غرينادا , جرينادا ; غرناطة
Grenlandia - جرينلاند ,جرين لاند
grillować - شوى
grill - ‎مشواة
grobowiec - قبر
grób - قبر
gromadzenie - تشكيل
gromadzić - ركب
groszek - ‎بازلاء
grota - مغارة
groza - رهبة
grubiański - خشن
gruby - ‎سمين ; ثخين , سميك
grudzień - ديسمبر , كانون الأول
grunt - تربة
grupa śmierci - مجموعة الموت
grupa - فرقة, جماعة, زمرة, مجموعة, حزب, قوم, شيعة ,فئة
gruszka - إجاص ,كمثرى
Gruzinka - جورجية
gruziński - ‎جورجي
Gruzja - جورجيا
gruźlica - سل
gryf - فتخاء
grypa - ‎إنفلونزا
gryźć - ‎عض, قرض
gryzienie - عض
Gryzonia - غراوبوندن
grzanka - ‎خبز محمص
grzbiet - متن
grzebień - ‎مشط
grzech - خطيئة , حنث , سيئة
grzeczny - مؤدب ,أديب
grzeszny - خاطئ
grzmot - رعد
grzyb - ‎فطر ,عيش الغراب
grzywka - ‎غرة
Guam - غوام
Gujana Francuska - غويانا الفرنسية;
Gujana - غويانا
gułag - غولاغ ,جولاج
guma - ‎علكة ; مطاط
gumka do ścierania - ممحاة
gumka - ممحاة ; مطاط
guzik - زر
guz - ورم
Gwadelupa - جوادلوب, غوادلوب
gwałtownie - بعنف
gwarancja - ‎ضمان
Gwatemala - غواتيمالا ; مدينة غواتيمالا
Gwatemalczyk - غواتيمالي
gwatemalski - غواتيمالي
Gwiazda Poranna - نجم الصباح
gwiazda - نجمة ,نجم, كوكبة
gwiazdozbiór - برج ,كوكبة
Gwinea Bissau - غينيا بيساو
Gwinea Równikowa - غينيا الاستوائية
Gwinea - غينيا
gwizdanie - صفير
gwóźdź - مسمار
Hades - هاديس
hafn - هافنيوم
Haga - لاهاي
haiku - هايكو
Haiti - هايتي
haj - كيف ''''
hałaśliwy - صاخب
hałas - ‎جعجعة , ‎ضجيج , ضجة
hala - ‎قاعة
halo - ‎الو
hamburger - هامبرغر
hamować - ثبط فرمل
hamulec - فرامل, مكبح, كابحة
hańba - عار ,شين ,فضيحة
hańbić - أخزى, عاب ,وصم ,فضح ,شأن
handel - تجارة
handlować - تسوق
handlowy - تجاري, متجر
haniebny - شين, قبيح, شائن
Hanoi - هانوي
harem - حرم ,حريم
harfa - هارب
harmonia - إتفاق
harmonogram - جدول
harować - أجد, اجتهد
hasło - كلمة مرور ,كلمة السر
haszysz - حشيش
has - هاسيوم
Hawaje - هاواي
Hawana - هافانا
hazard - مقامرة
heban - أبنوس
hebrajski - عبرية|العبرية ; عبري
hektar - هكتار
Hektor - هكتور
helikopter - مروحية, هليكوبتر
hełm - خوذة
Helsinki - هلسنكي
hel - هيليوم
Hemera - هميرا
hemiplegia - فالج
heparyna - الهيبارين
Hera - هيرا
herbata - شاي
herbatnik - بسكويت
herb - شعار النبالة
herezja - بدعة
Hermes - هيرميز
Hestia - هيستيا
Hezbollah - حزب الله
hidżab - حجاب
hiena - ضبع
hieroglif - هيروغليفية , هيرغليفية
higiena - نظافة, علم الصحة
Himalaje - هيمالايا, الهملايا, جبال الهيمالايا
hindi - هندية
hinduizm - هندوسية
Hindukusz - هندوكوش
Hinduska - هندية
Hindus - هندي
Hiob - أيوب
hipertermia - فرط الحرارة
hipokryta - مداهن , منافق
hipokryzja - مداجاة ,نفاق, رياء
hipoteza - فرضية
Hiroszima - هيروشيما
historia - تاريخ
historyczny - تاريخي
Hiszpania - إسبانيا / اسبانيا
Hiszpanka - إسبانية
hiszpański - إسباني
Hiszpan - إسباني
hobby - هواية ,هاجس
hojny - سخي ,نجب ,خير ,سمح ,جواد
hokej - هوكي ,هوكي الجليد
Holandia - هولندا
Holenderka - هولندية
holenderski - هولندي ; هولندية
Holender - هولندي
holm - هولميوم
holokaust - هولوكوست
homar - جراد البحر ,كركند
homeopatia - معالجة المثلية
homofobia - رهاب المثلية
homoseksualizm - مثلية جنسية , لواط
homoseksualny - مثلي
Honduras - هندوراس
Hongkong - هونغ كونغ
Honiara - هونيارا
honor - شرف , عرض
hormon - هرمون
horoskop - خريطة البروج
horyzontalny - أفقي
horyzont - أفق, خط الأفق
hotel - فندق , أوتيل
humanistyka - إنسانية
humanitarny - انساني / إنساني, خير
hummus - حمص
humor - دعابة , فكاهة ; مزاج
huragan - عاصفة , إعصار
Hurghada - الغردقة
huśtawka - أرجوحة
hydrologia - علم المياه
hymn - نشيد
ibis - أبو منجل
idealista - مثالي ;مثالي
idealistka - مثالية
idealny - مثالي
idea - فكرة
identyfikacja - تعرف
idiota - أحمق
id - الهو
iftar - إفطار
igła - إبرة, خياط
iglica - برج الكنيسة
ignorancja - جهالة، جهل
ignorować - تجاهل
igrzyska olimpijskie - الألعاب الأولمبية
ikona - أيقونة
ile - بكم , كم
ilość - كمية
ilustracja - رسم, صورة, رسم توضيحي
iluzoryczny - موهم, غرار
imaginacja - خيال
imago - يافعة
imam - إمام
imbir - زنجبيل
imię - اسم
imigracja - هجرة
imigrant - مهاجر, مغترب
imperator - إمبراطور
imperium - إمبراطورية
impertynencja - وقاحة, تطاول, صلافة
impuls - دفعة
inaczej - بشكل مختلف
Indie - الهند
indolencja - قصر
Indonezja - إندونيسيا
Indonezyjczyk - إندونيسي
Indonezyjka - إندونيسية
indonezyjski - إندونيسي
indyjski - هندي
indyk - ديك رومي
ind - إنديوم
inercja - جمود، كسل
infekcja - عدوى
infiltracja - تغلغل
informacja - معلومات
informatyka - علم المعلومات, المعلوماتية
informować - خبر ,عرف ,أنبأ, أفاد ,أبلغ ,أعلم, أشعر
infrastruktura - بنية تحتية
inkryminować - جرم
inny - آخر ,مختلف
inspektor - ‎مفتش ,محقق
instruktor - مدرب
instrument - آلة أداة
instynktowny - غريزي
instytucja - مؤسسة , معهد
instytut - مؤسسة , معهد
insulina - إنسولين
intelektualny - ‎فكري, مفكر
inteligencja - حذق ,ذكاء
inteligentny - عاقل, ذكي
intencja - غاية , قصد , عمد
intensyfikacja - تكبير
intensywny - مُتَكَثِّف
interakcja - تفاعل
interesować - اهتم رغب
interesujący - مثير للاهتمام, مشوق
interes - شأن , مسألة ; مصلحة
interlokutor - محاور
internet - الإنترنت ,إنترنت
interpretacja - تَفْسِير
intifada - انتفاضة
intonacja - نبرة
intryga - خداع، دسيسة، مكيدة، كيد
inwalida - معاق
inwazja - تغلغل ,غزوة ,غزو
inwentaryzacja - جرد
inwestor - مستثمر ,موظف
inwestować - استثمر
inżynieria - هندسة
inżynier - '''' مهندس ; '''' مهندسة
iracki - عراقي
Irakijczyk - عراقي
Irakijka - عراقية
Irak - العراق
Irańczyk - إيراني
Iranka - إيرانية
irański - إيراني
Iran - إيران
Irlandczyk - إيرلندي
Irlandia Północna - ايرلندا الشمالية
Irlandia - ايرلندا
Irlandka - أيرلندية
irlandzki - إيرلندي
ironia - تهكم, سخرية
iryd - إريديوم
irytacja - حنق
irytować - أثار، أغضب، أغاظ، ناكد، هيج، غاظ، أسخط، غايظ، ضايق
iść - سار
Isfahan - أصفهان
Islamabad - إسلام آباد
islamizacja - أسلمة
islamofobia - إسلاموفوبيا
Islamska Republika Mauretańska - الجمهورية الإسلامية الموريتانية
islamski - إسلامي
islam - إسلام , الإسلام
Islandczyk - آيسلندي
Islandia - آيسلندا
Islandka - آيسلندية
islandzki - آيسلندي
istnienie - كون ,وجود
istota - ماهية
istotny - مهم
itd. - إلخ
iterb - إتيربيوم
itr - إتريوم
Izaak - إسحاق
Izajasz - أشعياء
Izraelczyk - ‎إسرائيلي
izraelski - إسرائيلي
Izrael - إسرائيل
jabłko Adama - تفاحة آدم
jabłko - تفاحة
jacht - يخت
jadalnia - غرفة طعام
jądro - خصية
jagoda - توت
jaguar - يغور
jajko - بيضة
jajo - بيضة
jakikolwiek - أي
jaki ojciec, taki syn - الابن سر أبيه
jakiś - ما
jakość - نوعية
jakoś - ‎بطريقة ما ,لسبب ما
jak się masz? - زيك, &amp;lrm;, كيف حالك
Jakub - يعقوب
jak - كيف
jałmużna - حسنة
Jamajczyk - جامايكي
Jamajka - جامايكا
jamajski - جاميكي ,جامايكي
jama ustna - فم
Jamusukro - ياموسوكرو
Jan - يوحنا
Japończyk - ياباني
Japonia - اليابان
Japonka - يابانية
japoński - ياباني
jaskinia - كهف ,مغارة, غار
jaskółka - خطاف
jaskrawy - مشرق
jaśmin - ياسمين
jasno - بوضوح
jasny - بين ,مشرق لماع ,براق
jaszczurka - سحلية , ضب , عظاءة , حرذون
jawajski - جاوي
jazda - ركوب
jaźń - ذات
jazz - جاز
ja - أنا
jęczmień - شعير
jeden - وحيد &amp;rlm; واحد
jednolity - مطرد
jedność - وحدة ,إتفاق
jednostka - كيان, شخص, فرد
jedwab - حرير
jedyny - وحيد ,أحد
jedzenie - طعام ,غذاء ,أكل ,عيش ,مأكل
jego - ه ''''
jej - لها
jeleń - ايل, أيل
Jemeńczyk - يمني
jemeński - يمني
Jemen - اليمن
jeniec - أخيذ ,أسير حرب ,أسير
Jeremiasz - إرميا
Jerozolima - اورشليم, القدس, بيت المقدس
Jerycho - أريحا
Jerzy - جرجس
jeść śniadanie - فطر
jeść - أكل, آكل
jesień - خريف
jeździć - ركب ;ركب
jeździec - فارس, خيال
jeżeli - إذا, لو
Jezioro Aralskie - بحر آرال
jezioro - بحيرة
Jezus - يسوع , عيسى
język migowy - لغة الإشارة
język ojczysty - لغة طبيعية , اللغة القومية , اللغة الأم , لغة أولى
językowy - لغوي
językoznawczy - لغوي
język programowania - لغة برمجة
język - لسان ; لغة
jeż - قنفذ|قُنْفُذ
jidysz - يديشية|اليديشية
jodła - شوح
jod - يود
jogurt - رائب
Jonasz - يونس ,يونان
jon - أيون
Jordańczyk - ‎أردني
Jordania - الأردن
Jordanka - أردنية
jordański - ‎أردني
Jordan - الأردن
jota - إيوتا
Jowisz - المشتري ; يوبيتر
Józef - يوسف
jubileusz - يوبيل
judaizm - يهودية
judasz - ثقب الباب
Judea - يهودية
judo - جودو
juglon - جَغلون
Jugosławia - يوغوسلافيا
jugosłowiański - يوغوسلافي
jujuba - عناب
juliański - يولياني
juta - جوت
jutro - غد ; في الغد , غدا
kabel - كابل
kabuki - كابوكي
Kabul - كابول, كابل
Kabylia - منطقة القبائل
Kabyl - القبائل
kaczka - بطة
kac - خمار
kadm - كادميوم
kadzidło - بخور
Kair - القاهرة
kajak - زورق صغير, كاياك
kakadu - كوكاتو
kakao - كاكاو
kaktus - صبار
kalafior - قرنبيط
Kaledonia - كاليدونيا
Kalifornia - كاليفورنيا
kaliforn - كاليفورنيوم
kaligrafia - خط ,فن الخط ,علم الخط
kalkulator - حاسب , آلة حاسبة
kaloryfer - جهاز مشع, رادياتير, مشعاع
kalwinista - كالفيني
kalwinizm - كالفينية
kał - براز
Kambodżanin - كمبودي
kambodżański - كمبودي
Kambodża - كمبوديا
Kamczatka - كامشاتكا
kameleon - حرباء
kameruński - كاميروني
Kamerun - الكاميرون, الكامرون
kamień milowy - معلم
kamienny - صخري
kamień - حجر, صخر
kamikaze - كاميكازي
Kampala - كمبالا
Kampania - كامبانيا
kampus - حرم
Kanada - كندا
Kanadyjczyk - كندي
Kanadyjka - كندية
kanadyjski - كندي
Kanał Sueski - قناة السويس
kanał - قناة ; قناة تلفزيون
kananejski - كنعاني
kanapa - أريكة
kanapka - سندويش
kanarek - طائر الكناري, كناري
kandydat - مرشح
kangur - كنغر
kanion - تلعة
kanton - إقليم ,كانتون
kapać - سأل
kapar - أصف
kapeć - شبشب
kapelusz - قبعة
kąpielówki - سروال سباحة
kąpiel - حمام ,سباحة
kapitalista - رأسمالي
kapitalistyczny - رأسمالي
kapitalizm - رأسمالية
kapitał - رأس المال ,مال
kapitan - نقيب قبطان
kapitulacja - استسلام
kapłan - كاهن ,قس
kappa - كبا
kaptur - قلنسوة
kapucyn - القرد
kapusta - ملفوف, كرنب
karabin maszynowy - رشاش
karabin - بارودة , بندقية
Karaczi - كراتشي
karać - عاقب
karafka - غرافة
karaibski - كاريبي
Karaiby - الكاريبي
karate - كاراتيه
karat - قيراط
kara - عذاب, عقاب, جزاء ,عقوبة
karczoch - خرشوف, ‎أرضي شوكي
kardamon - هال
kardiologia - طب القلب
kardiologiczny - قلبي
kark - رقبة
karmazyn - قرمز
karma - كارما ;علف
karmel - كراميل
karmić - أطعم ,غذى
karnawał - كرنفال
Karolina - كارولين
karta graficzna - بطاقة عرض مرئي
karta kredytowa - بطاقة ائتمان
karta - بطاقة
kartka - ورق
karykaturalny - كاريكاتوري
karzeł - قزم
kąsać - قرص
kastrat - خصي
kastrować - خصى
kaszel - سعال
kaszleć - سعل ,كح
Kaszmir - كشمير
kasztanowy - كستنائي, أسمر
katalogować - فهرس
katalog - فهرس
Katalonia - كاتالونيا
Katarczyk - قطري
Katarka - قطرية
katarski - قطري
Katarzyna - كاثرين
katar - التهاب الأنف
Katar - قطر
katastrofa - كارثة , نكبة , مصيبة
kąt dwuścienny - زاوية زوجي|زوجية
kategoria - باب
kategoryczny - حاسم
kategoryzacja - تصنيف
Katmandu - كاثماندو
katolicki - كاثوليكي
katolicyzm - كاثوليكية
katoliczka - كاثوليكية
katolik - كاثوليكي
kąt - زاوية
kaukaski - ‎قوقازي
Kaukaz - القوقاز
kawa arabska - قهوة عربية
kawałek - كسرة , مقطع, قطعة
kawaler - عزب
kawa po turecku - قهوة تركية
kawa - قهوة
kawiarnia - مقهى
kawior - كافيار
Kazachstan - كازاخستان
kazać - خطب
Kazaszka - كازاخية
każdy - كل
kciuk - إبهام
keczup - صلصة طماطم, كتشب, كاتشب
kefija - كوفية
kelner - سفرجي ,نادل
Kenia - كينيا
Kenijczyk - كيني
kenijski - كيني
Kent - كنت
kichać - عطس
kichanie - عطس
kiedykolwiek - كلما
kiedy - متى
kiełbasa - سجق
kierować - أدار
kierowca - سائق
kierownica - عجلة القيادة
kierownictwo - إدارة
kierownik - إداري
kierunek - اتجاه ,جهة ,نحو ,أوب, صوب
kieszeń - جيب
kieszonkowiec - نشال
Kigali - كيغالي
kijanka - شرغوف
Kijów - كييف
kij - عصا
Kilimandżaro - جبل كيليمانجارو , كيليمانجارو
kilka - عدة ,بعض
kilogram - كيلوغرام, كيلو
kilometr - كيلومتر
kilo - كيلو
kimono - كيمونو
kinematyka - علم الحركة
kino - سينما
Kinszasa - كينشاسا
kiosk - كشك
kirgiski - قرغيزي
Kirgistan - كرغستان, قرغيزستان
Kirgizka - قرغيزية
Kirgiz - قرغيزي
Kiribati - كيريباس
Kiszyniów - كيشيناو
kiur - كوريوم
klacz - فرس
kląć - شتم
klakson - زمارة ,بوق
kłamać - كذب
kłamca - أفاك ,كذاب
klamka - مقبض الباب
kłamstwo ma krótkie nogi - حبل الكذب قصير
kłamstwo - أكذوبة ,كذب ,مين ,زور
klan - عشيرة , رهط ; زمرة , عمارة
klarnet - كلارينيت
klasa - طائفة ,صف
kłaść - وضع
klaskać - صفق
klaskanie - تصفيق
klasyczny - كلاسيكي
klasztor - دير
klatka piersiowa - قفص صدري ,صدر
klatka - قفص
klaustrofobia - رهاب الأماكن المغلقة
klawiatura - لوحة مفاتيح
klawisz - مفتاح
klęczeć - برك
kleić - صمغ
klej - صمغ
klękać - ركع, برك
klęska - كسرة, هزم, أحبط, خيب
kleszcz - قراد
klientka - زبونة
klient - زبون
klika - حلقة , طغمة ,ثلة ,زمرة ,عصبة
klimatyzacja - تكييف الهواء
klimatyzator - مكيف الهواء
klimat - مناخ
klin - إسفين
klips - مشبك
klon - قيقب
kłopot - مشكلة
kłótnia - خصام
klub - ناد
klucz - مفتاح
kmin rzymski - كمون
knajpa - حانة
koala - كوالا
koalicja - تحالف, ائتلاف
kobalt - كوبالت
kobiecy - أنثوي, نسوي
kobieta - مرأة , امرأة
kobra - كوبرا
kochać - جامع حب, عشق, انشغف
kochanek - عاشق ,خليل
kochanie - حبيبي
kochany - حبيبي, حبيب ,محبوب عزيز
koc - بطانية
kod - شفرة
koegzystencja - تعايش
kofeina - كافايين, كافيين
kogut - ديك
kojarzyć - ربط
kokos - جوز الهند
koktajl - كوكتيل
kolacja - عشاء
kolano - ركبة
kolarstwo - ركوب الدراجات
kola - كولا
kolba - دورق
kolczasty - حاد ,شوكي ,شائك
kolczyk - قرط ,حلقة
kołdra - لحاف
kolebka - مهد , رجاحة ,أرجوحة , سرير الطفل
kolega - زميل
kolejka - طابور ; طابور
kolejny - ثان, قادم, مقبل, تال, متلاحق
kolej - دور
kolekcjoner - جامع
kolekcjonować - جمع
kolektywny - جماعي, متجمع
kolendra - كزبرة
koleżanka - زميلة
kolidować - خالف
kolizja - صدم
kołnierz - قبة , ياقة
kolonializm - استعمار , استعمارية
kolonia - مستعمرة
kolonizator - مستعمر
kolorowy - ملون
kolor - لون
koło - دائرة ; عجلة , دولاب
Kolumbia Brytyjska - كولومبيا البريطانية
Kolumbia - كولومبيا
Kolumbijczyk - ‎كولومبي
kolumbijski - ‎كولومبي
kolumna - عمود ; باب
kołyska - مهد
komar - بعوضة
komentować - علق
komercyjny - تجاري
kometa - مذنب
komfort - هون, راحة
kominek - مستوقد, مدفأة
komisariat - مركز شرطة
komitet - مجلس
komórka - خلية
Komory - جزر القمر
kompan - رفيق, زميل ,صاحب
kompas - بوصلة
kompetencja - كفاءة
kompletnie - تماما
kompletny - كامل ,تمام ,صحيح
komponować - لحن, ترسل
kompromis - حل وسط ,اتفاق وسط
komputer - كمبيوتر , حاسوب, حاسب
komunia - مناولة
komunikacja - رسالة
komunista - شيوعي
komunistyczny - شيوعي
komunizm - شيوعية
Konakry - كوناكري
koncentrować - ركز
końcowy - نهائي ,أخير
kończyć - انتهى / أنهى
kondom - عازل ذكري
kondygnacja - طابق
konfederacja - حلف
konferencja - مؤتمر
konflikt - خصام
Kongo - كونغو , جمهورية الكونغو , الكونغو ; نهر الكونغو
kongres - ‎مؤتمر
koniak - كونياك
konieczność - ضرورة , حتمية , وجوب
konieczny - ضروري
koniec - نهاية ,إنتهاء
konik morski - فرس البحر
konkurs - مسابقة
konopie - كيف ,قنب هندي ,قنب
konsekwencja - عاقبة
konserwatywny - محافظ
konserwować - حفظ
Konstantynopol - القسطنطينية
konstelacja - كوكبة, برج
konsternacja - رعب، ذعر
konstrukcja - تركيب, بناء, إقامة, تعمير, عمران, إنشاء, إعمار
konstrukcyjny - إنشائي
konstruowanie - صياغة
konstytucja - دستور
kontener - حق
konto - حساب
kontrabanda - تهريب
kontrabas - كمان أجهر
kontrahent - مقاول
kontrakt - عقد ,إتفاق
kontrola - مراقبة
kontroler - مراقب
kontuzja - رض
kontuzjować - رض
kontynentalny - قاري
kontynent - قارة
kontynuować - تابع ,إستمر
konwencjonalny - كلاسيكي, عادي
koń - حصان ,جواد, خيل
kopalnia - منجم
kopanie - حفر
koparka - حفارة
Kopenhaga - كوبنهاغن
koperta - ظرف
koper włoski - شومر
koper - شبت
kopia - نسخة
kopiować - نسخ
kopiowanie - محاكاة , تقليد ,نسخ
koptyjski - قبطية قبطي
kopuła - قبة
Koran - القرآن
kordialny - قلبي
Koreańczyk - كوري
Koreanka - كورية
koreański - كوري
Korea Północna - كوريا الشمالية
Korea Południowa - كوريا الجنوبية
Korea - كوريا
korek - زحام سير
korelacja - ترابط
korespondencja - بريد
korespondować - كاتب
korona - تاج ; كرونة
korpus - فيلق
korsykański - كورسيكي
Korsyka - كورسيكا
korzeń - جذر, عرق, شرش ; باطن ,عرق
korzyść - إنتفاع
korzystać - إنتفع ,إستفاد ,إستمتع, أفاد
korzystny - نافع ,موافق
kościelny - كنسي
kościół - كنيسة
kość sitowa - عظم غربالي
kość słoniowa - عاج
kość - عظم
kosmologia - علم الكون
kosmos - كون
Kosowo - كوسوفو, كوسوفا
Kostaryka - كوستاريكا
kostka - كعب ,مكعب ; كاحل
koszary - ثكنة , قشلة , قشلاق , ثكنة عسكرية
koszmar - قابوس ,كابوس, جثام
kosztować - كلف
koszt - حساب
koszula - قميص
koszykówka - كرة السلة
kosz - سلة المهملات, سلة
kos - شحرور
kotka - قطة
kot perski - قط فارسي
kot syjamski - قط سيامي
kotwica - مرساة
kot - قط, هر
kowal - حداد
Kozak - قوزاق
koza - عنز عنزة , ماعز, معزة
kozioł - جدي
Koziorożec - برج الجدي
kpina - أضحوكة
krab - سرطان البحر, سرطان
kradzież - سرقة , إختلاس ,نهب
krąg - حلقة
Kraj Basków - منطقة إقليم الباسك ذاتية الحكم بلاد البشكنش
krajobraz - منظر طبيعي, مشهد
krajowy - محلي, أهلي
kraj - دولة , ولاية , بلد ,بلاد
Kraków - كراكوف ,كراكوفيا
kraniec - غاية , أقصى
kran - صنبور, حنفية
kraść - سرق ,إختلس ,نهب
krawat - كرافته
krawędź - شفرة, حافة
krawiec - خياط
kreacjonizm - نظرية الخلق
kreatywny - خلاق ,إبداعي
kręcić - دور
kredyt - ائتمان
kręgosłup - العمود الفقري
krem - ‎مرهم ,دهان
kreska - خط
krętogłów - لواء
kret - خلد
krewetka - جمبري
krewny - قريب
krew - دم
kroić - قطع
krokodyl - تمساح
krokus - زعفران
krok - ‎خطوة
Królestwo Bhutanu - مملكة بوتان
królestwo - ملكوت
królewski - ملكي, ملوكي
królik - أرنب
królowa - ملكة
król - ملك
kropka - نقطة
kropla - قطرة
krosta - بثرة
krótki - قصير ; وجيز
krótkotrwały - زائل
krótko - باختصار, أختصارا
krowa - بقرة
krtań - حنجرة
kruchy - قصيم
krucjata - حملات صليبية
kruk - ‎غراب
krwotok - ‎نزيف
krykiet - كريكت
krypton - كريبتون
kryształ - بلورة
krytyczny - حاسم, حرج
krytyka - نقد
krytykować - نقد, عيب, إنتقد
krytykowanie - انتقاد
kryzys - نوبة, ‎أزمة
krzak - شجيرة
krzem - سليكون
krzesło - كرسي, مقعد
krzyczeć - صاح
krzyk - صياح, صيحة, صرخة
Krzysztof - خرسطوفورس
krzywa - خط
krzywda - حيف
krzywy - أعوج ,متعرج
krzyżówka - كلمات متقاطعة
krzyż - صليب
ksenon - زينون
ksiądz - قس ,قسيس ,كاهن
książę - أمير
książka - كتاب
księgarnia - مكتبة
Księga Rodzaju - سفر التكوين
księga - مصحف
księgowość - محاسبة
księgowy - محاسب
księżniczka - اميرة
księżyc - قمر
kształt - جسم, مظهر, شكل
kto pod kim dołki kopie, sam w nie wpada - من حفر حفرة لأخيه وقع فيها
który - الذي
ktoś - واحد
kto - من
Kubańczyk - كوبي
kubański - كوبي
Kuba - كوبا
kubek - كوب
kucharz - طباخ
kuchnia - مطبخ ; ‎طبخ
kukułka - وقواق
kukurydza - ذرة
kula - كرة
kulturalny - أديب
kultura - ثقافة ,حضارة ,تقاليد
kult - عبادة
kupa - كومة
kupno - شراء
kupować - ابتاع, اشترى
kura - دجاجة
kurczak - فروج
kurdyjski - كردية كردي
kurier - ساع
kuriozalny - غريب، شاذ، عجيب
kurs - دورة
kurtka - سترة , ‎جاكيت
kurwa - عاهرة, مومس, زانية
kurz - غبار
kuskus - كسكس, كسكسي
kuszenie - جاذبية
kuwejcki - كويتي
Kuwejtczyk - كويتي
Kuwejtka - كويتية
Kuwejt - الكويت ; مدينة الكويت
kwadrans - ربع ساعة, ربع
kwadratowy - مربع تربيعي
kwadrat - مربع
kwalifikacja - كفاءة
kwarc - مرو
kwas foliowy - حمض فوليك
kwas mlekowy - حمض لاكتيك
kwaśny - حامض
kwas octowy - حمض الخليك
kwas - حمض
kwestia - مسألة, خطب
kwestionować - شك
kwiat - زهرة
kwiecień - أبريل , نيسان, ربيع الآخر
kwintesencja - جوهر
kwitnąć - ازهر ,نور
kwota - مبلغ
łabędź - إوز عراقي
laboratorium - معمل
łacina - لاتينية
łaciński - لاتيني
Lacjum - لاتسيو
łączyć - عشق ; قرن, ربط, وصل, ترابط
ładny - جميل , صباح
ładować - شحن
ładowanie - شحن
ładowarka - شاحن
ładunek - شحن, شحنة
ląd - بر, يابسة
łagodnieć - لين
łagodnie - بهدوء
łagodny - سمح ,لين, رقيق
Lahaur - لاهور
łąka - مرج
lakier do paznokci - طلاء أظافر
lalka - دمية
łamać - حطم
lambda - لامدا
lament - نوح
lampa - مصباح ,لمبة ,سراج
łańcuch pokarmowy - سلسلة غذائية
łańcuch - سلسلة سلسلة جبلية
lantan - لانثانوم
Laos - لاوس
łapać - أمسك
łapanie - مسك
łapa - قدم الحيوان
lapis lazuli - لازورد
laptop - حاسوب محمول, كمبيوتر محمول
larum - جلبة
łaska - عفو ,رحمة, فضل
las - غابة ,أيك
latanie - طيران
latarka - مصباح جيب
lato - صيف
łatwo - بسهولة
łatwy - يسير ,سهل
lawenda - ضرم
ławka - دكة
łazienka - حمام مرحاض
Lazurowe Wybrzeże - الريفييرا الفرنسية
lazur - لازوردية , لازورد
łechtaczka - بظر
lecieć - طار
leczenie - معالجة
leczniczy - شاف
leczyć - داوى ,عالج
ledwo - بالكاد
legalny - حلال ,شرعي ,مشروع ,جائز
legenda - أسطورة ;أسطورة
legislacja - سن
legitymacja - بطاقة
lekarstwo - دواء, عقار
lekarz - طبيب , طبيبة , حكيم
lekceważenie - أنفة
lekcja - درس
lekkoatletyka - ألعاب قوى
lęk - قلق, حصار
lemoniada - ليمونادا, شراب الليمون
lemur - ليمور
lenistwo - كسل, تكاسل, تراخ, خمول, قصور
leniwy - كسول, كسلان, خامل, بطيء, كسل
len - كتان
lepiej późno niż wcale - أن تصل متأخرا خير من أن لا تصل أبدا
lepszy - أفضل ,أحسن ,أخير
Lesotho - ليسوتو
letni - صيفي
lewarek - رافعة
lewicowy - شمالي ,يساري ,اشتراكي
lewo - يسار
lewy - أيسر
lew - أسد , سبع
Lew - برج الأسد
Libańczyk - لبناني
Libanka - لبنانية
libański - لبناني
Liban - لبنان
liberalizm - ليبرالية ,تحررية
Liberia - ليبيريا
Libia - ليبيا
libido - غريزة جنسية , ليبيدو
Libijczyk - ليبي
Libijka - ليبية
libijski - ليبي
licencja - إجازة
liceum - ثانوية
lichwa - ربا , مراباة
liczba mnoga - صيغة الجمع ,جمع
liczba - عدد ,رقم
liczenie - حساب ,عد, عید
liczi chińskie - ليتشي
liczny - ‎كثير, عديد
liczyć - عد ,حسب, عید
lider - هادي, زعيم, قائد, رئيس ,رأس ,قطب
Liguria - ليغوريا
likwidacja - تسييل
lilak - ليلك
lilia - زنبق
Lima - ليما
limit - نهاية , قصر
lina - حبل
lingwista - لغوي
lingwistyka - لسانيات, علم اللغة ,لغويات
linia - خط , سطر
link - رابط ,رابط تشعبي
lipiec - يوليو , تموز
lira - لور ليرة
lir - ليرة
liść - ورقة ,ورق
lista - لائحة
listonosz - ساعي البريد
listopad - نوفمبر , تشرين الثاني
list - رسالة , مكتوب , كتاب
lis - ثعلب
literacki - أدبي
literalny - حرفي
literatura - أدب
litera - حرف
litewski - ليتواني
litość - رحمة
litr - ليتر
Litwa - لتوانيا;
Litwinka - ليتوانية
Litwin - ليتواني
lit - ليثيوم
lizać - لعق
lizanie - لعق, لحس
Lizbona - لشبونة
lodowiec - نهر جليدي, مثلجة
lodowisko - حلبة التزلج
lodówka - ثلاجة
łodyga - عرق, ساق
łódź - زورق, قارب
Łódź - وودج
lód - جليد , ثلج ; مثلجات
logiczny - منطقي
logować - سجل
logo - شعار
lojalny - مخلص، أمين، بار، وفي
lokalizacja - محل, موضع
lokalny - محلي
łokieć - كوع
Lombardia - لومبارديا
londyńczyk - لندني
londyński - لندني
Londyn - لندن
łono - رحم
łopata - رفش
łopatka - عظم الكتف
lorens - لورنسيوم
lornetka - ناظور
łosoś - سلمون
losowy - عشوائي
los - حظ ,قدر ,نصيب
łoś - موظ
łotewski - لاتفي
lotnictwo - طيران
lotnisko - مطار
Łotwa - لاتفيا
Łotyszka - لاتفية
Łotysz - لاتفي
lot - طيران
łóżko - سرير, فراش, تخت, مضجع, مهاد
łożysko - مشيمة
Luanda - لواندا
lubić - حب ,أحب ,ود
lubieżność - شبق
lubieżny - شبق
Lublana - لوبلانا
lub - أو
łucznictwo - نبالة
ludobójstwo - إبادة جماعية
ludowy - شعبي
ludzie - ناس ,شعب ,بشر, قوم
ludzki - إنساني ,آدمي ,بشري
ludzkość - بشرية , ناسوت , إنسانية ; إنسانية , حنو , شفقة
lud - شعب
Luksemburg - لوكسمبورغ ,لوكسمبورج
luksus - ترف , إسراف, رغد, رفاهية, تبذير, رغادة, جدة
łuk - قوس
lustro - مرآة
lutet - لوتيشيوم
luty - فبراير , ''dialekt syryjski'' شباط , ''dialekt algiersko-tunezyjski'' فيفري , ''dialekt libijski'' النوار
lwica - لبؤة
łydka - بطة الساق
łysy - أصلع
łyżeczka - ملعقة صغيرة
łyżka - ملعقة
łza - دمعة, عبرة
Macedończyk - مقدوني
Macedonia - مقدونيا
Macedonka - مقدونية
macedoński - مقدوني
machać - لوح
macica - رحم
macierzanka - زعتر
macierzyński - أمومي
Madagaskar - مدغشقر
mądrość - حكمة
Madryt - مدريد
mądry - حكيم
maestro - مايسترو
mafia - مافية
magazynować - خزن
magazyn - مجلة ; مخزن
Maghreb - المغرب العربي ,مغرب
magia - سحر
magiczny - سحري
magister - ماجستير
magnes - مغناطيس
magnetyczny - مغنطيسي
magnez - مغنسيوم, مغنيسيوم
magnolia - ماغنوليا
mahajana - ماهايانا
Mahomet - محمد
majątek - مال
Maja - مايا
majestatyczny - مهيب ,فخم, ملوكي
majonez - مايونيز
major - رائد
Majotta - مايوت ,مايوطة
majtki - سروال داخلي
maj - مايو , ايار
makaron - معكرونة, مكرونة
Makau - ماكاو
mąka - طحين, دقيق
makijaż - مكياج
makrela - إسقمري
mak - خشخاش
Malabo - مالابو
malajski - ملايو ملايو, ملايوي
Mała Niedźwiedzica - الدب الأصغر
malaria - ملاريا, أجمية
malarstwo - رسم فني
malarz - رسام
Mała Syrta - خليج قابس
Malawi - ملاوي
Malezja - ماليزيا
Malezyjczyk - ماليزي
Malezyjka - ماليزية
malezyjski - ماليزي
Male - ماليه
malina - توت العليق
Mali - مالي
malować - لون ,‎رسم
mało - شوية ; قليل
Maltańczyk - مالطي
Maltanka - مالطية
maltański - مالطية مالطي
Malta - مالطة, مالطا
malwa - خطمي ;خطمي
mały - صغير , ضئيل
małżeński - زواجي ,زوجي
małżeństwo - زواج, نكاح, تزويج
małżonek - زوج
małżonka - زوجة
mama - ماما
Managua - ماناغوا
Manama - المنامة
manat - خروف البحر ; مانات
Manat - مناة
mandarynka - يوسفي
mandat - غرامة
manekin - مانيكان
mangan - منغنيز
mango - مانغو, منجا
maniera - صورة
Manila - مانيلا
mapa - خريطة
maraton - ماراثون
marcepan - مرصبان
marchew - جزر, جزرة
Marek - مرقس
margaryna - مارغرين
Mariany Północne - جزر ماريانا الشمالية
Maria - مريم
marka - ماركة ; مارك
marmolada - مرملاد
marmur - رخام, ‎مرمر
marnować - أضاع
Marokańczyk - مغربي, مراكشي
Marokanka - مغربية
marokański - مغربي, مراكشي
Maroko - المغرب
maronita - ماروني
Marrakesz - مراكش
Marsylia - مارسيليا , مرسيليا
marszałek - مارشال
marsz - مارس
Mars - المريخ , مريخ
martwić - قلق, كرب, جزع عنى
martwy - ميت
Martynika - مارتينيك
Maryja - مريم , مريم العذراء
marynarz - بحار , ملاح , بحري
marzec - مارس, آذار
marzyć - رجا ,أمل
Masada - مسادا , مسعدة
masaż - تدليك
masa - كتلة
maść - ‎مرهم
Maseru - ماسيرو
Maskat - مسقط
maska - قناع
maślanka - لبن خض , مخيض
masło - زبدة , سمن
masoneria - ماسونية
mason - ماسون
masturbacja - استمناء ,عادة سرية
masturbować - استمنى
maszyna - ماكينة
matczyny - أمومي, أمي
matematyczny - رياضي
matematyka - رياضيات
matematyk - رياضي
materiał - مادة ; قماش
materia - جسم مادة ; هيولى
Mateusz - متى
matka - أم , والدة
matrioszka - دمية روسية , ماتريوشكا
matura - بكالوريا
Mauretańczyk - موريتاني
Mauretania - موريتانيا
Mauretanka - موريتانية
mauretański - موريتاني
Mauritius - موريشيوس
mauzoleum - ضريح
mąż - زوج , بعل
mebel - أثاث
mechaniczny - ميكانيكي
mechanika - ميكانيكا, ميكانيك
meczet - مسجد ,جامع
męczyć - تعب
mecz - مباراة
medal - نيشان ,ميدالية
mediana - وسيط
mediolański - ميلانو
Mediolan - ميلانو
mędrzec - حكيم
meduza - قنديل البحر
medycyna - طب
Medyna - المدينة, المدينة المنورة
meitner - مايتنريوم
Mekong - ميكونغ
Meksykanin - مكسيكي
meksykański - مكسيكي
Meksyk - المكسيك ; مدينة مكسيكو
melancholia - كآبة , ملنخوليا , سوداء
melasa - مولاس ,دبس
melatonina - ميلاتونين
Melilla - مليلية
mellah - الملاح ,ملاح
melodia - لحن ,نغم
melon - بطيخ, شمام ,بطيخ أصفر
mendelew - مندليفيوم
menstruacja - حيض
Merkury - عطارد
męski - رجولي&amp;lrm; مذكر ;ذكري
męskość - ذكورة , رجولية , رجولة
metabolizm - استقلاب ,أيض
metafora - استعارة
metalowy - معدني
metal - معدن
metan - ميثان
meteorologia - علم الطقس
meteoryt - حجر نيزكي, نيزكي
meteor - شهاب ,نيزك
metoda - نحو ,طريقة ,منهج, غرار, ميزان
metro - مترو
metr - متر
mężczyzna - رجل , آدم
Mezopotamia - بلاد الرافدين
mgła - ضباب, سديم
miasteczko - بلدة
miastenia - الوهن العضلي الوبيل
miasto - بلدة ,مدينة
miażdżyca - تصلب الشرايين
miąższ - رب
Michał - ميخائيل , ميكائيل
mieć miejsce - وقع ,حدث ,جرى
mieć nadzieję - أمل ,رجا
miecz - سيف
mieć - تضمن، إمتلك، حاز، ملك، إقتنى
miedziany - نحاسي
Międzynarodowa Agencja Energii Atomowej - الوكالة الدولية للطاقة الذرية
Międzynarodowy Ruch Czerwonego Krzyża i Czerwonego Półksiężyca - جمعية الصليب والهلال الأحمر
międzynarodowy - أممي, دولي
między - بين ,وسط
miedź - نحاس
miejsce - مكان ,محل ,موقع
miejscowy - بلدي&amp;lrm; موضعي
miejska legenda - أساطير مدنية حديثة
miękki - لين, ناعم, رقيق
mierzyć - قياس ,كيل, كال
miesiąc - شهر
mięsień - عضلة
mięso - لحم
mieszać - بلبل أخجل إختلط ,خالط
mieszanina - خلطة , خليط / إختلاط , مزيج
mieszanka - خلطة , خليط
mieszkać - سكن
mieszkaniec - مواطن
mieszkanie - شقة
mięta - نعناع
migdał - لوز
migrena - صداع, صداع نصفي
mikrofon - ميكروفون ,مصدح
Mikronezja - ميكرونيسيا
mikroorganizm - ميكروب
mila - ميل
milczeć - صمت
milczenie - سكوت ,هدوء ,صمت
milicja - ميليشيا
milimetr - مليمتر
milioner - مليونير
militarny - عسكري
miłość jest ślepa - الحب أعمى
miłość platoniczna - حب أفلاطوني
miłość - غرام ,حب ,عشق ,صبابة
miłośnik - معجب
miłosny - غرامي, غزلي
miło - بلطف
miły - لطيف ,حنان ,طيب
minaret - مئذنة
mina - لغم
minerał - معدن
minimalny - الأقل
ministerstwo - وزارة , مفوضية
minister - وزير
Minnesota - مينيسوتا
Mińsk - مينسك
minus - ناقص
minuta - دقيقة
miodowy miesiąc - شهر العسل
miód - عسل
miraż - هال, سراب
misja - تبشير
miska - طاسة , طبق
Miśnia - ميسين
miso - ميسو
Missisipi - مسيسيبي
mistrzostwo - إجادة
mistrz - بطل
miś - دمية دب
mitologia - ميثولوجيا
mitologiczny - ميثولوجي
mit - أسطورة ; خرافة
mizantropia - بغض البشرية
mi - مو
mleczny - لبني
mleko sojowe - حليب الصويا
mleko - لبن ,حليب ,درة
młodość - شبيبة , نشأة , غلامية
młody - يافع ,شاب ,صغير
młodzieńczy - ‎شاب
młodzieniec - شاب
młoteczek - مطرقة
młotek - مطرقة
młynek - مطحنة
młyn - طاحونة , مطحنة
mnich - راهب
mniejszość - أقلية
mniej więcej - نحو ,تقريبا
mnogi - جمعي
mnogość - زيادة
mnożenie - ضرب
moabicki - لغة مؤابي|مؤابية ; مؤابي
mocny - صلب
moczowy - بولي
mocz - بول
móc - استطاع, أمكن
moc - قدرة حيل
moda - موضة
model - نموذج, طرز
modernizacja - عصرنة
modlić się - صلى
modlitwa - صلاة , أوشية
Mogadiszu - مقديشيو, مقديشو
moher - موهير
Mojżesz - موسى
mój - لي
mokry - ندي
Mołdawianin - مولدوفي
Mołdawianka - مولدوفية
Mołdawia - مولدافيا , مولدوفا
mołdawski - مولدوفي
molibden - موليبدنوم
mol - مول
moment - دقيقة ,لحظة ,برهة
Monako - موناكو
monarcha - ملك, عاهل
monarchia - ملكية
Mongolia - منغوليا
monitor - شاشة
monogamia - الزواج الأحادي
monoteistyczny - توحيدي
monoteizm - توحيدية
monotonia - رتابة
monotonny - راتب ,روتيني ,رتيب
Montevideo - مونتيفيديو
Montreal - مونتريال
moralność - أخلاقيات
moralny - خلقي
morderca - قتال, سفاح, سفاك دماء
morderstwo - قتل, اغتيال, غيلة, مقتل
morela - مشمش
Moroni - موروني
morski - بحري
Morze Adriatyckie - البحر الأدرياتيكي
Morze Arabskie - بحر العرب
Morze Bałtyckie - بلطيق, بحر البلطيق
Morze Barentsa - بحر بارنتس
Morze Czarne - البحر الأسود
Morze Czerwone - البحر الأحمر
Morze Irlandzkie - البحر الأيرلندي
Morze Jońskie - البحر الأيوني
Morze Kaspijskie - بحر قزوين
Morze Koralowe - بحر كورال
Morze Martwe - بحر ميت ,البحر الميت
Morze Norweskie - بحر النرويج
Morze Północne - بحر الشمال
Morze Południowochińskie - بحر الصين الجنوبي
Morze Śródziemne - البحر الأبيض المتوسط ,البحر المتوسط ,بحر الروم
Morze Żółte - البحر الأصفر
morze - بحر
Moskwa - موسكو
mostek - عظم القص
most - جسر;
moszna - صفن , كيس الصفن
motel - موتيل
motocykl - دراجة بخارية , موتوسيكل
motorówka - زورق آلي
motyl - فراشة
mowa jest srebrem, a milczenie złotem - إذا كان الكلام من فضة فالسكوت من ذهب
mowa - كلام ,منطق
mówić - تحدث, تحادث, تكلم, قال ,كلم
Mozambik - موزمبيق
może - ربما, عل, لعل, قد
mózg - دماغ, مخ
możliwość - إمكانية ; فرصة
możliwy - ممكن ,محتمل
mrówka - نملة
mucha - ذبابة
muezin - مؤذن
muł - بغل
Murzyn - أسود ,زنجي
mur - جدار, حائط, سور
musieć - واجب
muślin - شاش
muszla - صدفة
musztarda - خردل
muza - إلهام
muzeum - متحف
muzułmanin - مسلم
muzułmanka - مسلمة
muzułmański - إسلامي, مسلم
muzyka - موسيقى
muzyk - موسيقار
mycie - إغتسال
myć - غسل
mydło - صابون
mylić - أخطأ ,سقط ,غلط
mylny - باطل, ضال
myśleć - فكر ; إعتقد
myślenie - فكر ,عد
myśliwiec - طائرة مقاتلة
myśl - هاجس, فكر
Myszka Miki - ميكي ماوس
myszka - فأرة
myszoskoczek - يربوع
mysz - فأرة فأر
my - نحن
nacisk - كبس
nacjonalizacja - تأميم
nacjonalizm - قومية
naczyniak krwionośny - ورم وعائي
naczynie - طبق ,وعاء
nadal - ما زال ,لا يزال
nadawać - ناسب
nadchodzić - جاء ,قدم
nadepnąć - داس
nadgarstek - رسغ , معصم
nadludzki - فوق بشري
nadmiar - زيادة
nadnercze - غدة كظرية
nadprzewodnictwo - موصلية فائقة
nadzieja - أمل , رجاء, رجية
nagi - ‎عار ,عري
nagle - فجأة
nagły - خاطف
nago - عاريا
nagranie - سجل
nagroda - جائزة ,مكافأة
nahda - نهضة , النهضة
Nairobi - نيروبي
naiwny - غر ,ساذج
najpierw - أولا
nakaz - أمر ,إلزامي ,أمري
nakrycie - خمار, برقع ''''
nalewać - سكب ,صب
nałóg - إدمان
Namibia - ناميبيا
namiot - خيمة
napad - مهاجمة , إعتداء
napalm - نابالم
napaść - مهاجمة , إعتداء, هجوم
napastnik - مهاجم
napędzać - دفع
napęd - محرك
na pewno - بالتأكيد, قطعا
napięcie - توتر ,ضغط
napinać - توتر ,وتر
napis - كتابة
napiwek - بقشيش
napletek - قلفة
napój - مشروب, شراب
napomnienie - ذكرى
naprawa - تصليح, لام ,إصلاح
naprawdę - حقا
naprawiać - أصلح شعب
na przykład - مثلا، على سبيل المثال، مثال على ذلك
narciarstwo - تزحلق, تزلج
narcyz - نرجس
narkomania - دمان مخدرات
narkotyk - مخدرات
narodowość - جنسية , قومية
narodowy - قومي, وطني
narodziny - ولادة, مولد ,ميلاد
naród - أمة , قوم
narrator - قصصي
narzeczona - خطيبة‎
narzędzie - آلة, أداة , وسيلة
nasiono - حبة, بزور, بذرة
naskórek - بشرة
Nassau - ناساو
następca - خلف ,خليفة
następnie - حينئذ ,ثم ,بعد ذلك
następny - التالي
następować - '''' تابع, عقب
następstwo - أثر ,تلو, عاقبة
nastolatek - مراهق
nastrój - مزاج
naszyjnik - قلادة
nasz - خاصتنا, ملكنا
naturalizacja - تجنيس
naturalnie - طبعا بطبيعة الحال
naturalny - فطري;&amp;lrm; طبيعي
natura - طبيعة خلق
natychmiast - فورا ,على الفور, حالا
nauczanie - درس
nauczycielka - مدرسة , , أستاذة , معلمة
nauczyciel - معلم ,مرشد ,مدرس
nauka - علم ; تعلم
naukowiec - عالم
Nauru - ناورو
Nawakszut - نواكشوط
nawa - صحن
nawet - حتى
nawias - قوس
nawyk - شأن
nawzajem - بعضهم بعضا, بعضه ببعض
nazwa - اسم
nazwisko - لقب
nazywać - سمى
na - على , فوق
Ndżamena - نجامينا, إنجامينا
Neapol - نابولي
nędza - فاقة , فقر مدقع
nędzny - بائس
negatywny - سلبي
negocjować - حادث ,فاوض
nękać - كرب
neodym - نيوديميوم
neologizm - تعبير جديد ,لفظة جديدة ,لفظ محدث
neon - نيون
Nepalczyk - نيبالي
Nepalka - نيبالية
nepalski - نيبالية نيبالي
Nepal - نيبال
nepotyzm - محسوبية
Neptun - نبتون
neptun - نبتونيوم
nerka - كلية
nerwowość - عصبية
nerwowy - عصبي
nerw - عصب
neutrino - نيترينو
neutron - نيوترون
Niamey - نيامي
Nicea - نيس
nic - لا شيء
nieaktywny - غير فعال ,عاطل
niebezpieczeństwo - خطر, مهلكة
niebezpieczny - خطر ,خطير
niebieski - أزرق ; سماوي
nieboskłon - قبة , قبة سماوية
niebo - سماء جنة
niechcący - عن غير قصد
niechęć - كراهية, غل
niecierpliwie - بفارغ الصبر
nieczystość - قذر
niedawno - حديثا
niedługo - بعد قليل
niedobór - قصور
niedobrze - بشكل خاطئ
niedokrwienie - إقفار
niedokrwistość - فقر دم
niedola - شقاء
niedouczony - جاهل
nie do zniesienia - لا يطاق
niedożywienie - مجاعة, سغل, نقص التغذية, سوء تغذية, سوء
niedrogi - غير غال
niedużo - قليلا
Niedziela Palmowa - أحد الشعانين
niedziela - الأحد
niedźwiedzi - دبي
niedźwiedź polarny - دب قطبي
niedźwiedź - دب
nieistotny - طفيف
niekoherentny - متفكك
niekontynuowanie - وقف
niektóry - بضع, بضعة
nielegalny - غير قانوني
nieludzki - وحشي ,غير إنساني
Niemcy - ألمانيا
Niemen - نيمان
Niemiecka Republika Demokratyczna - الجمهورية الألمانية الديمقراطية
niemiecki - ألماني
Niemiec - ألماني
Niemka - ألمانية
niemowlę - مولود ,رضيع
niemy - أخرس
nienawidzenie - بغض
nienawidzić - كره ,بغض
nienawiść - كره, كراهية ,بغض
nieobecny - غائب
niepalący - غير مدخن
niepełnosprawność - إعاقة
niepełnosprawny - ‎مقعد, معاق
niepewnie - بتردد ,بعدم اليقين
niepewność - عدم اليقين ,ظن
niepewny - غير متأكد, متقلب
niepodległość - استقلال
niepodległy - مستقل
niepokój - قلق ,حصار ,جأش, كرب
niepokorny - جامح
nieporozumienie - سوء الفهم, سوء
nieposłuszeństwo - عصيان
niepotrzebnie - بدون ضرورة
niepowodzenie - فشل ,نحس ,عادية
nieprawda - كذب، مين
nieprawdziwy - باطل ,كاذب
niereligijny - ملحد
nieść - حمل, نقل
nieskomplikowany - بسيط
nieskończony - خالد, مخلد, لانهائي
nieśmiałość - خجل ,حياء
nieśmiały - خجول, حيي
nieśmiertelność - خلود, خلد
niesprawiedliwie - ظلما
niesprawiedliwość - حيف ; ظلم, جور
niesprawiedliwy - جائر ,ظالم
niesprawny - عاجز
niestety - للاسف الشديد ,للاسف
nieszczęście - مصيبة , بؤس, شقاء
nieszpory sycylijskie - حرب صلاة غروب|الغروب صقلي|الصقلية
nietoperz - خفاش ,وطواط
nietrzeźwy - سكران
nieunikniony - محقق
nieustraszony - شجاع, جسور
nieuwaga - غرة, سهو, غفلة, نسيان, إهمال
niewiele - قليل
niewielki - يسير
niewierzący - لا ديني
niewinność - طهارة
niewinny - بريء ,أبيض, زكي
niewola - رق
niewolnictwo - عبودية
niewolnik - عبد
nie wszystko złoto, co się świeci - ليس كل ما يلمع ذهبا
niewydolność - قصور
niezależność - استقلال
niezależny - مستقل
niezbędny - ضروري
niezdolność - عجز ,قصور ,إعياء
niezgoda - بين ,فتنة, شقاق
nieznajomy - أجنبي
nieznany - منكر, مجهول, مغمور, غير معروف
nieznośny - لا يطاق
niezwykły - مدهش
nie- - لا ,غير
nie - لا, ليس ,مش, لن
nigdy - أبدا
nigdzie - لا مكان
Nigeria - نيجيريا
Nigeryjczyk - نيجيري
nigeryjski - نيجيري
Niger - النيجر
nikab - نِقاب , نقاب
Nikaragua - نيكاراجوا
nikczemny - نذل
nikiel - نيكل
nikotyna - نيكوتين
Nikozja - نيقوسيا
nikt - لا احد
Nil - النيل
nirwana - نيرفانا
niski - مهين ,نذل &amp;rlm; منخفض ,قصير, واطئ
niszczyciel - مدمر ; مدمرة
niszczyć - خرب ,هدم, حطم, دمر ,سحق, ثبر
Nix - نيكس
niż - من
ni - نو
nobel - نوبليوم
nocny - ليلي
noc - ليل , ليلة
noga - رجل, ساق
nominować - عين, نصب
nonkonformista - منشق
nonsens - لغو
Norfolk - نورفولك
normalny - طبيعي ,عادي
Normandia - نورماندي
Norwegia - النرويج
Norweg - نرويجي
norweski - نرويجي
Norweżka - نرويجية
nosić - لبس
nos - أنف
notatka - مذكرة
notatnik - دفتر
notes - دفتر, مفكرة
notować - دون
Nowa Kaledonia - كاليدونيا الجديدة
Nowa Zelandia - نيوزيلندا
Nowe Delhi - نيودلهي
nowina - نبأ ,خبر
nowoczesny - معاصر ,حديث ,عصري ,جديد
nowość - حدث ,بدعة ,حداثة ,طرافة
Nowosybirsk - نوفوسيبيرسك
nowotworowy - سرطاني
nowotwór - ورم
Nowozelandczyk - نيوزيلندي
nowożeniec - عريس
nowo - حديثا
Nowy Jork - نيويورك
Nowy Meksyk - نيومكسيكو
nowy - جديد
nozdrze - منخر
nożyczki - مقص
nóż - سكين
np. - مثلا
nuda - ملل
nudny - مضجر, ممل
nudzić - أمل
numerować - رقم, عید, عدد
numerowanie - عید
numer - رقم
Numidia - نوميديا
Nuristan - نورستان
nurkować - غطس
nurkowanie - غوص &amp;rlm; غطس
Nuuk - نوك
Nyks - نيكس
oaza - واحة
obaj - هما
obalać - دفع
obalenie - دفع
obawa - قلق
obawiać się - خشي
oba - كلا ,كلتا
obchodzić - احتفل دار
obciążać - صعب ,حمل
obcinać - قص
obcy - غريب ,عجمي
obecność - حضور وجود
obecny - حاضر, موجود
obelisk - مسلة
obezwładniać - عجز
obfity - وافر ,وفير ,زمزم
obiecujący - واعد
obiecywać - وعد
obiekcja - ممانعة
obieranie - قشر
obietnica - وعد
objaśniać - نور, بسط, فسر
objaw - عرض
objętość - حجم
obłęd - هوس
oblężenie - حصار
obliczać - عد ,حسب, عید
obliczanie - عید
obłuda - دهان
obłudnik - مداهن
obojczyk - ترقوة
obok - بجانب
obowiązek - واجب
obowiązkowy - إلزامي ,إجباري
obóz - معسكر
obracać - قلب, دور, أدار
obracanie - إدارة
obrażać - إهان
obraza - إهانة , سب ,إثم ,عادية ,إستياء
obraźliwy - مقرف, مهين
obraz - صورة
obrona - دفاع
obrońca - حام
obronny - دفاعي
obrót - دور
obroża - طوق
obrus - شرشف ,مفرش
obrzezanie - ختان
obrzydliwy - مقرف
obsceniczność - بذاءة , قذارة , فاحشة , سفالة , فحش , رفث
obserwować - شاهد ,رصد ,تفرج ,راقب ,نظر
obsługa - خدمة
obszar - منطقة
obwód - محيط ; دائرة
obywatelski - مدني
obywatelstwo - ‎جنسية , مواطنة
obywatel - مواطن
Ocean Arktyczny - المحيط المتجمد الشمالي ,المحيط الشمالي
Ocean Atlantycki - المحيط الأطلسي
Oceania - أوقيانوسيا
Ocean Indyjski - المحيط الهندي
oceanografia - علم المحيطات
Ocean Południowy - المحيط المتجمد الجنوبي
Ocean Spokojny - المحيط الهادي
ocean - محيط
ocena - تقييم
oceniać - نظر
ocet - خل, حمض
ochota - رغبة
ochrona - أمان
och - يا
octan - خلات
o czasie - في حينه
oczekiwać - نظر
oczekiwanie - أمل انتظار
oczyszczać - خلص ,نظف ,زكى
oczywiście - طبعا
oczywisty - بديهي, بين ,ظاهر
odbicie - عكس
odbierać - إستلم
odbyt - شرج
odchodzić - ذهب ,مضى ,غادر ,راح
odcinek - مقطع
odcisk palca - بصمة الإصبع
odcisk - بصم
odczuwać - حس
odczuwanie - حس
oddanie - إخلاص
oddawać - أعاد ,أرجع
oddech - نفس
oddychać - تنفس ,نفس
oddychanie - تنفس
oddziaływanie - نفوذ
oddział - دائرة
oddzielać - فرق
odkąd - منذ
odkrywać - وجد, اكتشف, استكشف
odległy - قصي ,شاسع ,بعيد
odmawiać - أبى
odmiana - تشكيلة
odpad - سقط
odpoczywać - إستراح
odporność - صلادة
odpowiadać - أجاب
odpowiedni - موافق
odpowiedzialność - عهدة , مسؤولية
odpowiedzialny - مطالب, مسؤول
odpowiedź - رد ,جواب ,إجابة ,مجاوبة
odrobina - لزب
odrodzenie - نهضة , تناسخ ,بعث, أحياء
odsetka - فائدة
odwaga - نجدة ,شجاعة, تجاسر, جسارة
odważny - شجاع, جسور, جريء
odwieczny - دهري
odwiedzać - وفد, زار
odwracać - قلب
Odyseusz - أوديسيوس
odzież - ملابس
od - من
oferować - قدم ,عرض, اقترح
ofiara - فريسة ,قتيل ,مصاب , ضحية ; قربان
oficer - ضابط
oficjalnie - رسميا
oficjalny - رسمي
ogień - نار
ogólnie - على العموم
ogon - ذنب, ذيل
ogórek - خيار
ogórek - خيار
ograniczony - محدود
ogrodzenie - سور
ogród - حديقة , جنينة , بستان
ogromny - كبير, ضخم, هائل, جسيم, جبار, طائل
ohyda - رجس
ojciec - أب , والد
ojcostwo - أبوة
ojczyzna - وطن
okapi - أكاب
okazja - '''' أوكازيون
okno - نافذة ,شباك ,كوة
około - نحو
oko - عين
okrągły - مستدير ,مدور
okrąg - دائرة
okra - بامية
okręg - دائرة
określać - عين ,حدد
określony - منصوص
okresowy - دوري
okres - زمن ,عصر ,حقبة
okręt - سفينة
okrucieństwo - شناعة , وحشية
okrycie - حجاب ,جلباب
Oksford - أكسفورد
oksymoron - تناقض لفظي
okulary przeciwsłoneczne - نظارات شمسية
okulary - نظارة
okupacja - تبوؤ, إحتلال
oleisty - مدهن
olejek eteryczny - زيت عطري
olejek - عطر
olej - زيت
olimpijski - أولمبي
Olimp - جبل أوليمبوس
oliwa - زيتون, زيت زيتون
oliwka - زيتون
oliwkowy - زيتي
ołówek - قلم رصاص
ołów - رصاص
Oman - عمان, سلطنة عمان
Omar - عمر
omega - أوميغا
omikron - أوميكرون
omlet - عجة البيض
ona - هي
one - هن
oni - هم
ontologia - أنتولوجيا, علم الوجود
ontologiczny - أنتولوجي
on - هُوَ
opakowanie - علبة , عبوة
opalenizna - سمرة
opal - أوبال
opat - رئيس الدير
operacja - عمل جراحة
operacyjny - جراحي
opera - دار أوبرا أوبرا
opieka - وصاية , عهدة
opiekować się - نظر ,اعتنى
opiekun - راع ,مهيمن ,حافظ
opieszałość - قصر
opieszały - متلكئ
opinia - رأي
opisywać - صور
opium - أفيون
opłakiwać - ندب
oponować - ضاد, عارض
opornik - مقاوم
oportunista - نفعي
opór - مقاومة
opowieść - قصة , حكاية
oprócz - غير ,ما عدا, سوى
oprogramowanie - برمجية , برمجيات
optymalny - الأحسن، أفضل، أمثل
optymistyczny - متفائل, تفاؤلي
optymizm - تفاؤل
opuszczać - ترك
oralny - فموي
orangutan - إنسان الغاب ,أورانغوتان
Oran - وهران
orbita - مدار , فلك
oregano - مردكوش
organiczny - عضوي
Organizacja Narodów Zjednoczonych - الأمم المتحدة
organizacja - تنظيم منظمة, حركة ,مؤسسة
organizm - نظام, متعضية
organ - عضو
orgazm - هزة الجماع ,ذروة الجماع
Orient - شرق
origami - أوريغامي
orkiestra - أوركسترا
Ormianin - أرميني
ormiański - أرمنية أرمني
Ormuz - مضيق هرمز ,هرمز
ornament - زينة , حلية , زخرفة
ornitologia - علم الطيور
ortodoksyjny - ‎أرثوذكسي
orzech - بندقة, جوز
orzeł - نسر ,عقاب
osadnik - مستوطن
osądzić - نظر
osąd - حكم
Osaka - أوساكا
osa - دبور
ość - شوكة
osiągać - أنجز ,أتم ,إكتسب, بلغ
osiągnięcie - حيازة
osiołek - عفو
osioł - حمار
oskarżać - اتهم
oskarżony - متهم
oślica - أتان
osłona - جنة , ستر
Oslo - أوسلو
osmański - عثماني
ośmiornica - أخطبوط
osoba - شخص ,نفس
osobiście - بصفة شخصية
osobisty - شخصي
ostateczny - نهائي, آخر
Ostatnia Wieczerza - العشاء الأخير
ostatnio - حديثا
ostatni - آخر ,أخير
ostentacyjny - متفاخر، متباه، مفاخر
osteoporoza - تخلخل العظم
ostrosłup - هرم
ostrożny - ورع
ostry - حار
ostrzegać - حذر ,أنذر
ostrzeżenie - حذر ,تحذير
ostrze - شفرة , نصل
ostrzyć - سن
oświadczać - بين, صرح, أعلن, جهر
oszukiwać - غر
oszustwo - غش ,خديعة ; نصب
oszust - دجال ,مختلق
oś - مدار , محور ; قطب ; جزع
otaczać - طوق, حف; '''' جدر, سور
otoczenie - بيئة
otrzymywać - تلقى, حصل
Ottawa - أوتوا , أوتاوا
otwarcie - جهرا ,علنا
otwarty - مفتوح
otwieracz - فتاحة
otwierać - فتح ,فك
otworzyć - فرج
otwór - فم نفذ, فرج
otyłość - سمنة , بدانة
otyły - ‎سمين
owad - حشرة
owca - خروف, غنم, نعجة
Owernia - أوفرن
owieczka - حمل
owocny - مريع, خصب ,مخصب
owoc - فاكهة , ثمرة , ثمر ; ثمرة , جنى
ozdabiać - زخرف ,حسن, جمل, زين
oznaczać - قصد
ozon - أوزون
o - حول يا
pacha - إبط
pachnący - عطر, عطري, ذكي, أرج, زكي, شذي, فواح, معطر, عابق, عبق, عاطر
pachnieć - عطر, تشمم, إشتم
pacjent - مريض
paczka - علبة , عبوة
padać - أمطر
Padwa - بادوفا
pająk - عنكبوت
pajęczyna - نسيج العنكبوت
Pakistańczyk - باكستاني
pakistański - باكستاني
Pakistan - باكستان
pakować - يحزم
palący - مدخن
palacz - مدخن, '''' حشاش
pałac - قصر
Palau - بالاو
palec - إصبع
palenie - احتراق ; تدخين
paleolit - عصر حجري قديم
Palermo - باليرمو
Palestyna - فلسطين
Palestyńczyk - فلسطيني
Palestynka - فلسطينية
palestyński - فلسطيني
palić - دخن
palindrom - واروخوانه
paliwo - وقود ,محروقات
pallad - بالاديوم
palma - نخلة
pamięć - ذكر, ذاكرة
pamiętać - ذكر
Panama - بنما
panarabizm - وحدة عربية
panda - دب صيني ,باندا ;باندا أحمر
pani - آنسة ربة
panna młoda - عروس ,عروسة
panna - آنسة
Panna - برج العذراء
panorama - مشهد, بانوراما
panowanie - ملك, سيطرة
państwo - بلد , دولة , ولاية
pantera śnieżna - نمر الثلوج
Pan - الرب ; بان ; سيد
pan - رب
papieros - سيجارة
papier - ورق, قرطاس
papieski - بابوي
papież - بابا
papirus - فافير ,بردي, ورق البردي ;
paplanina - لغو ,ثرثرة
papryka - فليفلة
Papua-Nowa Gwinea - بابوا غينيا الجديدة
papuga - ببغاء
parabola - قطع مكافئ
parafianin - أبرشي|الأبرشي
Paragwaj - باراغواي
paralelny - مواز
paraliż - شلل ,شل
Paramaribo - باراماريبو
parasol - مظلة ; شمسية
para - بخار
parkować - أوقف
park - منتزه
parlamentarny - برلماني
parlament - برلمان
parowanie - تبخر
partia polityczna - حزب سياسي
partia - حزب
partner - عاشق '''', شريك ,قسيم ,مشترك ; زميل
partykuła - أداة ,حرف
paryski - باريسي
Parys - باريس
paryżanin - باريسي
Paryż - باريس
pasek - حزام
pasja - حمية
pasować - طابق ,ناسب
pasta do zębów - معجون أسنان
pastel - باستيل
pasterz - راع
pasticjo - مكرونة باشميل
pastor - قس
pastwisko - مرعى
pasza - علف باشا
paszport - جواز سفر
paszto - بشتوية
pasztuński - بشتوي
patetyczny - أبهي, طنان
patio - فناء
patologiczny - باثولوجي
patriarcha - بطريرك
patriotyzm - وطنية
patrzeć - نظر
patyk - عود
pawian - بابون
październik - أكتوبر , تشرين الأول
paznokieć - ظفر
pchła - برغوث
pechowy - منحوس
pedagogika - تربية
pederasta - لوطي
pederastia - لواط
pedofilia - غلمانية
pędzić - عجل
pęd - زخم ; زخم , زخم الحركة
pejoratywny - تحقير, منتقص, إنتقاصي
Pekin - بكين
pełen - ممتلئ ,عامر
pelikan - بجع
pełnia - بدر
pełny - كامل ممتلئ ,تمام
Pendżabczyk - بنجابي, بنجاب
pendżabski - لغة بنجابية ;بنجابي
penis - قضيب ,ذكر, زب
pensja - معاش ,راتب
pępek - سرة
perfekcja - كمال, تمام
perła - جمانة , لؤلؤة , درة
Perseusz - بيرسيوس
Persja - فارس
perski - إيراني, فارسي, عجمي
perswazja - إقناع
peruka - شعر ,باروكة
Peru - بيرو;
peso - بيزو
pesymistyczny - متشائم
pesymizm - تشاؤم
Petersburg - بطرسبرغ ,سانت بطرسبرغ
pewien - أكيد, جازم, متأكد ,محقق, مؤمن
pewnie - ربما
pewnik - بديهية
pewność - يقين , اطمئنان
piać - زقا
piasek - رمل
piaszczysty - رملي
piąta kolumna - الطابور الخامس
piątek - الجمعة
picie - شرب ; مشروب, شراب
pić - شرب
piechota - مشاة
pieczęć - طابع
pieczywo - ‎عيش
piec - شوى تنور
piekarnia - نانوایی
piekarz - خباز
piekło - جحيم ,جهنم, سقر
piękno - روعة, جمال, حسن, زهرة
piękny - جميل ,وسيم ,صبيح
pielęgniarka - ممرضة
pielęgniarz - ممرض
pielgrzymka - حجة , حج
Piemont - بييمونتي
pieniądze - نقود ,فلوس ,مال
pień - جذع
pieprzyć - نكح فلفل
pieprz - فلفل
pierścień - حلقة , طوق, هالة
pierścionek - خاتم ,حلقة
pierś - ثدي
pierwiastek - عنصر ,عنصر كيميائي
pierwsza dama - سيدة أولى
pierwsza wojna światowa - الحرب العالمية الأولى
pieśń - نشيد
pies obronny - كلب حراسة
pies pasterski - كلب الرعاة
pies policyjny - كلب الشرطة ,كلب بوليسي
pies stróżujący - كلب حراسة
pieszy - ماش
pies - كلب
pięta - عقب
piętro - طابق, دور
pietruszka - بقدونس
pigułka - حبة
pigwa - سفرجل
pijak - شراب
pijany - سكران
Pikardia - بيكاردي
piksel - بكسل
piła - منشار
piłka nożna - كرة القدم
piłka ręczna - كرة اليد
piłka - كرة
pilot - طيار
pingwin - بطريق
pionowy - عمودي, رأسي ,شاقولي
pióro - قلم ريش, ريشة
piorun - برق
piosenkarz - منشد
piosenka - أغنية
piramidalny - هرمي
piramida - هرم
Pireneje - البرانس ,البيريني ,البرينيو
pisać - كتب, ‎حبر
pisarka - كاتبة , مؤلفة
pisarz - كاتب ,مؤلف ,أديب
piskliwy - حاد
pismo - خط, كتابة
pistacja - فستق
pistolet - مسدس
piwo - بيرة ,جعة
piżama - منامة
Pizydia - بيسيديا
pizza - بيتزا
pizzeria - مطعم بيتزا
płaca - أجر
płacić - دفع ,سدد ,وفى
płacz - بكاء, بكى
plac - ميدان
plądrować - انتهب
płakać - بكى, دمع
plakat - ملصق
planetarium - بلانتاريوم
planetarny - فلكي
planeta - كوكب, كوكب سيار
planować - استهدف وضع
planowanie - تصميم
plan - مخطط
plaster - شهد ;شريحة
plastikowy - بلاستيكي
plastik - بلاستيك
płaszcz - معطف
płatność - دفعة , دفع
Platon - ‎أفلاطون
platyna - بلاتين
plaża - ساحل, شاطئ
plazma - بلازما , هيولى
płciowy - جنسي, تناسلي
plecy - ظهر
płeć - جنس
plemię - عشيرة ,قبيلة
plemnik - حيوان منوي
pleść - جدل
płetwa - زعنفة
płomień - شعلة , لهب
plon - حصد, جنى ; جنى
plotka - ثرثرة , شائعة
plucie - بصق
płuco - رئة ,سحر
pluć - بصق
pług - محراث
pluskwa - بق
Pluton - بلوتو
pluton - ‎فصيلة بلوتونيوم
płynąć - جرى
płynny - سائِل ;سائل
płyn - مائع
płyta główna - لوحة أم
płyta kompaktowa - قرص مضغوط
pływać - سبح
pływak - سابح
pływanie - سباحة
pobożny - متدين ,ورع
pobyt - إقامة
pocałunek - قبلة, تقبيل
pocenie - تعرق ,رشيح ,رجيع
pochłanianie - امتصاص
pochodnia - شعلة , مشعل
pochodzenie - عرق ,أصل ,نسب
pochodzić - إستمد
pochwa - قراب مهبل , غمد الخنجر , غمد
pociąg - قطار
pocić się - عرق
pociecha - تأسية
pocieszać - عزى
pocisk - رصاص , رصاصة
początek - بدء ,بداية ,رأس ,صدر, ابتداء
początkowo - أصلا ,في الأصل
poczekalnia - غرفة الانتظار
poczęstunek - أكلة
poczta - مكتب البريد ; ‎بريد
podatek - ضريبة , خرج
podatnik - مكلف ,دافع الضريبة
podążać - ''podążać za:'' أثر
podbój - فتح
podburzać - ألب
podczas gdy - حينما بينما
podczas - خلال ,أثناء ,طوال
poddać - تنازل
podejrzany - مشتبه ;مشتبه
podejrzewać - إشتبه ,ظن
podeszwa - نعل
Podgorica - بودغوريتشا
podium - دكة
podkowa - نعل
podłoga - أرضية
podłość - رداءة , حقارة
podłużny - مستطيل
podły - مهين ,رديء ,نذل
podmuch - هبة
podniebienie - حنك
podniebienny - حنكي
podnosić - ارتفع, رفع
podnoszenie - رفع
podobać się - راق
podobieństwo - شبه
podobnie - كذلك
podobny - مطابق ,مماثل ,طبق ,مثل ,نظر, شبه
podpis - إمضاء, توقيع, كراس
podpora - دعامة
podróżnik - مسافر, رحال
podróżować - جاب ,سافر ,إرتحل ,طاف ,جال ,تجول ,ساح ,أطاف ,تطوف
podróż - رحلة
podrywać - غازل
podrywanie - مغازلة
podstawa - قاعدة, أساس, أصل
podstawowy - أولي ,عنصري ,أساسي
podstęp - خدعة , حيلة
poduszka powietrzna - وسادة هوائية
poduszka - وسادة
podwładny - تابع
podwójny standard - معايير مزدوجة
podwójny - مزدوج
podwórze - ساحة , فناء ,صحن
podwyżka - رفع راتب
podział - بين, تقسيم
podziękowanie - شكر
podziemny - تحت أرضي ,باطني ,جوفي
podziwiać - أعجب, عجب
podziw - إعجاب
poeta - شاعر
poetka - شاعرة
poetycki - شعري, شاعري
poezja - شعر ,أشعار
pogański - كافر, وثني
pogarda - أنفة
pogardliwy - مهين
pogląd - رأي
pogoda - جو ,طقس أون
pogodny - بشوش
pogrzeb - جنازة , جناز
pojawiać się - صدر ,ظهر
pojawienie - ظهور
pojazd - مركبة , عربة
pojedynczy - مفرد ,أحد ,منفرد ,وحداني
pojemnik - صندوق ,حق
pójść - ذهب
pojutrze - بعد غد
pokarm - غذاء
pokazywać - أرى ,دل, عرض, أظهر, كشف
pokaz - عرض
poker - بوكر
pokład - متن
pokój - غرفة ;سلم ,صلح سلام , حجرة , مخدع
pokolenie - ذرية
połączenie - وصل ,ترابط
Polak - بولندي
pole bitwy - ساحة
polecać - ‎أمر
polegać - اعتمد
polemika - جدل
pole - حقل
poliandria - تعدد الأزواج
policjant - شرطي
policja - شرطة, بوليس
policzek - خد
poligamia - تعدد الزوجات
poligynia - تعدد الزوجات
Polinezja Francuska - بولينزيا الفرنسية
Polinezja - بولينزيا
polityczny - سياسي
polityka - سياسة
polityk - سياسي
Polka - بولندية
półka - رف
północny - شمالي
północ - منتصف الليل , ; شمال
połóg - تال للولادة, ما بعد الولادة
polon - بولونيوم
polować - صاد ,قنص
polowanie - صيد, قنص
połowa - نصف ,شقة
położenie - وضع , موقع ; حالة , حال
położyć - '''' نوم
polo - بولو
Polska - بولندا, بولونيا;
polski - بولندي
polucja - احتلام
południe - جنوب
południowy - جنوبي
Półwysep Arabski - شبه الجزيرة العربية ,جزيرة العرب
Półwysep Bałkański - البلقان
półwysep - شبه جزيرة
połysk - لمع
pół - نصف
pomagać - ناصر, ساعد
pomarańcza - برتقال
pomarańczowy - برتقال ,برتقالي
pomiar - مقياس
pomidor - طماطم, بندورة
pomieszczenie - غرفة
pomijać - ترك
pomnik - تمثال
pomocnik - ظهير, مساعد, معاون
pomoc - مساعدة ,نجدة ,إعانة ,مظاهرة ,معونة ,عون ,مدد, معاونة
pomyłka - لغو ,خطأ
pomyślność - نجاح
pomysł - فكرة
ponad - فوق
pończocha - شراب ,جورب
poniedziałek - الإثنين
ponieważ - لأن, بسبب ,بسبب من
poniżej - تحت
ponury - مشؤوم, أسيان
popielaty - رمادي
popielniczka - منفضة
popierać - ضلع, عزز
popiół - رماد
popołudnie - بعد الظهر ,ظهر ,عصر
poprawiać - أصلح ,صحح
poprawny - صحيح, سليم
poprzednio - سابقا
poprzedni - سابق
poprzedzać - سبق ,سلف
poprzez - بين، عبر، خلال، بواسطة
popularny - شعبي ,شائع ,مبسط
populizm - شعبوية
pop - بوب
pora roku - فصل, فصول السنة
pora - وقت
porcja - حصة
poród - وضع ,ولادة
poronienie - سقط ,إجهاض
porównanie - نظر
porównywać - نظر
portfel - محفظة
portier - بواب
Portoryko - بورتوريكو, بورتو ريكو
portret - بورتريه
Portugalczyk - برتغالي
Portugalia - البرتغال
Portugalka - برتغالية
portugalski - برتغالي
port - إسكلة ,ميناء ,مرفأ, بندر, مرسى
poruszać - تحرك
poruszenie - جأش ,إثارة
porywczy - عجول
porządek - نظام
porządny - محترم، مرض، محتشم، مهذب
porzucać - ترك, نزل
por - كراث
posiadanie - حيازة
posiłek - أكلة , وجبة
pośladek - ردف
posłaniec - مرسال
posolić - ملح
pośpiech - عجل, غرار
pośpieszać - هرع
pospolity - عام
postanowienie - قرار
postawa - وضع
postępowanie - مأخذ
postęp - تقدم
postrzegać - عد
postulat - مطالبة
post - صوم, صيام
poświęcać - قرب ,إستمات
poświęcenie - قربان
poszerzanie - بسط
potas - بوتاسيوم
potęga - حيل, عزة
potem - فيما بعد
potencjalny - جهدي, كامن
potępiać - قبح ,أدان ,لعن
potężny - كبير قوي, جبار ,ضخم, عظيم
potoczny - غيرفصيح
potok - سيل
potomek - ابن ,خلف ,ولد ,عقب
potomstwo - نسل
potrafić - استطاع
potrzeba - ضرورة ; حاجة
potrzebny - ضروري
potrzebować - احتاج إلى
potwierdzić - أكد, ثبت
potwór - وحش
pot - عرق
pouczać - نور ,نصح ,أنذر ,حذر ,عاتب
poważanie - حرمة
poważnie - بجدية
poważny - حرج ;جدي
powieka - جفن العين, جفن
powiększać - ضخم, زاد
powiernik - أمين
powierzchnia - سطح ,ظاهر
powiesić - شنق
powieszenie - شنق
powietrze - هواء
powodować - سبب
powodzenia - حظا أوفر
powodzenie - حظ, ‎فلاح ,يمن
powódź - فيضان ,طوفان ,سيل
powód - سبب
powoli - ببطء
powolny - بطيء
powrót - رد, عودة ,عودة ,أوب, رجع
powstanie - ثورة
powszechny - شائع عمومي ,عام
powtarzać - كرر ,أعاد
pożądać - اشتهى ,بغى
pożądanie - شهوة, عشق
pozarządowy - غير حكومي
pożar - حريق ,لهيب
poza - وضع
pozbawiać - حرم ,جرد
pozdrowienie - تحية ,سلام
pożegnać - ودع
poziom morza - سطح البحر
poziom - سطح ,مستوى
Poznań - بوزنان
później - لاحقا
późno - متأخرا
późny - متأخر
pozostałość - أثر ,بقية
pozostawać - فضل مكث
pozostawanie - مكث
pozwalać - أذن, سمح
pozycja - مكان, موقع وضع
pożyczać - أعار استعار
pożytek - فائدة , نفع
po - بعد أثر, تلو, عقب
prababcia - جدة الجدة
praca - فعل, عمل
prącie - قضيب
pracować - عمل
pracowity - مجتهد
pracownia - معمل
pracownica - موظفة
pracownik - عامل ,موظف ,مستخدم
praczka - غسالة
prać - غسل
prąd - تيار
Praga - براغ
pragmatyk - براغماتي
pragnąć - رغب ,أراد
pragnienie - أوار ,عطش ; شهوة , رغبة , بغية , ود
pralka - غسالة
pranie - مغسلة ; غسيل
prasować - كوى
prawa człowieka - حقوق الإنسان
prawa zwierząt - حقوق الحيوان
prawda - حقيقة, حق
prawdopodobnie - من المحتمل ,ربما ,على الأرجح
prawdziwy - صحيح, حقيقي, أصلي
prawica - ميمنة ; يمينية ;يمين
prawie - تقريبا
prawnik - عالم قانوني
prawo jazdy - رخصة قيادة
prawowitość - قانونية
prawo - حق; قانون
prazeodym - براسيوديميوم
prażyć - حمص
precyzja - تمكن ,دقة ,ضبط ,إحكام
precyzyjny - دقيق
predestynacja - قدر ,التحتيم ,جبر
prędkość - سرعة
preferować - فضل
prefiks - بادئة
premedytacja - تصميم
pretekst - حجة ,ستار
prezentacja - عرض تقديمي
prezentować - قدم, عرض
prezent - هدية ,منحة ,هبة ,عطية, حلوان
prezerwatywa - عازل ذكري ,واق ذكري
prezydent - رئيس
Priam - بريام
priorytet - أولية
próba - تجربة
problem - مشكلة
próbować - جرب dżarraba, حاول hawala; تذوق
procent - نسبة مئوية
procesor - وحدة المعالجة المركزية
proces - عملية ; محاكمة
proch strzelniczy - بارود
proch - رماد
producent - منتج
produkcja - إنتاج
produkt - منتج
profesor - أستاذ
profit - ربح ,مكسب , جداء , عائدة ,غنيمة ,فائدة ,منفعة
programowanie - برمجة
program - مصطلح ; برنامج
projekt - مشروع ,تصميم, خطة
prokurator - وكيل نيابة
promet - بروميثيوم
promień - شعاع
promować - نشر
prom - سفينة عبارة
propan - بروبان
proponować - إقترح, عرض
proporcja - نسبة
propozycja - إقتراح ,عرض
proroczy - نبوي
prorok - نبي , رسول
prośba - طلب
prosić - طلب talaba
proso - دخن
prosperować - نما
prosta - خط
prostokątny - مستطيل
prostokąt - مستطيل
prostytucja - دعارة, عهر
prostytutka - بنت الهوى, بائعة الهوى, زانية, مومسة, عاهرة, مومس, بغي
prosty - بسيط ;ساذج ;سهل ,خالص
proszek - مسحوق
proszę - من فضلك ; تفضل tafaddal
protaktyn - بروتكتينيوم
protekcjonizm - حمائية
protestancki - ‎بروتستانتي
protestantyzm - بروتستانتية
protestant - ‎بروتستانتي
protestować - احتج
protest - احتجاج
protokół - معاهدة
proton - بروتون
prowadzenie - قيادة
prowadzić - رشد&amp;lrm; قام, أدار
prowincja - محافظة ,إقليم
prowokacja - استفزاز|إستفزاز , إثارة
prowokacyjny - إستفزازي
prowokować - إستفز
prowokowanie - تحرش
próżnia - فراغ
próżność - مباهاة
Prusy - بروسيا
pryskać - نضح, رش, ذر, بخ, نثر
prysznic - دوش
prywatnie - بصورة شخصية
prywatny - خاص ,شخصي
przebaczenie - غفران ,مسامحة
przeceniać - خصم
przeciągać - أجل سحب
przeciętny - أوزون, أوسط
przecinek - فاصلة
przeciwciało - جسم مضاد
przeciwgorączkowy - مضاد للحمى, مقاوم للحمى
przeciwieństwo - نقيض ,معاكسة
przeciwnie - بالعكس
przeciwnik - عدو ,معارض
przeciwny - معارض نقيض, مضاد
przeciwstawiać - ناهض
przeciw - ضد
przedmieście - ضاحية
przedmiot - آلة , شيء
przedmuzułmański - جاهلي
przedstawiciel - نائب ,ممثل ,وكيل
przedszkole - روضة أطفال , روضة
przedwczesny - خديج
przędza - خيط
przed - قبل أمام, قدام
przejrzysty - صاف ,واضح, شفاف ,صفي
przejście - مرور
przejść - تمشى
przekąska - لهجة
przekaźnik - مذياع
przekazywać - أثر سلم
przekleństwo - لعنة , شتيمة
przekonanie - اعتقاد
przekonywać - أقنع
przełęcz - شعب, فج
przełożenie - تأخير
przeludnienie - انفجار سكاني
przemieszczać - نقل
przemoc - عنف, عنوة
przemysłowy - صناعي
przemysł - صناعة
przemytnik - مهرب
przemywać - غسل
przenikliwy - حاد
przenosić - انتقل نقل ,أقل
przenośnie - مجازيا
przenośny - مجازي نقال
przepaść - هوة
przepis - وصفة
przepraszać - اعتذر, عفوا afwan, آسف asif, متأسف muta'assif
przepraszam - عفوا
przeprowadzka - انتقال
przerwa - إستراحة
przerywać - وقف
przesadzać - غالى, ضخم, بالغ
prześcieradło - شرشف
prześladowanie - إضطهاد
przesmyk - برزخ
przestankowy - متقطع
przestarzały - مهجور ,متروك
przestawać - كف ,وقف
przestępca - مجرم
przestępczość - إجرام
przestępczy - مجرم
przestępstwo - جريمة, جرم
przestraszyć - يخوّف
przestrzegać - أطاع أخطر, حذر, نبه, أنذر
przestrzeń - فضاء
przesuwać - نقل
przeszkadzać - أزعج
przeszkoda - زاجر ,سد ,عقبة, حرج
przeszłość - ماض
przeszły - ماض
przetrwanie - عيش
przewinienie - حرج
przewodnik - هادي
przewodzić - رأس
przewracać - كبا
przewyższać - فضل
przeziębienie - زكام ,رشح
przeznaczenie - قدر, نهاية, مصير
przezroczysty - شفاف
przez - أثر عبر
przodek - جد ,سلف
przybijać - خبط طرق
przybity - مكتئب
przybywać - جاء ,قدم ,وصل
przychodzić - قدم ,أتى, حضر
przyczyna - سبب ,أصل ,أجل
przydatność - نفع
przydatny - نافع ,مفيد
przydawka - بدل
przygnębiać - ثبط, إياس, غم
przygotowywać - جهز, حضر
przyimek - حرف جر
przyjaciel - صديق, حميم خليل
przyjaciółka - صديقة ; خليلة
przyjaźnić się - تصاحب ,صادق
przyjazny - ودود ,حبي
przyjaźń - صداقة , خلة , صحبة
przyjęcie - حفلة , مأدبة
przyjemność - متعة ,تلذذ ,ملذة ,لذة ,إمتاع ,تمتع ,إستمتاع ,طرب ,لذاذة ,هناء, طيب
przyjemny - مبهج
przyjmować - رحب
przykład - مثال
przymiotnik - نعت, صفة
przynajmniej - على الأقل
przynosić - در أحضر
przypadek - حالة , صدفة , مصادفة , إتفاق
przypisać - عين
przypisywać - نسب
przypominać - مثل ذكر
przyprawa - تابل، بهار
przyprawiać - طيب
przypuszczać - ظن ,حسب
przyroda - طبيعة
przyrostek - لاحقة
przysadka mózgowa - غدة نخامية
przysięgać - أقسم
przysięganie - حلف
przysięga - قسم, يمين
przysłówek - ظرف
przysłowie - مثل
przysługa - معروف
przyśpieszać - تسارع
przyśpieszenie - تسارع
przystawka - مقبلات
przystojny - وسيم, زين
przyszłość - مستقبل
przytulić - احتضن
przywiązywać - تعلق ربط
przywódca - هادي ,رئيس ,قائد
przyznanie - اعتراف
przyzwoity - كريم, محترم ,محتشم
pseudonauka - علوم زائفة
psi - كلبي
pstrąg - سلمون مرقط
psychiczny - نفسي ,نفس
psychologia - علم النفس , سيكولوجيا
psychologiczny - سيكولوجي
psycholog - عالم النفس
pszczoła - نحلة
pszenica - قمح, حنطة
ptak - طائر, طير
ptasia grypa - ‎إنفلونزا الطيور
publiczność - جمهور
publiczny - عام, عمومي
publikacja - نشر, منشور
pudełko - صندوق ,علبة
pudło - علبة
pukać - دق
pukanie - دق ,خبط
pułapka - فخ
pulpit - سطح المكتب
punkt - نقطة
pustoszyć - حطم, دمر, خرب, عاث
pustynia - صحراء
pustynny - صحراوي
pusty - فارغ ,أبيض ,خال
puszka - علبة
pycha - مباهاة , عجب ,زهو
pył - تراب
pyszny - لذيذ
pytać - استنبأ, سأل ,تساءل, ساءل
pytanie - سؤال ,استفهام, تساؤل
rabarbar - راوند
Rabat - الرباط
rabować - نهب ,انتهب
rachatłukum - حلقوم , راحة حلقوم
Rachela - راحيل
rada - وصية ,مشورة ,نصيحة
radioodbiornik - مذياع
radio - راديو
radon - رادون
radość - سعادة , فرح ,بشر ,مرح ,سرور
radosny - فرحان ,بشوش ,فرح
radzić - نصح
rad - راديوم
rafa koralowa - شعاب مرجانية
rajstopy - جوارب نسائية
raj - جنة , فردوس
rakieta - صاروخ
rakietowy - صاروخي
Rak - برج السرطان
rak - سرطان
ramadan - رمضان
rama - إطار
ramię - ذراع
ramka - برواز
rana - جرح ,كلم
randka - تعيين
ranga - مقام
ranić - جرح ,آذى
rano - صباحا صباح
rap - راب
rasa - عرق, عنصر ,جنس
rasistowski - عنصري
rasizm - التمييز العرقي ,عنصرية
rasowy - جنسي, قومي
ratować - أنقذ
ratunek - إنقاذ ,تخليص
razem - معا ,سويا
raz - مرة
Ra - رع
rdza - صدأ
rdzeń - مركز, محور
reagować - تفاعل
reakcja - تفاعل
realizacja - تحقيق ,تنفيذ
realizować - حقق
rebeliancki - ثائر
recesja - كساد
ręcznie - يدويا
ręcznik - منشفة , فوطة , بشكير
ręczny - يدوي
redukcja - إنزال
refren - قرار
regał - خزانة , رف
reggae - ريغي
regionalny - إقليمي ,قطري
region - إقليم , ولاية
regularny - مطرد
reguła - مبدأ
regulować - نظم ساوى
reinkarnacja - تناسخ
rejestrator - مسجل
rejestr - دفتر
rejon - منطقة
rękawica - قفاز
rękaw - كم
ręka - يد
rekin - قرش
reklama - إِعْلان , إِيذان
reklamować - نشر
rekomendacja - التوصيه
rękopis - خط, مخطوطة
relacja - علاقة , صلة
religia - دين ,ديانة ,ترهب
religijny - ديني, متدين, تقي
renoma - صيت, سمعة
renowacja - تجديد
Ren - راين
ren - رينيوم
reprezentant - ممثل
Republika Czeska - الجمهورية التشيكية
Republika Macedonii - جمهورية مقدونيا
Republika Południowej Afryki - جمهورية جنوب أفريقيا ,جنوب أفريقيا
Republika Środkowoafrykańska - جمهورية أفريقيا الوسطى
Republika Zielonego Przylądka - الرأس الأخضر
republika - جمهورية
reputacja - اشتهار, صيت, سمعة
restauracja - مطعم
rewolucja francuska - الثورة الفرنسية
rewolucja - ثورة
rewolucjonista - ثائر
rewolucyjny - ثوري ,ثائر
rezerwacja - حجز
rezerwować - حجز
rezultat - أثر ,نتيجة, نهاية ,ثمر ,عقبول
rezydencja - منزل ,مقر
rezygnacja - ترك ,تنازل
reżyser - مخرج
riel - ريال
Rijad - الرياض
ring - حلبة
robak - دودة
robić - فعل
robienie - جعل
robotnik - عامل
robotyka - إنسالية
robot - روبوت ,إنسان آلي
rock - روك
rocznica - ذكرى ,يوبيل
roczny - سنوي
rodzaj - نوع, جنس, لون
rodzic - والد
rodzić - وضع ,ولد
rodzimy - بلدي
rodzina językowa - عائلة لغوية
rodzina - أسرة ,عائلة, أقارب ; فصيلة
rodzinny - عائلي
rodzynka - زبيب
ród - حسب
rod - روديوم
roentgen - رونتجينيوم
Róg Afryki - القرن الأفريقي
róg - زاوية ; قرن
rój - سرب
rok przestępny - سنة كبيسة
rok świetlny - سنة ضوئية
rok - عام , سنة
rola - دور
rolnictwo - زراعة
rolniczy - زراعي, ريفي
rolnik - ‎مزارع, ‎فلاح
romantyczny - رومانسي ,عاطفي ,غرامي
romski - رومنية رومني
ropa naftowa - نفط, بترول
ropa - قيح
ropień - خراج
ropociąg - خط أنابيب النفط
ropucha - علجوم
rosa - ندى
Rosjanin - روسي
Rosjanka - روسية
Rosja - روسيا
roślina - نبات
roślinność - نبات
roślinny - نباتي
rosnąć - كبر
rosyjski - روسي
rotacja - نوبة
rower - دراجة هوائية ,دراجة
również - أيضا, كذلك
równik - خط الاستواء
równina - سهل
równość - مساواة ; نصف ,إنصاف ,تساو ,تكافؤ
równowaga - توازن
równy - متساو, متكافئ
rów - خندق , أخدود
różany - وردي
Róża - وردة
róża - وردة , ورد
rozdrażnienie - غضب
rozdział - فصل, باب
rozdzielać - شعب&amp;lrm; باعد
rozdzielanie - تمييز
rozebrać - جرد
rozkład - نتانة
rozkoszować się - نعم
rozległy - شاسع
rozmach - دافع ,زخم دفعة
rozmawiać - تحدث ,كلم
rozmiar - قد
rozmowa - حديث, كلام, حوار, محادثة, تكلم, تحدث ,مخاطبة ,مكالمة
rozmyślać - تفكر
rozmyślanie - تفكر
różnica - فرق
różnić - اختلف
różnorodny - مختلف ,متنوع
różny - مختلف ,متنوع
różowy - وردي ,زهري
rozpacz - إياس
rozpoczynać - بدأ / بدا
rozprawa - محاكمة ; أطروحة
rozrodczy - مولد
rozrywka - لهو
rozsądny - عاقل ,متزن ,معقول ,حازم ,حصيف
rozśmieszać - أضحك
roztargniony - شارد الذهن
rozumieć - فهم ,عقل
rozumny - عاقل
rozum - عقل, رشد
rozważać - عد ,نظر
rozważanie - عد, عید
rozwiązanie - حل
rozwijać - تطور طور
rozwód - طلاق ,خلع
rozwój - نهضة , تطور, نمو
różyczka - حصبة ألمانية
ro - رو
rtęć - زئبق
rubel - روبل
rubid - روبيديوم
rubin - ياقوت
ruch - حركة , تحرك
rujnować - خرب, دمر, ثبر
Rumunia - رومانيا
Rumunka - رومانية
rumuński - روماني
Rumun - روماني
rum - رم
rura - مأسورة ,أنبوب ,قناة
rurociąg - خط أنابيب
ruszać - تحرك حرك
ruten - روثينيوم
rutherford - رذرفورديوم
rwa kulszowa - عرق النسا
Rwanda - رواندا
ryba - سمك , سمكة
rybitwa - خطاف البحر
Ryby - برج الحوت
rycerz - فارس
ryć - خط
Ryga - ريغا
ryj - خرطوم
rymarz - سراج
rynek - سوق
rysować - رسم, خط
rysunek - رسم
ryś - فهد
rytm - إيقاع
rytualny - شعائري
rywalizacja - مباراة , منافسة , تنافس , مزاحمة
ryzykować - إستمات ,جازف ,غامر ,جرؤ ,خاطر ,تجاسر
ryzyko - مجازفة , مخاطرة
ryż - أرز ,رز
rzadki - نادر
rzadkość - نادرة
rzadko - نادرا
rząd marionetkowy - حكومة عميلة
rządzić - ملك ,حكم, تحكم
rząd - حكومة , دولة ; صف
rzeczownik własny - اسم علم
rzeczownik - اسم
rzeczywiście - فعلا, في الواقع
rzeczywistość - واقع ,واقعية, حقيقة
rzeczywisty - حقيقي ,فعلي
rzecz - شيء
Rzeka Świętego Wawrzyńca - نهر سانت لورانس
rzeka - نهر
rzemieślnik - حرفي ,صانع
rzęsa - هدب, رمش
rzeżączka - سيلان
rzeźba - نحت ,تمثال
rzeźbiarz - نحات ,مثال
rzeźbienie - نحت
rzeź - مذبحة
rzodkiewka - فجل
rzucać perły przed wieprze - لا تطرحوا درركم قدام الخنازير
rzucać - رمى
rzut karny - ركلة جزاء
rzut rożny - ضربة زاوية
rzut - رمي, رمية
Rzymianin - روماني ; '''' الرومان , الروم
rzymski - روماني
Rzym - روما
Sabina - سبینا
sabotaż - تخريب
Sąd Ostateczny - يوم القيامة, ''w islamie'' الآخره
sądowy - قضائي
sądzić - إعتقد
sad - بستان
sąd - محكمة
Safakis - صفاقس
saga - أسطورة
Sahara Zachodnia - الصحراء الغربية
Sahara - الصحراء الكبرى
Saipan - سايبان
sakralny - مقدس
saksofon - ساكسفون
sałata - خس
sałatka - سلطة
sala - ‎قاعة , صالة
saldo - موازنة
Salomon - سليمان
Salwador - السلفادور
samar - ساماريوم
samba - سامبا
samica - أنثى
samiec - ذكر
Samoa Amerykańskie - ساموا الأمريكية
Samoa - ساموا
samobójstwo - انتحار
samochód - سيارة, أتوموبيل
samolot - طائرة
samotny - وحيد ,أحد ,موحش
Samson - شمشون
samum - سموم
sam - وحيد
Sana - صنعاء
sandałowiec - صندل
sandał - صندل
sanktuarium - مقام ,مقدس ,حرم
San Marino - سان مارينو
Santiago - سانتياغو
Saragossa - سرقسطة
Sarajewo - سراييفو
Sara - سارة
sardela - أنشوفة
Sardynia - سردينيا
sardynka - سردين
sarkastyczny - تهكمي, سخري
sarkazm - تهكم, سخرية
sąsiadować - جاور
sąsiad - جار
satelita - قمر
Saturn - زحل
satyna - اطلس
satysfakcja - غنى, رضاء, سد, قناعة
Saudyjczyk - سعودي
saudyjski - سعودي
Saul - طالوت
sauna - ساونا
scena - مسرح ;مشهد
schizofreniczny - فصامي
schody - سلم ,معرج ,درج
schronienie - معزل ,موئل ,جنة ,مأوى, ستر
schronisko - مأوى, نزل
ściągać - حمل
ściąganie - إنزال
ściana - حائط, جدار
ściany mają uszy - للحيطان آذان
ścięgno - وتر
ścierać - مسح
ścieranie - مسح
ścierka - خرقة
ścieżka - مسار ,خط
seaborg - سيبورجيوم
sędzia - قاض
segregacja rasowa - عزل عنصري
segregować - عزل
sejf - خزينة حديدية , خزينة
sekciarski - ملي ,طائفي
sekcja - دائرة
sekretariat - سكرتيرية , أمانة
sekretarka - سكرتيرة
sekretny - مخبأ, سري
seksapil - جاذبية الجنس
seks oralny - جنس فموي
seksturystyka - سياحة جنسية
seksualny - جنسي ,تناسلي
seksuologia - طب جنسي
seks - باه ,جنس
sekunda - ثانية
Sekwana - السين
selekcja - نخب ,إنتقاء
selen - سيلينيوم
seler - كرفس
semestr - فصل دراسي
semicki - سامي
Semita - سامي
Senegal - السنغال, سنغال
senny - ناعس ,نعسان ,وسن نومي
sens - معنى
sen zimowy - بيات شتوي
sen - نوم ,حلم ,نومة
separatysta - خارج
sęp - نسر
Serbia - صربيا
Serbka - صربية
serbski - صربي
Serb - صربي
serce - قلب ,فؤاد ; لب
serdecznie - من القلب
serdeczny - قلبي, ودود
seria - سلسلة ; تشكيلة
sernik - كعكة الجبن
seryjny - مسلسل
ser - جبن ,جبنة
Seszele - سيشيل
Seul - سيول
Sewilla - إشبيلية
sezam - سمسم
sezon - موسم
Sfederowane Stany Mikronezji - ولايات ميكرونيسيا المتحدة
sfera - كرة
siać - زرع ,نثر ,بذر
siadać - جلس
siano - حشيش
siara - لبأ
siarka - كبريت
siarkowodór - كبريتيد الهيدروجين
siatkówka - شبكية كرة طائرة
siebie - نفسه
sieć - شباك, شبكة ; شبكة
siedziba - مقر
siekiera - بلطة , فاس
sierpień - أغسطس , آب
Sierra Leone - سيراليون
sierść - وبر ,فرو
sigma - سيغما
sikać - تبول
sikhizm - سيخية
siła - قوة حيل
silnik turbośmigłowy - محرك مروحة عنفية
silnik - محرك, بابور
silny - قوي, جبار, حاد, شديد, مشدد
siłownia - جمنازيوم
Singapur - سنغافورة
sinus - جيب
siodło - سرج ,رحل
siostra - أخت
siostrzenica - ابنة الأخ
siwy - أشيب, شائب
skakać - طفر
skała - صخرة
skaleczenie - خدش
skandaliczny - شائن
skandal - فضح, فضيحة, بغي
Skandynawia - اسكندنافيا
skandynawski - إسكندنافي
skand - سكانديوم
skaner - ماسح ضوئي
skanować - مسح
skąpstwo - بخل
skąpy - بخيل
skarb - كنز
skarpeta - شراب ,جورب
składać - كون
składnik - مكون, مركب
sklep - دكان , محل , حانوت
skłonność - ميل
skłonny - متقبل
skoczek - جربوع
skok - قفزة
skomplikowany - صعب معقد, مركب
skończony - محطم
Skopje - سكوبيه
skóra - جلد
skórny - جلدي
Skorpion - برج العقرب
skorpion - عقرب
skory - متلهف
skórzany - جلدي
skrajna prawica - يمين متطرف
skrajny - بالغ, أقصى
skraj - حافة
skrępowany - حرج
skromny - بسيط متواضع
skroniowy - صدغي
skroń - صدغ
skrót - اختصار
skrucha - أسف ,ندم
skrzydło - جناح
skrzypce - كمان
skrzypek - عازف الكمان
skrzyp polny - كنباث الحقول
skrzyżowanie - تقاطع طرق
skunks - ظربان
skutecznie - بنجاح
skuteczny - فاعل ,فعال
słabo - بضعف
ślad - أثر, حبار
sława - سمعة
sławny - شهير, معروف ,مشهور
śledzić - أثر ,تبع ,تابع
śledziona - طحال
śledź - رنكة ,سمك مملح
ślepa uliczka - ردب زقاق
ślepy - أعمى ,ضرير
śliczny - جذاب
ślimak - حلزون, بزاق
ślina - رضاب ,بصاق ,لعاب, ريق
śliski - زلق
śliwa - برقوق
śliwka - خوخ, برقوق
słodki - حلو
słodkość - حلاوة , عذوبة
słodzić - سكر
słoma - تبن ,قش
Słońce - الشمس, شمس
słońce - شمس
słonecznik - عباد الشمس ,زهرة الشمس ,دوار الشمس
słoneczny - شمسي ,مشمس
słony - مملح ,مالح
słoń - فيل
Słowacja - سلوفاكيا
słowacki - سلوفاكي
Słowaczka - سلوفاكية
Słowak - سلوفاكي
Słowenia - سلوفينيا
słownik - قاموس , معجم
słowotwórstwo - صوغ الألفاظ
słowo - كلمة
ślub - زواج, زفاف
słuchać - أذن ; أصغى ,إستمع, استمع
słuch - سمع
słup - عمود
służący - فراش
służyć - نفع
śluz - مخاط
słychać - سمع
smacznego - بالهنا والشفا
smaczny - طيب
smakować - طعم, تذوق
smakowanie - تذوق
smak - طعم ; نكهة , مذاق
smartfon - هاتف ذكي
smażyć - شوى
smerf - Sanfūr سنفور, Sanāfur سنافر
śmiać się - ضحك
śmiech - ضحك
śmieciarz - زبال
śmieć - نفاية , نفايات , , ; جرؤ
śmierć - موت ,وفاة, أجل
śmiertelny - قتال, قاتل, مميت
śmieszny - مضحك
śmietana - قشدة
smok - تنين
smoła - قطران
smród - نتانة
SMS - رسالة اس ام اس
smutek - حزن, كآبة, أسى, حسرة, كمد, ترح, غم
smutny - حزين , محزن, أسيان, جزع
śniadanie - فطور, ترويقة
śnić - حلم
śnieg - ثلج
sobota - السبت , سبت
sobotni - سبتي
socjalista - اشتراكي
socjalistyczny - اشتراكي
socjalizm - اشتراكية
socjologia - علم الاجتماع
socjologiczny - اجتماعي
socjolog - اجتماعي
soczewica - عدس
soczysty - ريان
sód - صوديوم
sofa - أريكة , صفة
Sofia - صوفيا
soja - فول الصويا
sokolnik - صقار
sokół - صقر ,شاهين
Sokrates - سقراط
sok - عصير
solidarność - تضامن
solidny - قوي ,صلب
sól - ملح
Somalia - الصومال
Somalijczyk - صومالي
somalijski - صومالي
sonata - سوناتا
Sopot - سوبوت
sopran - سوبرانو
sosna - صنوبر
sos sojowy - صلصة الصويا
sos tatarski - صلصة التارتار
sos - صلصة
sowa śnieżna - بوم الثلج
sowa - بومة
spacerować - تمشى
spać - رقد
spadać - سقط
spadanie - إنزال, هبوط
spadek - ميراث ; تراجع
spadochron - باراشوت, مظلة, مظلة هبوط
spalić - حرق
spanie - نوم
Sparta - أسبارطة , أسبرطة
specjalista - خبير ,اختصاصي
specjalny - استثنائي خاص
specyficzny - خارق, خاص
spędzać - قضى
sperma - مني, نطفة
śpiący - ناعس, نعسان, وسن
śpieszyć - عجل, أسرع
śpiewać - غنى
śpiewak - شاعر
spinacz - مشبك
śpioch - نومة
spironolakton - سبيرونولاكتون
śpiwór - كيس النوم
splot - ضفيرة
spódnica - تنورة
spodnie - سروال, بنطلون, شروال
spodziewać się - يتوقع ,ينتظر ,توقع
spód - أسفل
spojrzenie - نظرة ,نظر
spokojny - هادئ
spokój - هدوء, أون, سكينة, سكون, اطمئنان
społeczeństwo - مجتمع
społeczność - مجتمع
społeczny - اجتماعي
spółka - شركة
spontanicznie - تلقائيا, بديهيا, عفويا, ارتجالا
sporny - خلافي
sportowiec - رياضي
sportowy - رياضي
sport - رياضة
spór - جدل ,خصومة
sposób - أسلوب, غرار, صورة ,نول ,كيفية
spotkać - تلقى
spotkanie - مقابلة ,موعد ,لقاء
spotykać - قابل, لقي, اجتمع
spóźniać się - تأخر
sprawa - شأن قضية دعوى
sprawdzać - حقق ,فحص ,تفقد ,سبر ,نظر
sprawdzanie - نظر
sprawiać - جعل
sprawiedliwość - عدالة, عدل, ميزان
sprężyna - زنبرك ,نابض
sprytny - حاذق ,شاطر
sprzeciwiać się - ضاد ,عارض, ناقض
sprzeciw - مواجهة ,احتجاج
sprzedawać - تاجر ,باع ,نفق
sprzedawca - تاجر, بياع, بائع
sprzedaż - بيع
sprzęt - أجهزة , معدات
srebrny - فضي
srebro - فضة
średniowiecze - القرون الوسطى
średni - أوسط
Sri Lanka - سريلانكا
środa - الأربعاء
środek - قلب ,مركز ,وسط , منتصف ; وسيلة
środki masowego przekazu - وسائل الإعلام ,إعلام
środkowy - متوسط
środowisko - بيئة , وسط
śródręcze - مشط اليد
śródziemnomorski - متوسطي
sroka - عقعق
srom - فرج
śrubokręt - مفك
ssać - مص
ssak - ثديي
ssanie - مص
stacja benzynowa - محطة بنزين
stacja - محطة
stać - وقف
stadion - استاد
stado - قطيع ; ''ptaków:'' سرب
stajnia - إسطبل
stalagmit - صواعد الكهوف
stale - باستمرار
stały - وطيد ,رأس ,ثابت
stal - فولاذ, صلب
Stambuł - إسطنبول, إستانبول
stamtąd - من ثم، من هنا، من ذلك مكان|المكان
standard - معيار ,مستوى, مقياس
stanowczy - حاسم
stanowisko - منصب
Stany Zjednoczone Ameryki - الولايات المتحدة الأمريكية
Stany Zjednoczone - الولايات المتحدة
stan - طور ,كيف
starać się - حاول, قصد
staranie - جهد
starannie - بعناية
starość - هرم, شيخوخة
starówka - المدينة القديمة
starożytność - قدم
start - بدء ,بداية ,انطلاق
Stary Testament - العهد القديم
stary - قديم , خلق, جل
starzec - عجوز
statek - سفينة, مركب
status - وضع ,مقام
statystycznie - إحصائيا
statystyczny - إحصائي
statystyka - إحصاء
stawać - حدث ,جرى
staw - بركة ; مفصل
step - سهب
stereotyp - رأي شائع
sterta - كومة
ster - سكان, دفة
stewardesa - مضيفة طيران
stokrotka - أقحوان
stolarz - نجار
stolica - عاصمة
stół - طاولة , مائدة , منضدة
stopa - قدم
stop - قف سبيكة
stosowny - لائق
stosunek płciowy - جماع
stosunek - نسبة
stos - كومة
stowarzyszenie - عشرة ,ناد ,رابطة ,جمعية
strachliwy - خائف
strach - خوف ,رعب ,روعة ,روع, رهبة, خشية ,ذعر
straszny - إفزاع ,مرعب ,مريع
strategia - إستراتيجية
strażak - إطفائي, رجل إطفاء
strefa erogenna - منطقة الشهوة الجنسية
Strefa Gazy - قطاع غزة‎
strefa - منطقة , قطاع
strój - ثوب
strona - صفحة ; جهة ; صفحة إلكترونية , موقع
stront - سترونشيوم
stróż bezpieczeństwa - رجل أمن
stróż - حارس
strumień - سيل
strumyk - غدير
struna - وتر
struś - نعامة
strzała - سهم ,نبل ,نبلة
strzał - رمي, رمية
Strzelec - برج القوس
student - طالب
studiować - درس
studio - أستديو
studnia - بئر
stukanie - دق
stworzenie - إنسان ,كائن ,حيوان ,مخلوق ,خليقة ,برية
styczeń - يناير , كانون الثاني
stygmat - ميسم
styl - أسلوب ,تصميم ,نمط
suahili - سواحلية
subha - سبحة
subtelność - فارق بسيط ;دهاء ,كياسة
suchy - يابس ,جاف
Sudańczyk - سوداني
Sudan Południowy - جنوب السودان
sudański - سوداني
Sudan - السودان
Suez - السويس
suficki - صوفي
sufit - سقف ,سمك
sufizm - صوفية , تصوف
sufi - صوفي
sugestia - رأي
suka - كلبة
sukces - نجاح, ‎فلاح
sukienka - فستان
suknia - فستان, ثوب
sułtanat - سلطنة
sumak - سماق
Sumatra - سومطرة
suma - مبلغ ,كمية ,مجموع
Sumer - سومر
superbohater - بطل خارق
supermarket - السوق المركزية, متجر كبير
sura - سورة
Surinam - سورينام
surowy - نيء قاس, متقشف
suszarka do włosów - منشف الشعر
susza - جفاف
suszyć - يبس
sutek - ‎حلمة
Svalbard - سفالبارد
swastyka - صليب معقوف
sweter - كنزة
świadectwo - شهادة
świadek - شاهد
świadomość - ضمير
świadomy - واع ,شعوري, شاعر
świat arabski - الوطن العربي
światło - نور , ضوء ; إضاءة
światowy - عالمي
świątynia - معبد
świat - عالم ,دنيا
świeca - شمعة ; شمعة احتراق
świetność - روعة , زهرة
świetny - رائع, ممتاز
świętować - احتفل
świętowanie - حفلة
święto - عيد
święty Mikołaj - بابا نويل
święty - قديس ; حرم مقدس
świeży - طازج، غض، فطير، طري، منعش، رشراش، ريان
świnia - خنزير
świnka morska - خنزير غينيا
świt - فجر ;فجر
swobodnie - بحرية
swobodny - سائب طليق
Syberia - سيبيريا
Sycylia - صقلية
Sycylijczyk - صقلي
sycylijski - صقلي
Sydon - صيدا
sygnał - إشارة
syjonizm - صهيونية
sylwester - رأس السنة الميلادية
symbolizować - رمز
symbol - رمز
sympatia - عاطفة , حنان
sympatyczny - حسن ,لطيف
sympatyzować - رق
synagoga - كنيس
Synaj - سيناء
synapsa - مشبك كيميائي
syndrom sztokholmski - متلازمة ستوكهولم
synogarlica senegalska - فاختة النخيل, حمام الدبسي
syn - ابن , بن
sypialnia - غرفة النوم
Syria - سوريا, سورية, شام, الشام
Syriusz - الشعرى, الشعرى اليمانية
syrop klonowy - شراب الإسفندان
Syryjczyk - سوري, شامي
Syryjka - شامية
Syryjska Republika Arabska - الجمهورية العربية السورية
syryjski - سوري, شامي
systematyczny - منظوم
system operacyjny - نظام تشغيل
system plików - نظام الملفات
system - نظام ,جهاز ,جملة
sytuacja - حالة , حال, ظرف ,وضع
szachownica - رقعة الشطرنج
szachy - شطرنج
szach - شاه
szacunek - حظوة ,احترام , إكبار ; حساب
szafir - ياقوت, صفير
szafran - زعفران
szahada - شهادة
szakal - ذئب, ابن آوى
szakłak - سدر
szaleńczo - بجنون ,بسعر ,بحماقة
szaleniec - مجنون ; مخبل
szaleństwo - جنة ,جنون ,مس ,خبل ; حماقة
szalony - مجنون ,مسعور ,مخبل
szal - شال
szampan - شامبانيا
szampon - شامبو
szanować - احترم
szansa - فرصة
szarańcza - جرادة
szarlotka - فطيرة التفاح
szaszłyk - شاشليك
szatan - شيطان
szata - ثوب, روب, رداء ; غطاء
szczególnie - خاصة ,خصوصا ,لاسيما ,خصيصا
szczegółowy - دقيق, مفصل
szczegół - تفصيل
szczekać - نبح
szczekanie - نباح, نبح
szczęka - فك
szczelina - شق
szczepionka - لقاح ,لقاح
szczery - خالص, مستقيم, صادق
szczerze - بإخلاص, بصدق
szczęście - مرح , سعادة , سرور ; حظ
szczęśliwego Nowy Nowego Roku - كل عام وانت بخير ,كل سنة وانت سالم ,سنة جديدة سعيدة
szczęśliwy - سعيد ,مسرور ,فرحان
szczoteczka do zębów - فرشاة أسنان
szczotka do włosów - فرشاة للشعر
szczotka - فرشاة
szczupły - رفيع, نحيل
szczur - جرذ
szczyt - ذروة , قمة ; قمة
szef - رئيس ,باش
szemrać - همهم
szeptać - همس
szereg - صف
szeroki - واسع ,عريض
szerszeń - دبور
szerzenie - نشر ,بسط
szerzyć - شاع ,بسط
sześcian - مكعب
sześciokątny - سداسي
sześciokąt - مسدس
sześcioraki - سداسي
szewc - سكاف
szisza - شيشة
szkaradny - سيئ, قبيح
szkarłatny - أحمر داكن ,قرمزي
szkic - رسم
szkielet - هيكل, هيكل عظمي
szklanka - كاس ,كباية
szklany - زجاجي
szkło - زجاج
Szkocja - إسكتلندا
szkocki - إسكتلندي
szkoda - خسارة
szkodliwy - مضر
szkoła średnia - ثانوية
szkoła - مدرسة
szkolenie - تدريب
Szkot - إسكتلندي
szlachcic - نبل ,نبيل
szlachetny - كريم
szlafrok - برنس حمام
szmaragd - زمرد
szmata - خرقة
szmer - همهمة
szmugiel - تهريب
sznurek - خيط
sznurowadło - رباط الحذاء
sznur - حبل
szowinizm - شوفينية
szpic fiński - سبيتس فنلندي
szpiegowski - جاسوسي
szpieg - جاسوس
szpinak - سبانخ
szpital - مستشفى
szron - صقيع
sztandar - راية , لواء
Sztokholm - ستوكهولم, ‎استوكهولم
sztuczny - اصطناعي
sztuka - فن ; تمثيلية
sztylet - خنجر
szubienica - مشنقة
szuflada - جارور, درج
szukać - بحث
szumieć - حف
szum - خرير
szwagier - أخو الزوجة, زوج الأخت
Szwajcaria - سويسرا
Szwajcarka - سويسرية
szwajcarski - سويسري
Szwajcar - سويسري
Szwecja - السويد
Szwedka - سويدية
szwedzki - سويدي
Szwed - سويدي
szybki - سريع
szybkość - سرعة
szybko - بسرعة ,سريعا
szycie - تصميم
szyfr - شفرة
szyja - رقبة, عنق, خناق
szyjka macicy - عنق الرحم
szyszynka - غدة صنوبرية
tabela - لائحة
tablica rejestracyjna - لوحة أرقام السيارة , لوحة تسجيل السيارة
tablica - لوح, يافطة
tabuistyczny - محظور
tabu - حرمة , حرم ,حجر, محرم
taca - صينية
Tadżykistan - طاجيكستان
tag - وسم
tahini - طحينة
tajemnica - سر ,خفية
tajemniczy - باطني ,خفي ,غامض ,ملغز
tajfun - تيفون ,إعصار التايفون , طوفان
Tajlandczyk - تايلاندي
Tajlandia - تايلاند
tajny - سرّ
tajski - تايلاندي
Tajwan - تايوان
taksówka - تاكسي, سيارة أجرة
tak - نعم
talasemia - ثلاسيميا
talent - ملكة , موهبة
talerz - صحن
talia - جانب
talizman - طلسم
Tallinn - تالين
tal - ثاليوم
tamburyn - دف , رق
Tamiza - تيمز
tam - هناك
tancerka - غازية ,راقصة باليه
tancerz - راقص
tańczyć - رقص
Tangier - طنجة
tango - تانجو
taniec brzucha - رقص شرقي
taniec - رقص
tani - رخيص, بخس
tantal - تانتالوم
Tanzańczyk - تنزاني
Tanzania - تنزانيا
tanzański - تنزاني
taoizm - ‎طاوية
tarcza antyrakietowa - الدرع الصاروخي الأمريكي
tarcza - درع
taśma - شريط
Taszkent - طشقند
tatarski - تترية تتري
tata - بابا
tau - تاو
ta - هذه
Tbilisi - تبليسي
tchawica - رغامى, قصبة
tchórzliwy - خائف, جبان, فشل
tchórzostwo - جبن
tchórzyć - جبن
tchórz - جبان
teatralny - مسرحي
teatr - مسرح
technet - تكنيشيوم
techniczny - تقني
technika - تقنية
technik - تقن
technologiczny - تكنولوجي
tęcza - قوس قزح, قزح
tęczówka - قزحية
Teheran - طهران
teista - التّوحيد
tekst - نص ,متن
Tel Awiw-Jafa - تل ابيب-يافا, تل أبيب
telefoniczny - هاتفي
telefon komórkowy - هاتف نقال, هاتف محمول
telefonować - يتصل بالهاتف
telefon - تلفون , هاتف
telegraficzny - برقي
telegram - برقية
teleskop - منظار ,نظارة, مقراب
telewizja - تلفاز ,تلفزيون
telewizor - جهاز تلفزيون, تلفاز
tellur - تيلوريوم
temat - موضوع
temperatura - درجة حرارة
tenis - كرة المضرب, تنس
ten - هذا
teologia - إلهيات
teologiczny - لاهوتي
teoretyczny - نظري, تخيلي
teoria - نظرية
tępy - غبي, بليد
terapia - علاج
teraz - حالا ,الآن
terb - تيربيوم
teren - حقل
terier - تریر
termin - مصطلح أجل
termometr - محرار
Terpsychora - تيربسيكوري
terrorysta - إرهابي
terrorystyczny - إرهابي
terror - إرهاب
terytorium - إقليم, مساحة
teściowa - حماة
testament - وصيه
test ciążowy - اختبار الحمل
test - امتحان
tetraplegia - شلل رباعي
Tezeusz - ثيسيوس
theta - ثيتا
Timor Wschodni - تيمور الشرقية
Tirana - تيرانا
tkanina - نسيج
tkanka tłuszczowa - نسيج دهني
tkanka - أنسجة
tlenek etylenu - أكسيد إثيلين
tlenek węgla - أول أكسيد الكربون
tlen - أكسجين
tłok - ازدحام
tłumaczenie - صياغة ترجمة
tłumaczyć - ترجم
tłumacz - ترجمان ,مترجم
tłumić - كتم
tłum - جمهور , , ازدحام , ملا
tłusty - دهني ,مدهن, دسم
tłuszcz - دهن, شحم
toaleta - مرحاض
toast - نخب
tofu - توفو
Togo - توغو
Tokio - طوكيو
toksyczny - سام
toksykologia - علم السموم
tolerancja - تسامح
tom - مصحف
tona - طن
Tonga - تونجا , تونغا
topaz - توباز
topnieć - سأل
topola - حور
topór - بلطة
Tora - التوراة
torba - كيس ,حقيبة
torebka - حقيبة ; علبة
tornado - إعصار
tortura - عذاب
torturować - عذب ,لوع ,برح
tor - ثوريوم
Toskania - توسكانا
tost - ‎خبز محمص
totalitaryzm - شمولية
totalnie - تماما
towarzystwo - خلطة ; صحبة , تصاحب
towarzyszyć - واكب
tożsamość - شخصية
to - هٰذَا , هٰذِهِ
trąba - خرطوم
trąbka - بوق
tracić - فقد
tradycja - تقليد, تراث
tradycyjnie - تقليديا
tradycyjny - تقليدي
trądzik - حب ,عد, عید
trąd - جذام
tragedia - كارثة , مأساة ; تراجيديا
tragiczny - مأساوي
traktat - معاهدة
traktor - جرار, جرارة
tramwaj - ترام
transakcja - صفقة ,متجر
transcendentalny - ما وراء الطبيعة
transport - نقليات, نقل ,حمل
trasa - سكة
trauma - جرح , أذى , رض ; صدمة نفسي|نفسية , رضح
trawienie - هضم
trawnik - مرج
trener - مدرب
triumf - ظفر, فتح ,انتصار, نصر
trochę - قليل ,بعض
Troja - طروادة
Trójca Święta - الثالوث
trójkąt - مثلث
trójka - ثلاثية , ثالوث
trolejbus - حافلة كهربائية
troska - حيطة
trucizna - سم
trudność - زاجر, عسر
trudny - صعب, عسر
trud - جهد ,نزاع
truizm - بديهية
trujący - سام
trumna - تابوت
trunek - خمر
truskawka - فراولة
trwać - واظب ,ثبت
trwałość - دوام
trwanie - إستمرار
trwoga - قلق
tryb rozkazujący - ‎أمر, صيغة الأمر
Trynidad i Tobago - ترينيداد وتوباغو
Trypolis - طرابلس
trzcina - قصب
trzęsienie ziemi - زلزال
trzeźwy - معتدل
trzmiel - نحلة طنانة
trzon - أصل
trzymanie - مسك
trzy - ثلاثة
tsunami - تسونامي
Tuareg - طوارق
tulipan - تولب
tułów - جذع ; زور
tul - ثوليوم
tunel - نفق
Tunezja - تونس
Tunezyjczyk - تونسي
Tunezyjka - تونسية
tunezyjski - تونسي
Tunis - تونس
turban - عمامة
turbina - عنفة , تربين , تربينة
Turcja - تركيا
Turczynka - تركية
turecki - تركي
Turek - تركي
Turkmenistan - تركمانستان
turkusowy - فيروزي
Turyn - تورينو
turysta - سائح
turystyczny - سياحي
turystyka - سياحة
Tuvalu - توفالو
tuzin - دزينة
tu - هنا, هناك
twardy - عزيز ,شديد ,قاس, خشن ,صعب ,صلب ,عصيب ,شاق ,شظف
twarz - وجه
twierdzenie - مبرهنة
twój - ك
twórczy - خلاق
tworzenie - إيجاد
tworzyć - خلق ,كون
Tybet - تبت
tyć - بدن ,سمن
tydzień - أسبوع أسبوع
tygrysica - نمرة
tygrys - ببر , نمر
Tygrys - دجلة
tylko - فقط
tył - ظهر ,خلف, عقب
tymczasowy - زماني ,زمني
typ - نوع, طرز, نمط
tyrać - تعب
Tyr - صور
tysiąclecie - ألفية
Tytan - تيتان
tytan - تيتانيوم ; تيتان
tytoń - تبغ دخان
tytuł - لقب عنوان
ty - أنت, انت
ubezpieczenie - تأمين
ubierać - ubierać لبس labbasa, ألبس albasa, وشح
ubiór - لبس ,رداء ,ملبس
ubogi - فقير, مسكين
ubóstwo - فقر
ubranie - رداء
uchodźca - هارب , لأجيء, لائذ
ucho - أذن
uchwyt - مقبض
ucieczka - مهرب
uczciwy - خالص ,أمين
uczelnia - كلية
uczenie - تعلم
uczennica - طالبة
uczeń - طالب, تلميذ
uczestnictwo - حضور
uczucie - عاطفة, وجدان ; ود
uczuciowy - عاطفي
uczyć - درس, علم ; درس
udawanie - دهان
uderzać - طرق ,خبط
uderzanie - خفقان ,خبط
uderzenie - ضرب إصابة
uderzyć - ضرب
udoskonalenie - تحسين, تحسن
udo - فخذ
udręczać - كرب
udział - نصيب
ufać - نام ,اتكل ,وثق
Uganda - أوغندا
ugija - أوقية
ujgurski - أويغورية ;أويغوري
ukąszenie - لدغة
ukazywać - نجم
układ okresowy pierwiastków - جدول دوري
Układ Słoneczny - المجموعة الشمسية, النظام الشمسي
układ - جهاز, دائرة
ukochany - حبيب محبوب
ukojenie - راحة
ukończenie - إنهاء
ukończyć - تمم
Ukraina - أوكرانيا
Ukrainiec - أوكراني
Ukrainka - أوكرانية
ukraiński - أوكرانية أوكراني
ukrycie - مخبأ
ukryty - مخفي ,باطني ,مخبأ
ukrywać - اختبأ, حجب كن
ukrywanie - حجب
ukształtowywanie - نحت
ułamek - كسر
Ułan Bator - أولان باتور
ulepszać - تحسن
ulepszenie - تحسين, تحسن
ulga - فرج
ulica - شارع
uliczka - زقاق
ulotny - زائل, فان
ulubiony - مفضل
Umbria - أومبريا
umiejętność - قدرة
umierać - مات
umowa - إتفاق
umożliwiać - فسح, هيأ, مكن
umyślnie - عمدا
umysłowo - ذهنيا
umysłowy - ‎فكري ,نفسي ,ذهني ,عقلي
umysł - عقل ,رشد
Unia Europejska - الاتحاد الأوروبي
unia - اتحاد
unieważnienie - نسخ
unikać - اتقى, تجنب
unikanie - تجنب
unikatowy - وحيد ,أحد ,يتيم, فريد
uniwersalny - شامل ,عالمي
uniwersytecki - جامعي
uniwersytet - جامعة
upadek - كسرة , سقوط ; فساد, تعفن, عفن, سقوط
upał - حر, أوار
uparty - عنيد ,جامح ,صليب
upiększanie - تجميل ,تحسين
upiększenie - تحسين
upierzenie - ريش
upijać - سكر
upokarzać - وضع ,أذل
upomnienie - ذكرى
uprawa - حرث
uprawiać - حرث
uprościć - سهل
Urania - أورانيا
Uran - أورانوس ;أورانوس
uran - يورانيوم
uraz - إصابة
urlop - إجازة , مأذونية
uroczy - فاتن ,صباح ,ساحر ,أخاذ ,ظريف
urodziny - ميلاد عيد ميلاد
urodziwy - مليح
Urugwaj - أوروغواي
urządzenie - جهاز, أداة
urzeczywistniać - نفذ
urzędnik - مسؤول
urzędowy - رسمي
urzekać - اسر
usiłować - حاول
uskok - فالق
uśmiechać się - ابتسم
uśmiech - ابتسامة , بسمة
uspokajać - اطمأن سكن
ustanawiać - ثبت, نصب
ustawa - سن
usta - فم
ustny - فموي
ustrój - نظام
usuwać - أزال
usuwanie - حذف
uszczerbek - خسارة
utrudniać - ثبط ,صعب, حرج, منع
utrzymanie - معاش , رزق
utrzymywać - ثبت
uwaga - تعليق انتباه, عناية ,اهتمام , أشعار ; تحذير
uważać - نظر
uważny - منتبه
uwielbiać - ولع
uwolnić - برا, فرج, أطلق, أفرج
uwolnienie - خلاص ,إفراج
uzależnienie - إدمان, تولع, معاقرة
Uzbekistan - أزبكستان, أوزبكستان
uzgadniać - توافق
uznanie - إعجاب
uzurpować - إغتصب
użyteczność - نفع
użytkownik - مستعمل
używać - استعمل ,إنتفع, إستخدم, نفع
używanie - إستعمال
używany - مستعمل
u - عند
vice versa - العكس بالعكس
wada - مأخذ ,عيب ,شق ,علة ,صدع ,خلل ,مثلبة, شائبة
waga - أهمية , ميزان ; وزن ; شأن
Waga - برج الميزان
wagon - عربة , عربة قطار
wahać - تردد
wakacje - فرصة
walczyć - حارب ,قاتل ,إستمات ,شن, تقاتل, اقتتل
Walia - ويلز
walizka - حقيبة سفر
walka - صراع, جهاد نزاع, قتال ,عراك, تقاتل
waluta - عملة
wampir - مصاص دماء
wanilia - فانيليا
wanna - مغسل, حوض استحمام, بانيو, مغطس
wapń - كالسيوم
waran - ورل
warga - شفة
wariant - اختلاف
warkocz - ضفيرة
Warszawa - وارسو
wartość - ثمن
warunek - حالة , شرط
warunkowy - شرطي
warzyć - خمر
warzywo - نبات , بقول , خضار
Waszyngton - واشنطن
wąs - شارب ,شنب
wątpić - شك ,إشتبه
wątpliwość - ارتياب ,شك ,خلجة
wątroba - كبد
Watykan - الفاتيكان
wawrzyn - غار
ważność - أهمية
ważny - كبير ,مهم ,خطير ,هام
ważyć - وزن
wąż - أفعى, ثعبان
w celu - حتى, كي, لكي
wchłanianie - امتصاص
wciąż - ومع ذلك, غير ان, بيد أن; , لسه
wcześniactwo - ولادة مبكرة, ولادة قبل الأوان
wcześniej - قبل
wczesny - سابق ,باكر ,اول
wczoraj - أمس ,البارح ,امبارح
wdowa - أرملة
wdowiec - أرمل
wdzięczność - شكر
wdzięk - روعة, سحر
węch - شم
według - طبق
wędrować - جاب, تجول
wędrowanie - تجول
wegański - نباتي
wegetarianin - نباتي
wegetarianizm - نباتية
wegetarianka - نباتية
wegetariański - نباتي
węgiel - فحم ;كربون
Węgierka - مجرية , هنغارية
węgierski - هنغاري, مجري
Węgier - هنغاري, مجري
Węgry - المجر, هنغاريا
wejście - دخول, مدخل
Wenecja Euganejska - فينيتو
Wenecja - البندقية
Wenezuela - فنزويلا
Wenezuelczyk - فنزويلي
Wenezuelka - فنزويلية
wenezuelski - فنزويلي
Wenus - الزهرة , فينوس
wesele - زواج, فرح
wesołość - مرح
Wesołych Świąt - عيد ميلاد مجيد
wesoły - سعيد , فرحان , بشوش ,مرح, ضاحك
wesz - قملة
weterynaria - طب بيطري
weterynaryjny - بيطري
weterynarz - طبيب بيطري
weto - تحريم
wewnętrzny - باطن ,باطني
węzeł - عقيدة , عقدة
wiadomość - رسالة ,أخبار ,خبر
wiadro - دلو ,سطل
wiara - إيمان إستئمان
wiatrak - طاحونة هوائية
wiatr - ريح , دبور ''''
wiązać - عصب
widelec - شوكة
wideoklip - فيديو كليب , أغنية مصورة
widok - مشهد, منظر, رؤية
widzenie - رؤية ,نظر
widzialny - مرئي
widzieć - شاهد, بصر, شاف ,رأى ,نظر
wieczność - سرمد, أزل, سرمدية, أبدية, خلد
wieczny - خالد, سرمدي, أبدي, أزلي, '''' صمد
wieczorem - ‎مساء
wieczór - ليلة, عشاء, ‎مساء
Wiedeń - فيينا
wiedza - معرفة
wiedzieć - عرف ,علم
wiejski - ريفي
wiek emerytalny - سن التقاعد
większość - جل
większy - أكبر ,أوسع
wiek - قرن
wielbłąd - جمل
Wielka Brytania - المملكة المتحدة ; بريطانيا العظمى
Wielka Niedźwiedzica - الدب الأكبر
Wielkanoc - عيد الفصح
Wielkie Antyle - جزر الأنتيل الكبرى
wielki - كبير, ضخم, عريض, جزيل
wielkoduszny - سمح ,جواد ,كريم
wielkość - كمية ,كبر عظم
wieloryb - حوت ,بال
wieloznaczność - عجمة
wieprz - خنزير
wiercenie - حفر
wierność - إخلاص, وفاء ,ثمرة القلب
wiersz - قصيدة
wierzba - صفصاف
wierzchołek - رأس
wierzyć - آمن صدق
wieśniak - ‎فلاح, ريفي
wieś - قرية , ريف
Wietnamczyk - فيتنامي
Wietnamka - فيتنامية
wietnamski - فيتنامي
Wietnam - فيتنام
wiewiórka - سنجاب
wieża Babel - برج بابل
wieża - برج
więzienie - سجن
więzień - سجين ,أسير
wieżowiec - ناطحة سحاب
Wigilia - ليلة عيد الميلاد
wigor - حيل
Wikipedia - ويكيبيديا
Wikisłownik - ويكاموس
Wikiźródła - ويكي مصدر
Wiktoria - فيكتوريا
wilgotny - رطب, مبلول
wilk w owczej skórze - wolf in sheep's clothing
wilk - ذئب
Wilno - فيلنيوس
w imię - باسم
wina - ذنب, سيئة
winda - مصعد
Windhuk - ويندهوك
winnica - كرم عنب
winny - مذنب
winogrono - عنب
winorośl - دالية
wino - نبيذ ,خمر ,خمرة ,راح
wiosna - ربيع
wiśnia - كرز
witać - مرحبا, رحب
witraż - زجاج معشق
wiza - إذن الدخول ,تأشيرة ,سمة ,تأشيرة دخول
wizjer - ثقب الباب
wizyta - زيارة
wkrótce - بعد قليل
włączać - شغل
władca - شيخ , عاهل ; بعل , رب
władczyni - ملكة
władza - نفوذ ,سلطة ,ولاية ,سلطان, سيطرة
właścicielka - ربة
właściciel - رب ,مالك ,صاحب ,حائز ,ولي ,مقتن
właściwość - صفة , خاصة
właściwy - صحيح
właśnie - أجل
własność - حيازة
Włochy - إيطاليا , ايطاليا
Włoch - إيطالي
włoski - إيطالي
Włoszka - إيطالية
włos - شعر
w międzyczasie - خلال ذلك
wnętrze - خلد باطن
wnikliwość - فراسة
wniosek - إستنتاج
wnosić - إستنتج
wnuczka - حفيدة
wnuk - حفيد , عقب
woda - ماء
wódka - فودكا
Wodnik - برج الدلو
wodny - مائي
wodoodporny - مشمع
wodór - هيدروجين
wodospad - شلال
w ogóle - بصفة عامة, بالإجمال, عموما, على العموم, بشكل عام
wojenny - حربي
wojna domowa - حرب أهلية
wojna trojańska - حصار طروادة
wojna - حرب
wojskowy - عسكري
wołanie - صرخة
wola - إرادة
woleć - فضل
wolfram - تنجستن
Wołgograd - فولغوغراد ,ستالينغراد
wolność słowa - حرية التعبير
wolność - حرية
wolno - ببطء
wolny rynek - سوق حر
wolny - حر ,محلول ,خال ,محرر
wolt - فولت
woń - رائحة ,روائح ,طيب
wosk - شمع
wówczas - حينئذ
wpływać - أثر
wpływ - أثر, تأثير ,نفوذ
wprawny - ماهر
wracać - أوب, قفل, رجع
wrażliwy - حساس ,حساسي
wreszcie - أخيرا
wróbel - عصفور
Wrocław - فروتسواف
wrogi - عدائي
wrogość - بين, عداء, عداوة, خصومة, عدائية, ضغينة
wróg - عدو, خصم, قتل
wrota - بوابة
wróżenie - عرافة
wróżka - عرافة
wrzawa - جلبة
wrzesień - سبتمبر , أيلول
wrzos - خلنج
wschodni - شرقي
wschodzenie - ارتفاع ,صعود
wschód - بزوغ، مطلع، شروق، شروق الشمس، طلوع الشمس، شرق ; شرق
Wschód - شرق ,مشرق
wścieklizna - داء الكلب
wściekły - غضب
wskazówka - معلومة
wskazywać - أشار
wspaniałomyślny - كريم
wspaniałość - روعة, عظمة, مجد, زهرة, فخامة
wspaniały - ممتاز, مدهش, عظيم, عجاب
wspierać - ناصر, دعم, ساعد ,عال ,عون, سند, عمد, نصر
wspinaczka - تسلق
wspinanie się - صعود
współczesny - معاصر ,متعاصر ,عصري
współczucie - رحمة
współczuć - رق, حنا
Wspólnota Niepodległych Państw - اتحاد الدول المستقلة
wspólnota - مجتمع, أمة
współpraca - cooperation, co-operation
współpraca - تعاونية
współzawodnictwo - مسابقة
współżyć - جامع
wspomnienie - ذكرى ,ذكر ,تذكر
wśród - بين
wstęp - مقدمة , فاتحة
wstrętny - فاحش
wstyd - عار, شين
wszechmocny - قدير
wszechświat - كون
wszędzie - حيثما, في كل مكان
wtedy - حينئذ ,آنذاك
wtorek - الثلاثاء
wujek - خال ; عم
wulgarny - سوقي ,مقرف ,بذيء
wulkaniczny - بركاني
wulkan - بركان, جبل النار
wybaczać - سامح ,غفر
wybierać - نخب ,اختار
wybitny - جيد, وجيه, بارز
wyborca - ناخب
wybory - انتخابات ,انتخاب
wybór - نخب ,صفوة ,إختيار ,إنتقاء
wybrakowany - ناقص
Wybrzeże kość Kości Słoniowej - كوت ديفوار, ساحل العاج
wybrzeże - ساحل
wybuch - إنفجار / انفجار , تفجير , نسف , تفجر , فرقعة ; فورة
wychowanie - آداب السلوك
wychowawca - مؤدب
wychwalać - '''' سبح
wyciskanie - عصر
wyć - ولول
wydanie - نشر
wydarzenie - حدث ,ظهور
wydatek - خرج, دفع, كلفة
wydawać - نشر, لفظ
wydłużyć - طول, طال, أطال
wydma - كثيب
wydziedziczyć - حرم
wygląd - مظهر ,نظر
wygodny - مريح
wygranie - هزم
wygrywać - ربح ,فاز
wyjaśniać - شرح ,اول ,نور ,بسط, فسر, أوضح
wyjątek - استثناء
wyjątkowy - استثنائي
wyjazd - ابتعاد
wyjeżdżać - بعد ,غادر, رحل ,انصرف
wyjście - خروج ,مخرج
wyjść - خرج ,انفصل
wykałaczka - عود تخليل أسنان
wykładowca - محاضر
wykład - محاضرة
wykonawca - ‎فاعل
wykonywać - مارس
wykopaliska - حفر
wykroczenie - ذنب
wykrywacz kłamstw - جهاز كشف الكذب
wykrzyknik - علامة التعجب
wykształcony - أديب ,مثقف
wyłączać - أغلق
wylot - نفذ
wymagać - تطلب
wymiana - صرافة, تبديل
wymiar - بعد
wymiotować - إستفرغ ,تقيأ
wymiotowanie - قيء
wymioty - قيء
wymowa - نطق, لفظ
wynagrodzenie - جعل ; مكافأة
wynikać - تابع
wyobrażać - خال ,تصور
wyobrażanie - تصور
wyobrażenie - خيال, توهم, فكرة, خطة, خاطر
wyobraźnia - مخيلة
wypadek - حالة ; حادث , مصيبة
wypełniać - ملأ
wypełnienie - وفاء ; حشو
wypłacać - دفع
wypukły - بارز, محدب
wyrażenie - عبارة , تعبير
wyraźnie - بوضوح
wyrównać - ساوى
wyrównywanie - بسط
wyróżniać - امتاز
wyrżnąć - قتل
wyrzucać - قذف
wyściełać - نجد
wyścig - سباق
wysiłek - جهد, مجهود
wysłannik - رسول, مبعوث
wysoki - طويل , عالي, عال, مرتفع, علي
wysokość - ارتفاع
Wyspa Bożego Narodzenia - جزيرة عيد الميلاد
Wyspa Man - جزيرة مان
Wyspa Świętego Wyspy Świętego Tomasza i Wyspa Książęca - ساو تومي وبرينسيبي
Wyspa Świętej Heleny - سانت هيلينا
Wyspa Wniebowstąpienia - جزيرة أسينشين
wyspa - جزيرة
wyspiarski - جزري
wyspiarz - جزري
Wyspy Alandzkie - أولند ,جزر آلاند
Wyspy Cooka - جزر كوك
Wyspy Kanaryjskie - جزر الكناري
Wyspy Karkanna - قرقنة, جزر قرقنة
Wyspy Marshalla - جزر مارشال
Wyspy Salomona - جزر سليمان
wystarczać - كفى
wystarczająco - كفى
wystawa - عرض
wystawienie - تعرض
występek - عملة , إثم , حرج
wysyłać - أرسل ,صدر, قذف
wytłumaczyć - أفهم
wytrwałość - إستمرار ,عناد ,لجاجة ,تعنت
wytrzymać - صمد
wytrzymały - مقاوم
wytwarzać - أنتج
wytwarzanie - إنتاج
wytwórca - صانع
wyuzdanie - شبق, اباحية
wywiad - مقابلة , حديث
wywodzić - عرق
wywoływać - أوجد
wyznaczać - عين
wyznanie - إيمان ; اعتراف
wyznawać - اعترف
wyznawca - حواري
wyższość - نبل ,تفوق ,علو ,أرجحية ,غلبة ,علوية ,تعال ,جاه ,رجحان ,إستعلا ,تشامخ ,فوقان
wyzwolenie - تحرير
wy - أنتم , أنتن , أنتما ''''
wzdychać - آه ,تنهد
wzgląd - نظر, صدد, اعتبار
wzgórze - تل ,يفاع , رابية ; مهاد
wzmacniać - متن, عزز, عزیز
wzmianka - ذكر
wzniesienie - تل
wznosić - تسلق على شاد, نصب
wzorzec - نموذج
wzrokowy - بصري
wzrost - زيادة , ارتفاع
w - في
zabawa - لعب ,لهو ,هزل ,مزاح
zabawka - لعبة , ألعوبة , دمية
zabawny - ظريف مضحك ,مسل
żaba - ضفدع
zabijać - قتل ,اغتال
zabijanie - قنص
zabity - قتيل
zabłądzić - تاه
zabójca - قتال, قاتل, سفاح
zabójczo - بشكل قاتل, بشكل مميت;&amp;lrm; إلى حد بعيد
zabójczy - قتال, قاتل
zabraniać - منع, حرم, حجر, حرج
zaburzenie - اضطراب
zabytek - أثر, تمثال
ząb - سن
zachęta - تشجيع
zachodni - غربي
zachodzić - تداخل
Zachód - الغرب
zachód - غرب غروب, مغرب
zachorować - مرض
zachowanie - سلوك ,تصرف
zachowywać - حفظ ثبت&amp;lrm; تصرف
zachwycać - سر
zaćma - ساد ,سد
zaćmienie - كسوف , خسوف
zacny - قوي, متعفف, طاهر
zacofanie - تخلف
zaczynać - ابتدأ
żądać - طالب
żądanie - طالب , مطالبة
zadanie - واجب, مهمة, رسالة
zadawać - طرح ''''
żaden - أي
zadowolony - مبسوط ,مسرور ,رضي
zagadka - لغز
zagadnienie - موضع
zagraniczny - أجنبي
Zagrzeb - زغرب
zaimek - ضمير
zainteresowanie - اهتمام
zajęcie - شغل
zajęty - مشغول
zajmować - شغل
zakazany - محظور ,حرم, محرم ,ممنوع
zakazywać - حرم ,حظر
zakaz - تحريم, حظر, تحريج, ناهية, نهي ,حجر
zakładać - حسب أسس
zakładka - مؤشر , مؤشرة , علامة كتاب
zakład - منشأة
zakłócenie - تشويش
zakochany - مغرم
zakończenie - نهاية ; إنتهاء
zakonnica - راهبة
zakonnik - راهب
zakres - مجال, محيط, دائرة
zakręt - منعطف
zakrywać - غطى, ستر
załącznik - ذنب
załamany - مكتئب, محزن
zalesiać - شجر, حرج
zalesianie - تشجير
zależny - تلو
zaliczka - عربون
żałosny - تعيس
żałować - ندم
żal - حزن, غم, بلاء ; أسف
zamach stanu - انقلاب
zamarzać - تجمد
Zambia - زامبيا
zamek błyskawiczny - سحاب
zamek - قلعة , قصر ; قفل
zamęt - جأش
zamiar - غاية
zamiast - بدلا من ,بدلا
zamierzać - قصد ,نوى ,استهدف
zamieszkać - قطن ,وطن
zamieszkiwać - عمر, قر
zamykać - قفل ,أغلق
zanieczyszczenie - تلوث
zaniedbanie - قصور ,قصر
zanim - قبل ,قبل أن
zanurzać - غمر
zaopatrzenie - زاد ,تموين
zapach - نشا ,رائحة ,روائح ; عطر
zapalenie płuc - التهاب رئة
zapałka - عود ثقاب
zapalniczka - ولاعة, قداحة
zapał - حمية , غيرة , حماس , حماسة
zapewniać - جهز, رزق
zapisywać - سجل
zapobiegać - منع
zapobieganie - منع
zapominać - نسي
zapora - سد
zapraszać - دعا
zaprzeczać - جحد ,نفى ,أنكر
Zaratusztra - زرادشت
zaratusztrianizm - زرادشتية
żargon - رطانة
żarna - رحى
żarówka - لمبة, مصباح كهربائي
zarozumialstwo - عجب ,زهو
żartować - مزح, مازح
żartowanie - دعابة ,مزاح
żartowniś - مضحك ,مزاح ,بهلول ,هازل
żart - نكتة , مزحة , فكاهة
zarządzać - دبر
zasada - مبدأ ; قاعدة
zasłona - ‎ستارة ,ستار, ستر
zasługa - حسنة
zasługiwać - استحق
zasłużony - مستحق
zasmucać - حزن
zasnąć - نام
zastępca - نائب
Zatoka Bengalska - خليج البنغال
Zatoka Biskajska - خليج بسكاي
Zatoka Guantanamo - خليج جوانتانامو
Zatoka Kabiska - خليج قابس
Zatoka Meksykańska - خليج المكسيك
Zatoka Sueska - خليج السويس
Zatoka Tajlandzka - خليج تايلند
zatoka - خليج
zatrudniać - شغل, إستخدم, اشتغل
zatrzymanie - وقف ,حجز, توقف
zatrzymywać - كف ,وقف, توقف, أوقف, استوقف&amp;lrm; اسر
zaufanie - ثقة , إستئمان , ائتمان
zawartość - سعة، محتوى، محتويات، مضمون
zawiadamiać - أخبر, أعلم
zawodowy - مهني
zawodzić - خيب
zawód - مهنة ,حرفة ,كار
zawstydzać - أخجل
zawsze - دائما
zazdrość - حسد, غيرة
zazdrosny - حسود, حاسد, غيور
zazwyczaj - عادة
za - خلف ,وراء
zbawiciel - مهدي
zbierać - جمع, لم قطف, جنى
zbieranie - لم, قطف, تشكيل
Zbigniew - ﺯﺑﻐﻨﻴﻮ, ﺯﺑﯖﻨﻴﻒ, ﺯﺑﻐﻨﻴﻒ
żbik - قط بري
zbiorowy - جمعي
zbliżać - اقترب دنا
zbrodnia wojenna - جريمة حرب
zbrodnia - جريمة
zbroja - درع
zbyt - أكثر
z całego serca - بإخلاص ,من القلب
zdanie - جملة , عبارة
zdarzać - وقع
zdarzenie - حالة , حدث, حادث, بروز
zdecydować - بت, قر
zdecydowany - مصر
zdesperowany - يائس
zdobywać - غنم
zdolność - ملكة , قدرة ; وسع
zdolny - قدير, حاذق, قادر
zdrada stanu - خيانة عظمى
zdrada - خيانة, غدر
zdradzać - غدر
zdrajca - خائن , خوان
zdrowieć - صح, شفي
zdrowie - صحة
zdumienie - ذهول , دهشة , اندهاش, عجب
zdziwienie - استغراب
żebrak - شحاذ ,متسول
zebranie - اجتماع
żebro - ضلع
żeby - إلى
zegarek - ساعة
zegar - ساعة
żelazko - مكواة
żelazo - حديد
zelota - زيلوت
żel - جل
zemsta - انتقام, قصاص, نقمة
Zenon - زينون
żeński - مؤنث ;مؤنث ;مؤنث ,أنثوي
zepsuć - أفسد
zepsuty - فاسد ,مكسور
zero - صفر
zespół kanału nadgarstka - متلازمة النفق الرسغي
zespół napięcia przedmiesiączkowego - متلازمة سابقة للحيض
zespół - نفر فرقة
zeszyt - دفتر, كراس
Zeus - زيوس
zewnątrz - خارج
zewnętrzny - خارجي, خارج ,ظاهر
zezwalać - أذن
że - أن anna, إن inna, أنه annahu, إنه innahu
zgadzać - وافق
zginąć - مات
zgoda - صلح, وفاق, إتفاق , موافقة اذن
zgodnie - وفق ;أذن ,طبق
zgodny - موافق
zgromadzenie - حشر ; مجلس
zgubić - تاه ضيع
ziarno - حبة ,حب
zięć - ختن، صهر، زوج الابنة
zielarski - عشبي
zieleń - خضرة
zielony - أخضر
Ziemia - أرض , الأرض
ziemia - تربة ;ثرى ; بلد
ziemniak - بطاطا ; بطاطس
ziewać - تثاءب
ziewanie - تثاءب
zima - الشتاء , شتاء
Zimbabwe - زيمبابوي
zimna wojna - حرب باردة
zimny - بارد , قر
zimorodek - سكيكينة
zimowy - شتوي
zjawa - شبح
zjawisko - ظاهرة
zjednoczenie - وحدة
Zjednoczone Emiraty Arabskie - الإمارات العربية المتحدة
Zjednoczone Królestwo - المملكة المتحدة
złamać - انكسر
złamanie - كسر
złamany - مكسور
źle - بشكل سيء, بشكل خاطئ
złodziej - لص , حرامي , خطاف
złom - خردة
złość - غضب
złośliwość - شراسة , حقارة
złośliwy - مؤذ
złoto - ذهب
złoty - زلوطي ذهبي
złożenie - تركيب
złożony - مركب
zło - شر ,رداءة, سوء
złudzenie - وهم
zły - غاضب ; سيئ ,رديء
zmarły - متوفى
zmartwienie - كرب ,جزع
zmęczenie - تعب, لغوب
zmęczony - متعب, تعبان, منهك, ;&amp;lrm; ملول
zmiana - نوبة ,تغير ,تغيير ,تبديل ,تحوير ,تعديل ,تحويل
zmieniać - غير ,بدل ,تغير, حور
zmienny - متقلب
zmierzch - شفق
żmija - أفعى, حية
zmniejszać - صغر, خفض
zmniejszanie - خفض
zmuszać - أرغم ,إجبر
zmysłowy - شعوري
zmysł - حاسة
zmywarka - غسالة الصحون
znaczek pocztowy - طابع بريد
znaczenie - أهمية ,معنى ; وزن, شأن, ثقل, بروز
znaczyć - أهم;&amp;lrm; عنى, أفاد&amp;lrm; وسم
znajdować - وجد, إكتشف, لقي, لاقى
znajomość - معارف
znajomy - معروف, محيط
znakomity - جيد, متقن
znak - حرف , شارة , يافطة ; إشارة , علامة
znany - معروف, شائع
zniewaga - إهانة
zniewieściały - مخنث
zniknąć - غاب
zniszczenie - هدم ,هلاك ,سحق
zniszczony - خرب ,مدمر
żniwiarz - حصاد
zniżka - خصم
znosić - تحمل ,دام ,صبر ألغى
znużenie - كلال
zobaczenie - رؤية
zobowiązać - تعهد ''''
zodiak - برج
żołądek - بطن, معدة
żołądź - حشفة القضيب, حشفة البظر
żółknąć - إصفر ,اصفر
żołnierz - جندي
żółtko - صفار البيضة
żółty - أصفر
żółw - سلحفاة
żonaty - متزوج
żona - زوجة , حرم ,حرمة ,قرينة ,عقيلة ,حليلة ,ثوية
zoologia - علم الحيوان
zostać - أصبح
zostawać - بقي
zostawiać - خلف
z powrotem - إلى الوراء
zręczny - تقن
źrenica - حدقة , بؤبؤ
źródło - مراجع عين ,ينبوع ,مصدر ,مأخذ, ينبوع
zrównoważony - متوازن
zrozumienie - فهم , مفهوم ; رضوخ, تفاهم
zupa - شوربة , حساء
zupełność - تمام
zupełny - كامل
żurawina - توت بري
zwalniać - أقال ,فصل
związany - متلازم ,مترابط ,مربوط, متعلق
związek frazeologiczny - كناية
Związek Radziecki - الاتحاد السوفيتي
związek - عشرة, علاقة, ربط, قربى ; رابطة
związkowy - اتحادي
zwiększać - كبر, زاد
zwierzać się - صارح, ناجى
zwierzęcy - حيواني
zwierzę domowe - حيوان أليف
zwierzę - حيوان
zwięzły - مقتضب
zwilżać - ندى, زلق
zwłaszcza - تحديدا
zwłoki - جثة
zwój - طومار
zwolennik - تابع, ذنب, شيعة
zwrócić - أرجع ,رجع
zwrotnik - مدار
zwycięstwo - ظفر ,انتصار, فوز, نصر
zwyciężać - ظفر ,تغلب ,هزم
zwyczaj - تقليد ,عادة
życie - حياة ,وجود ,عيش
życzenie - أمنية
życzliwość - حنان
życzyć - تمنى
żyć - عاش ,حيي
Żydówka - يهودية
żydowski - يهودي
żyd - يهودي
żyła - وريد, عرق
żyrafa - زرافة
żyrandol - ثريا
zysk - فائدة , ربح
żywić - غذى
żywność - غذاء, قوت
żywy - حي
Żyzny Półksiężyc - الهلال الخصيب
z - من ; مع , ب|بـ
