; - ·
” - »
„ - «
10. - 10ος
1. - 1ος
2. - 2ος
3. - 3ος
4. - 4ος
5. - 5ος
6. - 6ος
7. - 7ος
8. - 8ος
9. - 9ος
Aaron - Ααρών
abaka - καννάβι της μανίλας
abakus - άβακας ; άβακας
abandon - εγκατάλειψη
abazja - αβασία
abażur - αμπαζούρ
Abchazja - Αμπχαζία
abderyta - Αβδηρίτης ; αβδηρίτης
abduktor - απαγωγός μυς
abdykacja - παραίτηση
abecadło - αλφαβητάρι
Abelard - Αβελάρδος
Abel - Άβελ
Abidżan - Αμπιτζάν
abiogeneza - αβιογένεση
abiotyczny - αβιωτικός
abioza - αβίωση
Abisynia - Αβησσυνία
abiturient - απόφοιτος
abolicja - κατάργηση
abonentka - συνδρομήτρια
abonent - συνδρομητής
aboralny - αντιστοματικός
aborcja - έκτρωση , άμβλωση
Abraham - Αβραάμ
abrogacja - ακύρωση
absces - απόστημα
absencja - απουσία
absolutny - απόλυτος
absolutyzm - απολυταρχία
absolwent - απόφοιτος
absorbować - απορροφώ; απορροφώ
absorpcja - απορρόφηση ; απορρόφηση
abstrakcja - ρεμβασμός ; αφαίρεση
abstrakcyjny - αφηρημένος
acetofenon - ακετοφαινόνη
aceton - ακετόνη
acetylen - ακετυλένιο
Achilles - Αχιλλέας ; Αχιλλέας
Adam - Αδάμ
adekwatny - επαρκής, αρμόδιος
Adelajda - Αδελαΐδα ; Αδελαΐδα
administracyjny - διοικητικός
administrować - διοικώ, διαχειρίζομαι
admirał - ναύαρχος
Adonis - Άδωνις
adopcja - υιοθεσία ; υιοθέτηση
adoptować - υιοθετώ
adorator - λάτρης ; εραστής
adrenalina - αδρεναλίνη
adres - διεύθυνση
Adrian - Αδριανός
Adriatyk - Αδριατική
adsorpcja - προσρόφηση
adwokat diabła - συνήγορος του διαβόλου
adwokat - δικηγόρος
adyton - άδυτο
aerobus - έρμπας
aerodrom - αεροδρόμιο
aerodynamika - αεροδυναμική
aerometr - αερόμετρο
aerostat - αερόστατο
afazja - αφασία
afera - απάτη , κομπίνα
afereza - αφαίρεση ; αφαίρεση
Afgańczyk - Αφγανός
afganistański - αφγανικός
Afganistan - Αφγανιστάν
Afganka - Αφγανή
afgański - αφγανικός
afisz - αφίσα
afleksyjny - άκλιτος
aforyzm - αφορισμός
Afrodyta - Αφροδίτη ; Αφροδίτη
Afrykanin - Αφρικανός
Afrykanka - Αφρικάνα / Αφρικανή
afrykański - αφρικανικός
Afryka - Αφρική
Agata - Αγάθη
agat - αχάτης
agenda - υποκατάστημα , πρακτορείο ; ατζέντα
Agnieszka - Αγνή
agnostycyzm - αγνωστικισμός
agnostyk - αγνωστικιστής
agonia - επιθανάτια αγωνία , χαροπάλεμα ; επιδείνωση , χειροτέρευση
agorafobia - αγοραφοβία
agora - αγορά
agronomia - αγρονομία , γεωπονία
agronom - αγρονόμος
agroturystyka - αγροτουρισμός
AIDS - AIDS
aikido - αϊκίντο
airbag - αερόσακος
Ajschylos - Αισχύλος
akacja - ακακία
akademia - ακαδημία , Ακαδημία
akademik - ακαδημαϊκός ; εστία , φοιτητική εστία
Akadia - Ακαδία
akant - ακάνθα
akapit - παράγραφος
akcent - τονισμός , τόνος ; τόνος ; προφορά
akceptować - αποδέχομαι, δέχομαι
akcja - δράση ; μετοχή
akcjonariusz - μέτοχος
akompaniament - ακομπανιαμέντο ; ακομπανιαμέντο
akompaniować - συνοδεύω, ακομπανιάρω
akordeonista - ακορντεονίστας
akordeon - ακορντεόν
akrobata - ακροβάτης
akrofobia - ακροφοβία
akronim - ακρωνύμιο , ακρώνυμο
akropol - ακρόπολη
Akropol - Ακρόπολη
aksamit - βελούδο
aksjomat - αξίωμα
akson - άξονας , νευράξονας
aktorka - ηθοποιός
aktor - ηθοποιός
akt urodzenia - πιστοποιητικό γεννήσεως
aktyn - ακτίνιο
aktywny - ενεργός; ενεργός
akt - πράξη ; γυμνό ; τελετή
akumulator samochodowy - μπαταρία
akumulator - συσσωρευτής , μπαταρία
akuszeria - μαιευτική
akuszerka - μαία , μαμή
akwaforta - ακουαφόρτε ; ακουαφόρτε
akwarela - ακουαρέλα
akwarium - ακουάριο , ενυδρείο
akwedukt - υδραγωγείο
akwilon - βαρδάρης , βοριάς
Akwitania - Ακουιτανία
Akwizgran - Άαχεν , Ακυίσγρανον
Alabama - Αλαμπάμα
alabaster - αλάβαστρο
Aladyn - Αλαντίν
alarm - συναγερμός
Alaska - Αλάσκα
Albańczyk - Αλβανός
Albania - Αλβανία
Albanka - Αλβανίδα
albański - αλβανικός
albatros - αλμπατρός , άλμπατρος
Alberta - Αλμπέρτα
albo - ή
album - λεύκωμα , άλμπουμ
alegoria - αλληγορία
aleja - περίπατος
Aleksander - Αλέξανδρος
Aleksandria - Αλεξάνδρεια
Aleksja - Αλεξία
alembik - αποστακτήρας , λαμπίκος
alergen - αλλεργιογόνο
alergia - αλλεργία ; αλλεργία , απέχθεια
ale - αλλά, μα, όμως; πόσο, τι
alfabet - αλφάβητο , αλφαβήτα
alfa i omega - το άλφα και το ωμέγα
alfa - άλφα
Alfons - Αλφόνσος
algebra - άλγεβρα
Algierczyk - Αλγερινός
Algieria - Αλγερία
Algierka - Αλγερινή
algierski - αλγερινός
Algier - Αλγέρι
algorytm - αλγόριθμος
alians - συμμαχία , ένωση
alibi - άλλοθι
Alicja - Αλίκη
aligator - αλιγάτορας , αλλιγάτορας
alimenty - διατροφή
alkalizować - αλκαλοποιώ
alkoholiczka - αλκοολική
alkoholik - αλκοολικός
alkoholizm - αλκοολισμός
alkoholowy - αλκοολούχος, οινοπνευματώδης
alkohol - αλκοόλη ; αλκοόλ , οινόπνευμα
alopata - αλλοπαθητικός
alpinista - αλπινιστής
Alpy - Άλπεις
Ałtaj - Αλτάια Όρη
alternator - εναλλακτήρας , γεννήτρια
altowiolista - εκτελεστής βιόλα|βιόλας
altówka - βιόλα
altruista - αλτρουιστής
altruizm - αλτρουισμός , φιλαλληλία
alt - άλτο ; άλτο ; άλτο ; άλτο
aluzja - υπαινιγμός , υπονοούμενο
Alzacja - Αλσατία
alzacki - αλσατικός
Alzatczyk - Αλσατός
Alzatka - Αλσατή
amazonit - αμαζονίτης
Amazonka - Αμαζόνιος ; Αμαζόνα
amazonka - ιππεύτρια , αμαζόνα
ambasada - πρεσβεία
ambasador - πρέσβης
ambicja - φιλοδοξία
ambitny - φιλόδοξος
ambona - άμβωνας
ambra - άμβρα , ζωϊκός|ζωϊκό ήλεκτρο
Ambroży - Αμβρόσιος
ambulans - ασθενοφόρο
ameba - αμοιβάδα
Ameryka Łacińska - Λατινική Αμερική
Amerykanin - Αμερικάνος , Αμερικανός
amerykanizacja - εξαμερικανισμός
Amerykanka - Αμερικανίδα, Αμερικάνα
amerykański - αμερικανικός, αμερικάνικος
Ameryka Północna - Βόρεια Αμερική
Ameryka Południowa - Νότια Αμερική
Ameryka Środkowa - Κεντρική Αμερική
Ameryka - Αμερική ; Αμερική
ameryk - αμερίκιο
ametyst - αμέθυστος
amfetamina - αμφεταμίνη
amfi- - αμφι-, αμφί-
amfora - αμφορέας
aminokwas - αμινοξύ
Amman - Αμμάν
amnestia - αμνηστία
amoniak - αμμωνία
Amon - Άμμων; Άμμων
amortyzator - αμορτισέρ
amperogodzina - αμπερώρα
amperomierz - αμπερόμετρο
amper - αμπέρ
amputacja - ακρωτηριασμός
amputować - ακρωτηριάζω
Amsterdam - Άμστερνταμ
amulet - φυλαχτό , φυλακτό
amunicja - πυρομαχικά
anaglif - ανάγλυφο
anagogiczny - αναγωγικός
anagram - ανάγραμμα
anakreontyk - ανακρεόντειο μέτρο
analfabeta - αναλφάβητος
analiza - ανάλυση
anamneza - ιστορικό
ananas - ανανάς ; ανανάς ; μπαγάσας , κατεργαράκος
anarchistyczny - αναρχικός
Anastazy - Αναστάσιος
Anatolia - Ανατολία , Μικρά Ασία
anatomia - ανατομία
Andaluzja - Ανδαλουσία
Andaluzyjczyk - Ανδαλουσιανός
Andora - Ανδόρρα
android - ανδροειδές
Andromeda - Ανδρομέδα; Ανδρομέδα
Andrzej - Ανδρέας
Andy - Άνδεις
anegdota - ανέκδοτο
anemometr - ανεμόμετρο
anemo- - ανεμο-, ανεμό-, ανεμ-
Angelika - Αγγελική
Angielka - Αγγλίδα
angielski - αγγλικός; αγγλικός|αγγλικά
angiografia - αγγειογραφία
angiologia - αγγειολογία
angioplastyka - αγγειοπλαστική , μπαλονάκι
Anglia - Αγγλία
anglicyzm - αγγλισμός
Anglik - Άγγλος
anglo- - αγγλο-, αγγλό-
Angola - Αγκόλα
Angolczyk - Αγκολέζος
Angolka - Αγκολέζα
angolski - αγκολέζικος
Ania - Αννούλα
anilina - ανιλίνη
animacja - εμψύχωση
ani mru-mru - τσιμουδιά
anioł stróż - φύλακας άγγελος
Anioł - Άγγελος
anioł - άγγελος ; άγγελος
anion - ανιόν
Ankara - Άγκυρα
Anna - Άννα
anoda - άνοδος
anoreksja - ανορεξία , ανορεξιά
antagonizm - ανταγωνισμός
Antananarywa - Ανταναναρίβο
Antares - Αντάρες
Antarktyda - Ανταρκτική
antena - κεραία
antidotum - αντίδοτο
Antigua i Barbuda - Αντίγκουα και Μπαρμπούντα
antonim - αντώνυμο
Antoni - Αντώνιος, Αντώνης
antrakt - διάλειμμα
antropologia - ανθρωπολογία
antropomorfizm - ανθρωπομορφισμός
antropo- - ανθρωπο-, ανθρωπό-, ανθρωπ-
Antwerpia - Αμβέρσα
antybiotyk - αντιβιοτικό
antycypacja - πρόβλεψη
antyfaszystowski - αντιφασιστικός
antygen - αντιγόνο
antyimperialistyczny - αντιιμπεριαλιστικός
antyklerykalizm - αντικληρικαλισμός
antyklerykalny - αντικληρικός
antykoagulant - αντιπηκτικό
antykwariat - παλαιοπωλείο ; παλαιοβιβλιοπωλείο
antykwariusz - παλαιοπώλης , παλαιοβιβλιοπώλης
Antyle Holenderskie - Ολλανδικές Αντίλλες
antylopa - αντιλόπη
antymateria - αντιύλη
antymon - αντιμόνιο
antypapież - αντίπαπας
antypoślizgowy - αντιολισθητικός
antysemita - αντισημίτης
anyż - γλυκάνισο
aorta - αορτή
aoryst - αόριστος
aparat fotograficzny - φωτογραφική μηχανή
apatia - απάθεια
Apeniny - Απέννινα
apetyt rośnie w miarę jedzenia - τρώγοντας έρχεται η όρεξη
apetyt - όρεξη ; όρεξη
Apia - Άπια
apodyktyczny - κατηγορηματικός, αναμφισβήτητος
apograf - απόγραφο
apokopa - αποκοπή
apokryf - απόκρυφα βιβλία
Apollo - Απόλλων ; Απόλλων
apologia - απολογία
apostazja - αποστασία
apostoł - απόστολος
apostrof - απόστροφος
apoteoza - αποθέωση
aprobata - επιδοκιμασία , έγκριση
apsyda - αψίδα
apteczka - φαρμακείο
aptekarka - φαρμακοποιός
aptekarz - φαρμακοποιός
apteka - φαρμακείο
Arabia Saudyjska - Σαουδική Αραβία
arabski - αραβικά ; αραβικός
Arab - Άραβας
Aragonia - Αραγονία
arbiter - διαιτητής
arbuz - καρπουζιά ; καρπούζι
archanioł - αρχάγγελος
archeologia - αρχαιολογία
archeologiczny - αρχαιολογικός
archipelag - αρχιπέλαγος
architektura - αρχιτεκτονική
architekt - αρχιτέκτονας
archiwolta - περίζωμα αψίδας
arcybiskup - μητροπολίτης , αρχιεπίσκοπος
areopag - Άρειος Πάγος
aresztować - συλλαμβάνω
aresztowanie - σύλληψη
Ares - Άρης
Argentyna - Αργεντινή
Argentyńczyk - Αργεντινός
Argentynka - Αργεντινή
argon - αργό
argument - επιχείρημα ; όρισμα
Ariadna - Αριάδνη
aria - άρια
Arkadia - Αρκαδία
Arkadiusz - Αρκάδιος
Arka Noego - κιβωτός του Νώε
arkebuz - αρκεβούζιο
Arktyka - Αρκτική
arkusz kalkulacyjny - λογιστικό φύλλο
Armagedon - Αρμαγεδδών/Αρμαγεδών
armata - κανόνι
Armeńczyk - Αρμένιος , Αρμένης
Armenia - Αρμενία
armeński - αρμένικος, αρμενικός
armia - στρατός [straˈto̞s] , στράτευμα [ˈstrate̞vˌma] , στρατιά [straˈtça]
arogancja - αλαζονεία
arsen - αρσενικό
Artemida - Άρτεμις
arteria - αρτηρία ; αρτηρία
Artur - Αρθούρος
artykuły gospodarstwa domowego - οικιακή συσκευή|οικιακές συσκευές
artykuł - άρθρο; προϊόν
artysta - καλλιτέχνης
Aruba - Αρούμπα
Arystokles - Αριστοκλής
Arystoteles - Αριστοτέλης
asekurant - υπολογιστής , συμφεροντολόγος
asfalt - άσφαλτος
aspiryna - ασπιρίνη
asteroida - αστεροειδής ; αστεροειδής
asterysk - αστερίσκος
astmatyk - ασθματικός
astma - άσθμα
astrologia - αστρολογία
astrolog - αστρολόγος
astronomia - αστρονομία
astronomiczny - αστρονομικός; αστρονομικός
asymetryczny - ασύμμετρος
asymptota - ασύμπτωτη
Asyria - Ασσυρία
Asyż - Ασίζη
ateista - άθεος , αθεϊστής
ateizm - αθεϊσμός
Atena - Αθηνά
ateńczyk - Αθηναίος
atenka - Αθηναία
ateński - αθηναίικος, αθηναϊκός
Ateny - Αθήνα
Atlantyda - Ατλαντίδα
Atlantyk - Ατλαντικός
atlas - άτλαντας
Atlas - Άτλας , Άτλαντας
atmosfera - ατμόσφαιρα
atmosferyczny - ατμοσφαιρικός
atom - άτομο
atrament sympatyczny - συμπαθητική μελάνη
atrament - μελάνι
atrofia - ατροφία
atut - ατού ; ατού
audycja - εκπομπή
Augustyn - Αυγουστίνος
aukcja holenderska - δημοπρασία ολλανδικού τύπου
aukcja - πλειστηριασμός
auksyna - αυξίνη
aulos - αυλός
aura - αύρα
Australia - Αυστραλία ; Αυστραλία
Australijczyk - Αυστραλέζος , Αυστραλός
Australijka - Αυστραλή , Αυστραλέζα
australijski - αυστραλιανός
Austriaczka - Αυστριακή
Austriak - Αυστριακός
Austria - Αυστρία
autobiografia - αυτοβιογραφία
autobusowy - λεωφορειακός
autobus - λεωφορείο
autodafe - άουτο ντα φε
autoportret - αυτοπροσωπογραφία
autopsja - αυτοψία
autostopowicz - άντρας που κάνω|κάνει οτοστόπ
autostop - ωτοστόπ , οτοστόπ
autostrada - εθνικός|εθνική οδός
autyzm - αυτισμός
awalista - εγγυητής
awantura - φασαρία
awaria - βλάβη , αβαρία
awersja - απέχθεια , αντιπάθεια
Awinion - Αβινιόν
awokado - αβοκάντο
azerbejdżański - αζερικός
Azerbejdżan - Αζερμπαϊτζάν
Azja Mniejsza - Μικρά Ασία
azjatycki tygrys - ασιατικός τίγρης
Azja - Ασία
Azory - Αζόρες
azot - άζωτο
azyl - άσυλο; άσυλο
a - και
babcia - γιαγιά
babiarz - μουνάκιας
babka - κέικ
bać się - φοβάμαι; φοβάμαι
bączek - μικροτσικνιάς ; βαρκάκι
badać - εξετάζω
badminton - μπάντμιντον
bagaż - αποσκευή|αποσκευές
Bagdad - Βαγδάτη
bagnet - μπαγιονέτα
Bahamy - Μπαχάμες
Bahrajn - Μπαχρέιν
bajka - παραμύθι
bakcyl - βάκιλος
bakelit - βακελίτης
baklawa - μπακλαβάς
bakłażanowy - μελιτζάνα|μελιτζάνας; μελιτζανής
bakłażan - μελιτζάνα
bakteria - βακτήριο , βακτηρίδιο
bakteriolog - βακτηριολόγος /
Baku - Μπακού
bak - ρεζερβουάρ , ντεπόζιτο ; φαβορίτα|φαβορίτες
bałagan - ανακατωσούρα
balanga - πάρτι
balet - μπαλέτο
Bałkany - Βαλκάνια
balkon - μπαλκόνι
balon - αερόστατο , μπαλόνι
balsam - βάλσαμο , μπάλσαμο ; βάλσαμο , μπάλσαμο , παρηγοριά
bałtycki - βαλτικός
balustrada - κιγκλίδωμα , χαμηλός|χαμηλό παραπέτο
bałwan - χιονάνθρωπος ; κουτός
bal - χοροεσπερίδα , χορός
bambus - μπαμπού
banan - μπανανιά ; μπανάνα
bandaż - επίδεσμος
banda - συμμορία
Bangladesz - Μπανγκλαντές
bańka mydlana - σαπουνόφουσκα
bank krwi - τράπεζα αίματος
banknot - χαρτονόμισμα , τραπεζογραμμάτιο
bankomat - μηχάνημα ανάληψης μετρητών , αυτόματη ταμειολογιστική μηχανή
bankructwo - πτώχευση , χρεωκοπία
bank - τράπεζα
Baranek Boży - αμνός του Θεός|Θεού
baranina - πρόβειος|πρόβειο κρέας
baran - κριάρι , κριός ; βλάκας
Baran - Κριός ''Kriós''; Κριός ''Kriós''
Barbados - Μπαρμπάντος
Barbara - Βαρβάρα
Barcelona - Βαρκελώνη
bardzo - πολύ; πιο
bard - βάρδος ; βάρδος
bark - ώμος
barman - μπάρμαν
baron - βαρόνος
barszcz - μπορς
barykada - οδόφραγμα
bar - μπαρ ; μπαρ ; βάριο
basen - πισίνα , κολυμβητήριο
Bask - Βάσκος
baśń - παραμύθι
batalion - μοίρα ; ψευτομαχητής
bateria - μπαταρία , συσσωρευτής ; συστοιχία πυροβόλων , μονάδα πυροβολικού ; συστοιχία
batuta - ράβδος
batyskaf - βαθυσκάφος
Bawaria - Βαβαρία , Βαυαρία , Μπάγερν
bawarski - βαβαρικός
bawełna - βαμβακιά , βαμβάκι ; βαμβάκι , μπαμπάκι
bawić się ptaszkiem - παίζω το πουλί μου
bawić - τέρπω, διασκεδάζω
bażant - φασιανός
Bazylea - Βασιλεία
beczka Diogenesa - πιθάρι του Διογένη
beczka - βαρέλι
bednarstwo - βαρελοποιία
behawiorysta - συμπεριφοριστής
Bejrut - Βηρυτός
bękart - μπάσταρδος
Belgia - Βέλγιο
Belgijka - Βελγίδα
belgijski - βέλγικος
Belgrad - Βελιγράδι
Belg - Βέλγος
Belize - Μπελίζε , Μπελίσε , Μπελίζ
belona - ζαργάνα
bemol podwójny - διπλή ύφεση
bemol - ύφεση , μπεμόλ
Benin - Μπενίν
benzyna - βενζίνη
Beocja - Βοιωτία
Berber - Βέρβερος
beret - μπερές , μπερέ
Berlin - Βερολίνο
Bermudy - Βερμούδες
Berno - Βέρνη
beryl - βηρύλλιο
bestia - κτήνος ; κτήνος
beta - βήτα
Betlejem - Βηθλεέμ
betoniarka - μπετονιέρα ; μπετονιέρα
beton - σκυρόδεμα , μπετόν
bezbarwny - άχρωμος
bezbożnik - άθρησκος, ασεβής
bezbożność - απιστία
bezbronny - ανυπεράσπιστος, απροστάτευτος
bezdomny - άστεγος
bez ogródek - χωρίς περιστροφές
bezokolicznik - απαρέμφατο
bezowocny - άκαρπος
beżowy - μπεζ
bezpiecznik - ασφάλεια
bezrobocie - ανεργία
bezsenność - αϋπνία , αγρύπνια
bezsens - ανοησία
bezwładność - αδράνεια
bez wytchnienia - αδιάκοπα, χωρίς ανάπαυση, χωρίς ανάσα
bezwzględny - απόλυτος
beż - μπεζ
bez - σαμπούκος ; πασχαλιά ; χωρίς, δίχως, άνευ
Bhutańczyk - Μπουτανέζος
Bhutanka - Μπουτανέζα
bhutański - μπουτανικός, μπουτανέζικος
Bhutan - Μπουτάν
biała flaga - λευκή σημαία
biała śmierć - λευκός θάνατος
białko - ασπράδι ; ασπράδι ; πρωτεΐνη
białoruski - λευκορωσικός; λευκορωσικός|λευκορωσικά
Białoruś - Λευκορωσία
białorzytka - σταχτοπετρόκλης
białoskórnictwo - σκυτολευκαντική
białozór - ασπρογέρακας
biały kruk - σπάνιο είδος ; σπάνιος άνθρωπος
biały ser - ανθότυρο
biały węgiel - λευκός άνθρακας
biały - άσπρος, λευκός; λευκός; άσπρος
Biblia - Βίβλος
biblijny - βιβλικός
bibliotekarz - βιβλιοθηκάριος
biblioteka - βιβλιοθήκη
bić - χτυπάω, χτυπώ; κόβω
bidet - μπιντές
biedak - φτωχός; καημένος
bieda - φτώχεια
biedny - φτωχός; καημένος
biedronka - πασχαλίτσα
biegacz - δρομέας
biegunka - διάρροια
biegun - πόλος ; πόλος
bielik - θαλασσαετός
biel - λευκότητα , ασπράδα ; άσπρος|άσπρα ; λευκό
biernik - αιτιατική
bigoteria - θρησκομανία , θρησκοληψία
bilet - εισιτήριο
biochemia - βιοχημεία
biogeografia - βιογεωγραφία
biografia - βιογραφία
biologia - βιολογία
biolog - βιολόγος
biomasa - βιομάζα ; βιομάζα
biomedycyna - βιοϊατρική
biomedyczny - βιοϊατρικός
bioniczny - βιονικός
biopsja - βιοψία
bioróżnorodność - βιοποικιλότητα
biotyna - βιοτίνη
bio- - βιο-, βιό-
birmański - βιρμανικός
Birma - Βιρμανία , Μυανμάρ /, Μπούρμα
biskup - επίσκοπος
bitwa - μάχη
biurko - γραφείο
biurokracja - γραφειοκρατία
biuro podróży - γραφείο ταξιδίων
biustonosz - σουτιέν
bizmut - βισμούθιο
biznes - επιχείρηση
BJRM - ΠΓΔΜ
błąd - λάθος , σφάλμα ; σφάλμα
błagać - ικετεύω
błazen - γελωτοποιός ; παλιάτσος
błędne koło - φαύλος κύκλος
błękitna krew - γαλαζοαίματος, γαλάζιο αίμα
błękitna planeta - γαλάζιος πλανήτης
błękitnooki - γαλανομάτης
błękitny - γαλάζιος, γαλανός
Bliski Wschód - Μέση Ανατολή
bliski - κοντινός, γειτονικός, κολλητός; ''poprzez czasownik'' κοντεύω; όμοιος; συγγενής, στενός, κολλητός; κοντινός, επικείμενος, προσεχής
blisko - κοντά
bliźniak - δίδυμος ; Δίδυμος ; όμιος|όμοιες κατοικία|κατοικίες χωρίζω|χωριζόμενες με μεσοτοιχία
Bliźnięta - Δίδυμοι ''Dídymoi''
blok mieszkalny - πολυκατοικία
blondynka - ξανθός|ξανθιά
błonica sałatowa - θαλάσσιο μαρούλι
błonica - διφθερίτιδα
błotnik - λασπωτήρας , φτερό
błoto - λάσπη
bluszcz - κισσός
błyskawica - αστραπή
bóbr - κάστορας ; καστόρι
bobslej - έλκηθρο
bocian czarny - μαυροπελαργός
bociani - πελαργικός
bocian - πελαργός
bogactwo - πλούτος
bogaty - πλούσιος
Bóg bez pracy nic nie daje - συν Αθηνά και χείρα κίνει
bogini - θεά
bóg - θεός
Bóg - Θεός
bohater dnia - ήρωας της ημέρας
bohaterka - ηρωίδα
bohaterstwo - ηρωισμός
bohater - ήρωας
bohr - μπόριο
boje homeryckie - ομηρικός καβγάς
bójka - καβγάς , συμπλοκή
bojownik - στρατιώτης
boks - διαμέρισμα στάβλος|στάβλου; πυγμαχία ; πιτ στοπ
boleć - πονώ
Boliwia - Βολιβία
Boliwijczyk - Βολιβιανός
Boliwijka - Βολιβιανή
boliwijski - βολιβιανός
ból - πόνος ; λύπη
bomba lotnicza - βόμβα
bombardować - βομβαρδίζω
bomba - βόμβα ; βόμβα
bombka - μπάλα
bombowiec - βομβαρδιστικός|βομβαρδιστικό αεροσκάφος
bon mot - εξυπνάδα
bordo - μπορντό
borsuk - ασβός
bosak - γάντζος πλοίο|πλοίου
Bośnia i Hercegowina - Βοσνία και Ερζεγοβίνη , Βοσνία-Ερζεγοβίνη
bosy - ξυπόλυτος
botaniczny - βοτανικός
botanika - φυτολογία
Botswana - Μποτσουάνα
Boże Narodzenie - Χριστούγεννα
brachylogia - βραχυλογία
brachyterapia - βραχυθεραπεία
brać nogi za pas - βάζω τα πόδια στον ώμο
brać - παίρνω, παίρνω, παίρνω, παίρνω, παίρνω, παίρνω, παίρνω, παίρνω, παίρνω, παίρνω, παίρνω
brak miesiączki - αμηνόρροια
brak - έλλειψη , απουσία ; ελάττωμα , μειονέκτημα
bramkarz - τερματοφύλακας
bratanek - ανεψιός , ανιψιός
bratanica - ανεψιά , ανιψιά
bratek - πανσές ; αδελφούλης , αδερφούλης
bratnia dusza - αδελφή ψυχή
bratowa - νύφη
Bratysława - Μπρατισλάβα
brat - αδελφός , αδερφός
brawo - μπράβο
brązowy medal - χάλκινο μετάλλιο
brązowy - καστανός, καφέ; μπρούντζινος, χάλκινος; χάλκινος
Brazylia - Βραζιλία
Brazylijczyk - Βραζιλιάνος
Brazylijka - Βραζιλιάνα
brąz - χαλκός
Bretania - Βρετάνη
brew - φρύδι
broda - πιγούνι ; γένι
brodziec śniady - μαυρότρυγγας , μαυρότρυγας
bród - πόρος , πορθμείο
broszura - φυλλάδιο
brudny - βρόμικος; βρόμικος
brud - βρόμα
Bruksela - Βρυξέλλες
brukselka - λάχανο Βρυξελλών
bruk - καλντερίμι
Brunei - Μπρουνέι
brunet - μελαχρινός
brydż - μπριτζ
Brytyjskie Wyspy Dziewicze - Βρετανικές Παρθένοι Νήσοι
brytyjski - βρετανικός
brzeg - όχθη ; άκρη
brzmienie - ήχος
brzoskwinia - ροδάκινο
brzoza - σημύδα
brzuch - κοιλιά
brzytwa - ξυράφι κουρέα
bucik - παπουτσάκι
Budapeszt - Βουδαπέστη
buddyzm - βουδισμός
budynek - κτίριο
budzić - ξυπνώ
budzik - ξυπνητήρι
Bukareszt - Βουκουρέστι
buk - οξιά
Bułgaria - Βουλγαρία
Bułgarka - Βουλγάρα
bułgarski - βουλγαρικός, βουλγάρικος; βουλγαρικά
Bułgar - Βούλγαρος
bułka - ψωμάκι
bunt - ανταρσία , εξέγερση ; αντίρρηση
burak cukrowy - ζαχαρότευτλο
burak - τεύτλο , παντζάρι
burdel - μπουρδέλο , μπορντέλο ; κωλοχανείο
Burkina Faso - Μπουρκίνα Φάσο
burmistrz - δήμαρχος
bursztyn - κεχριμπάρι , ήλεκτρο
Burundi - Μπουρούντι
burza w szklance wody - τρικυμία σ' ένα ποτήρι νερό
burza - καταιγίδα
Buszmen - Βουσμάνος
butan - βουτάνιο
butelka - μπουκάλι
but - παπούτσι
buzuki - μπουζούκι ; μπουζούκι
być bez grosza przy duszy - μένω πανί με πανί
być - είμαι
bydło - γελάδι|γελάδια ; όχλος , αλητεία , πλέμπα
byk - ταύρος
Byk - Ταύρος; Ταύρος
Była Jugosłowiańska Republika Macedonii - Πρώην Γιουγκοσλαβική Δημοκρατία της Μακεδονίας ''Prōën Giugkoslavikē Dëmokratía tës Makedonías''
były - πρώην
bzdura - βλακεία , ανοησία
cacyki - τζατζίκι
całka - ολοκλήρωμα
cały i zdrowy - σώος και αβλαβής
cal - ίντσα
capstrzyk - σιωπητήριο
car - τσάρος
cebula - κρεμμύδι
cecha - χαρακτηριστικό ; ιδιότητα
Cefeusz - Κηφεύς ; Κηφεύς ; Κηφεύς
cegła - τούβλο , πλίνθος
ceklownik - νυχτοπαρωρίτης , νυχτοκόπος
cela - κελί
celnik - τελωνειακός
celofan - σελοφάν , κελοφάνη
celować - σημαδεύω
celownik - σκόπευτρο ; δοτική
cel uświęca środki - ο σκοπός αγιάζει τα μέσα
cement - τσιμέντο
cena - τιμή
cenotaf - κενοτάφιο
centaur - κένταυρος
centrum - κέντρο
centurion - εκατόνταρχος
cent - σεντ , λεπτό
Ceres - Κέρες , αστεροειδής Δήμητρα , Δήμητρα ; Κέρες , Δήμητρα
cer - δημήτριο
cesarskie cięcie - καισαρική
cesarzowa - αυτοκρατόρισσα , αυτοκράτειρα
cesarz - αυτοκράτορας
cewka moczowa - ουρήθρα
cewnik - καθετήρας
chałwa - χαλβάς
chaos - χάος
charakter - χαρακτήρας
Charków - Χάρκιβ
Charon - Χάρος , Χάροντας , Χάρων ; Χάρων
charytatywny - φιλανθρωπικός
chcieć - θέλω
chciwość - αχορτασιά , αχορταγιά , απληστία
chciwy - πλεονέκτης, άπληστος
chęć - θέληση , προθυμία
chemia - χημεία
chemiczny - χημικός
chemioterapia - χημειοθεραπεία
Cheronea - Χαιρώνεια
Cheroneja - Χαιρώνεια
Chile - Χιλή
Chilijczyk - Χιλιανός
Chimera - Χίμαιρα
Chińczyk - Κινέζος
chinina - κινίνη
Chinka - Κινέζα
Chińska Republika Ludowa - Λαϊκή Δημοκρατία της Κίνας
chiński - κινέζικος; κινεζικά , κινέζικα
Chiny - Κίνα
chirurgia kosmetyczna - κοσμητική χειρουργική
chirurgia plastyczna - πλαστική χειρουργική
chirurgia - χειρουργική
chirurgiczny - χειρουργικός
chirurg - χειρουργός , χειρούργος
chi - χι
chlebak - ψωμιέρα
chleb powszedni - επιούσιος άρτος
chleb - ψωμί
chłopak - παιδί , αγόρι
chłopczyk - πιτσιρίκος , πιτσιρικάς
chłopiec - αγόρι
chlor - χλώριο
chmiel - λυκίσκος
chmura - σύννεφο
chociaż - αν και, μολονότι; τουλάχιστον
chodnik - πεζοδρόμιο ; χαλί ; γαλαρία
chodzić spać z kurami - κοιμάμαι με τις κότες
chód - βάδιση ; βάδην
choinka - χριστουγεννιάτικο δέντρο
cholera - χολέρα; διάολος/διάβολος
chorał - κοράλ
choroba Parkinsona - νόσος του Πάρκινσον , πάρκινσον
choroba - ασθένεια , αρρώστια , νόσος , νόσημα , πάθηση
chorobotwórczy - παθογόνος
chorowity - αρρωστιάρης, αρρωστιάρικος
Chorwacja - Κροατία
chorwacki - κροατικός
Chorwatka - Κροάτισσα
Chorwat - Κροάτης
chory - άρρωστος
chór - χορωδία ; ψαλτήρι ; ιερό
chowany - κρυφτό
chrapać - ροχαλίζω
chromatyna - χρωματίνη
chronić - προστατεύω, προφυλάγω
Chrystus - Χριστός
Chryzostom - Χρυσόστομος
chrząszcz - σκαραβαίος ; σκαραβαίος
chrześcijanin - χριστιανός
chrześcijański - χριστιανικός
chrześcijaństwo - χριστιανισμός ; χριστιανοσύνη
chrzest - βάφτισμα
chuchro - μπάμια
chude lata - εποχή των ισχνών αγελάδων
chudy - αδύνατος, λεπτός; άπαχος
chuj ci w dupę - γαμήσου
chuj - πούτσος ; βλάκας
chusteczka - μαντίλι
chustka - μαντίλα , μαντίλι
chwalić - επαινώ, εγκωμιάζω; δοξάζω, δοξολογώ
chybiać - αστοχώ
ciąć - κόβω; κεντρίζω, κεντώ, τσιμπώ
ciągnąć druta - κάνω μια πίπα
ciągnąć - σέρνω, τραβώ
ciąg - σειρά ; ακολουθία , πρόοδος
ciało niebieskie - ουράνιο σώμα
ciało - σώμα ; σορός
ciasnogłowy - στενοκέφαλος
ciąża - εγκυμοσύνη
cicho - σιγά, σιγανός|σιγανά, σιωπηλός|σιωπηλά; ήσυχος|ήσυχα; σιωπή!
cichy - αθόρυβος, '''' σιωπηλός; '''' χαμηλός
ciecz łzowa - δακρυϊκό υγρό
ciecz - υγρό
cielęcina - μοσχάρι ; μοσχάρι ; μοσχάρι , κουτός, βλάκας
ciemność - σκοτάδι
ciemny - σκούρος; μελαχρινός; κουτός, τούβλο
cienki - ψιλός
cień - σκιά ; σκιά ; σκιά ; σκιά ; σκιά ; σκιά
ciepło - θερμότητα ; ζεστά, φιλικά
cierlik - σιρλοτσίχλονο
cierpieć - πονώ, ζω
cierpienie - βάσανο
cierpliwość - υπομονή , ανεκτικότητα ; υπομονή , εμμονή
cietrzew - λυροπετεινός
ciężarówka - φορτηγό
ciężar - βάρος
ciocia - θεία
cios - χτύπημα ; πλήγμα
cipa - μουνί
ciśnienie - πίεση ; αρτηριακή πίεση
cisza - σιγή , σιωπή
cis - τάξος
ciuciubabka - τυφλόμυγα
cło - δασμός
cmentarz - κοιμητήριο , νεκροταφείο
cnota - αρετή
codziennie - καθημερινά
codzienny - καθημερινός
cokolwiek - τίποτα
co nagle, to po diable - κάλλιο αγάλια και καλά παρά γρήγορα και τυφλά
córeczka - κορούλα
córka - κόρη , θυγατέρα
coroczny - ετήσιος, χρονιάτικος
coś - κάτι, κατιτί
cudowny - θαυμάσιος
cudzoziemiec - ξένος , αλλοδαπός
cudzysłów - εισαγωγικά
cudzy - ξένος
cud - θαύμα
cukierek - καραμέλα
cukiernica - ζαχαριέρα
cukier puder - ζάχαρη σε σκόνη
cukier - ζάχαρη
cukinia - κολοκυθάκι
cukrownia - εργοστάσιο ζάχαρη|ζάχαρης
ćwiczenie - άσκηση
ćwierćnuta - τέταρτο
ćwierć - τέταρτο
cyberprzestrzeń - κυβερνοχώρος
cyferblat - πλάκα ρολόι|ρολογιού
cyfra - ψηφίο
cykada - τζίτζικας , τζιτζίκι
cyklamat - κυκλαμικό νάτριο
cynamonowy - κανελής; από κανέλα
cynamon - κανέλα
cyna - κασσίτερος
cynik - κυνικός ; κυνικός
cynk - ψευδάργυρος
cyprofloksacyna - κιπροφλοξακίνη
Cypryjczyk - Κύπριος , Κυπραίος , Κυπριώτης
Cypryjka - Κύπρια , Κυπραία , Κυπριώτισσα
Cypr - Κύπρος
cyranka - σαρσέλα
cyrkiel - διαβήτης
cyrkon - ζιρκόνιο
Cyryl - Κύριλλος
cytat - παραπομπή
cytra - κιθάρα , σαντούρι
cytryna - λεμόνι ; λεμονιά
cywilny - πολιτικός; αστικός
cywil - πολίτης
cyzelować - γλύφω
cząber - θρούμπι
czajka - καλημάνα
czajnik - τσαγιέρα , τσαγερό
czarna dziura - μαύρη τρύπα
czarna jagoda - βακκίνιο , μύρτιλλος ; βακκίνιο το μύρτιλλο
czarna owca - μαύρο πρόβατο
czarna porzeczka - φραγκοστάφυλο μαύρο
Czarnogóra - Μαυροβούνιο
czarnogórski - μαυροβούνιος
Czarnogórzanin - Μαυροβούνιος
Czarnogórzanka - Μαυροβούνια
Czarnogórzec - Μαυροβούνιος
czarnooki - μαυρομάτης
czarny humor - μαύρο χιούμορ
czarny rynek - μαύρη αγορά
czarny - μαύρος
czarownica - μάγισσα
czarujący - γοητευτικός, μαγευτικός
czasem - καμιά φορά
czasopismo - περιοδικό
czasownik nieprzechodni - αμετάβατο ρήμα
czasownikowy - ρηματικός
czasownik posiłkowy - βοηθητικό ρήμα
czasownik przechodni - μεταβατικό ρήμα
czasownik - ρήμα
czas teraźniejszy - ενεστώτας
cząstka - υποκοριστικό η|της λέξη|λέξης τμήμα / μέρος ; μόριο , σωματίδιο
czas to pieniądz - ο χρόνος είναι χρήμα
czaszka - κρανίο
czas - χρόνος
czatować - καιροφυλαχτώ; κουβεντιάζω
czcionka - στοιχείο ; χαρακτήρας
Czechosłowacja - Τσεχοσλοβακία ''Tsechoslovakía''
Czechy - Τσεχία ''Tsechía''; Βοημία ''Boëmía''
Czech - Τσέχος
czekać - περιμένω; περιμένω
czekolada - σοκολάτα
czekoladowy - σοκολατένιοσ
czereśnia - κερασιά ; κεράσι
czerwiec - Ιούνιος, Ιούνης
czerwona porzeczka - φραγκοστάφυλο ερυθρό
czerwonawy - κοκκινωπός, ερυθρωπός
Czerwony Krzyż - Ερυθρός Σταυρός
czerwony olbrzym - ερυθρός γίγαντας
czerwony - κόκκινος, ερυθρός
czesać - χτενίζω
część mowy - μέρος του λόγου
część - μέρος ; εξάρτημα
cześć - τιμή , σεβασμός ; γεια εσύ|σου, γεια εσείς|σας
czeski - τσέχικος; τσέχικα , τσεχικά
częstotliwość - συχνότητα
często - συχνά
częsty - συχνός
Czeszka - Τσέχα
czkawka - λόξυγκας , λόξιγκας
członek - μέλος ; μέλος
człowiek - άνθρωπος ; άνθρωπος
czołg - τανκ , άρμα
czoło - μέτωπο
czosnek - σκόρδο
czterokrotnie - τετράκις
czterosylabowy - τετρασύλλαβος
czwarta władza - τέταρτη εξουσία
czwartek - Πέμπτη
czwartorzęd - Τεταρτογενές
czworokąt - τετράπλευρο
czworonóg - τετράποδο
czynsz - ενοίκιο , νοίκι
czyścibut - λούστρος
czyściec - καθαρτήριο
czystość - καθαρότητα
Czysty Poniedziałek - Καθαρή Δευτέρα , Καθαρά Δευτέρα
czysty - καθαρός; καθαρός
czytać - διαβάζω
czytelnik - αναγνώστης
czyżyk - λούγαρο
czy - μήπως; αν; ή
dąb - βαλανιδιά , βελανιδιά , δρυς ; ξύλο βαλανιδιά|βαλανιδιάς
dach - στέγη , σκεπή
dać - δίνω; αφήνω
Dagestan - Δημοκρατία του Νταγκεστάν
daktyl - χουρμάς
Daleki Wschód - Άπω Ανατολή
daleko - μακριά
dama - βασίλισσα
dane - δεδομένα
Dania - Δανία , Δανιμαρκία
danie - φαγητό
darmo - δωρεάν, τσάμπα; μάταιος|μάταια, άδικος|άδικα
darowanemu koniowi w zęby się nie zagląda - καποιανού του χαρίζανε ένα γάιδαρο κι αυτός τον κοίταζε στα δόντια
dawać sobie radę - καταφέρνω
dawca - δότης ; δότης
Dawid - Δαβίδ
dawnymi czasy - άλλοτε
decydować - αποφασίζω
decyzja - απόφαση
defekt - ελάττωμα
defenestracja - εκπαραθύρωση
defetyzm - ντεφετισμός
defibrylator - απινιδωτής
defilada - παρέλαση ; επίδειξη
deforestacja - εκδάσωση
degradować - υποβιβάζω
Deimos - Δείμος
deizm - ντεϊσμός
dekada - δεκαετία , δεκάδα
dekalog - δεκάλογος
deklaracja - δήλωση ; διακήρυξη
deklinacja - κλίση , απόκλιση
dekolt - ντεκολτέ
dekret - διάταγμα
delfin - δελφίνι ; πεταλούδα δελφίνος
delikt - αδίκημα
delta - δέλτα ; δέλτα
demagogia - δημαγωγία
demagog - δημαγωγός /
Demeter - Δήμητρα ; Δήμητρα
Demetriusz - Δημήτρης , Δημήτριος
demobilizacja - αποστράτευση
demografia - δημογραφία
demokracja - δημοκρατία
demokrata - δημοκρατικός
Demokratyczna Republika Konga - Λαϊκή Δημοκρατία του Κονγκό , Λαοκρατική Δημοκρατία του Κονγκό , Κονγκό-Κινσάσα
Demokratyczna Republika Wyspy Świętego Tomasza i Wysp Świętego Tomasza i Książęcej - Λαϊκή Δημοκρατία του Αγίου Θωμά και Πρίγκιπα , Λαϊκή Δημοκρατία του Σάο Τομέ και Πρίνσιπε
demokratyczny - δημοκρατικός
demokratyzacja - εκδημοκρατισμός
demonstrant - διαδηλωτής
dendrologia - δενδρολογία
dentysta - οδοντίατρος
denuncjować - αποκαλύπτω
depilacja - αποτρίχωση
deportacja - εξορία
deportować - εξορίζω
deprymować - ταπεινώνω
derby - ντέρμπι
derkacz - ορτυκομάνα
dermatologia - δερματολογία
dermatolog - δερματολόγος
desensytyzacja - απευαισθητοποίηση
deser - επιδόρπιο
deskorolka - τροχοσανίδα
destabilizacja - αποσταθεροποίηση
destrukcyjny - καταστρεπτικός
deszczomierz - βροχόμετρο
deszcz - βροχή
detal - λεπτομέρεια ; λιανεμπόριο , λιανική
detektyw - ντετέκτιβ , ιδιωτικός αστυνομικός
dętka - σαμπρέλα ; σαμπρέλα
dezynfekować - απολυμαίνω
diabeł - διάβολος , σατανάς , δαίμονας
diabetyk - διαβητικός
diagram - διάγραμμα
dialekt - διάλεκτος
dialog - διάλογος
diament - διαμάντι
diaspora - διασπορά
dielektryk - διηλεκτρικό , διηλεκτρικός|διηλεκτρικό υλικό
dieta - δίαιτα
dihydralazyna - διυδραλαζίνη
dinozaur - δεινόσαυρος
dioda - δίοδος
diuna - αμμόλοφος
dlaczego - γιατί
dla - για; για
dłoń - παλάμη
dmuchać - φυσώ; πηδώ
dno - κώλος
doba - εικοσιτετράωρο
dobra, dobra - καλά
dobranoc - καληνύχτα , καληνύκτα
dobra - καλά, εντάξει, γίνομαι|έγινε
dobroć - καλοσύνη
dobry wieczór - καλησπέρα
dobry - καλός
dobrze - καλά
dochód narodowy - εθνικό εισόδημα
dochód - εισόδημα , προϊόν
dodawanie - πρόσθεση ; πρόσθεση ; πρόσθεση
do dupy - του κώλου
do góry nogami - άνω κάτω
doić - αρμέγω
dojrzały - ώριμος
dokładnie - ακριβώς, επακριβώς
dokładny - ακριβής
dokonać - επιτελώ, εκτελώ; πραγματοποιώ
dokument - έγγραφο
dolar - δολάριο
dołek - λακκούβα , γούβα : λακκάκι
dolewać oliwy do ognia - ρίχνω λάδι στη φωτιά
dolina - κοιλάδα
dolmen - ντολμέν
dolny - κάτω
dół - γούβα , λάκκος
dom akademicki - φοιτητική εστία
dom dziecka - ορφανοτροφείο
domena publiczna - κοινό κτήμα
Dominikana - Δομινικανή Δημοκρατία
Dominikanka - Δομινικανή
Dominika - Ντομίνικα , Δομίνικα
domowy - σπιτικός, σπιτίσιος, κατοικίδιος
dom publiczny - οίκος ανοχής
dom starców - γηροκομείο
dom - σπίτι ; οίκος ; κατάστημα
doniczka - γλάστρα
Donieck - Ντονιέτσκ
dopełniacz - γενική
dopełnienie - συμπλήρωμα ; αντικείμενο
dorada - τσιπούρα
dosłownie - κυριολεκτικός|κυριολεκτικά, κατά λέξη, πιστός|πιστά, κατά γράμμα
dostawca - προμηθευτής
dostępny - ευπρόσιτος, προσιτός, προσηνής, προσπελάσιμος; εφικτός; προσιτός
dostęp - πρόσβαση
dostojnik - αξιωματούχος
doświadczalny - πειραματικός
dotyk - αφή
do widzenia - γεια, αντίο, χαίρετε, εις το επανιδείν
dowód osobisty - ταυτότητα , δελτίο ταυτότητας
dragon - δραγόνος ; αλόγα
drakońskie prawa - δρακόντειοι νόμοι
dramaturg - δραματουργός
dram - ντραμ
drapacz chmur - ουρανοξύστης
dreszcz - ρίγος
drewniak - ξυλοπάπουτσο , σαμπό
drewno - ξύλο
drezyna - δραιζίνα
drobne - ψιλά
Droga Mleczna - Γαλαξίας
droga - οδός , στράτα
drogi - ακριβός; αγαπητός
dromader - δρομάδα
drożdże - ζυμομύκητας , μαγιά ; ζύμη , προζύμι
druga strona medalu - η άλλη όψη του νομίσματος, η άλλη πλευρά του νομίσματος
druga wojna światowa - Β' Παγκόσμιος Πόλεμος
drukarka - εκτυπωτής
drukarnia - τυπογραφείο
drukować - εκτυπώνω, τυπώνω
drumla - άρπα των Εβραίων
drużyna - ομάδα
drwalnia - αποθήκη καυσόξυλο|καυσοξύλων
drylownica - αφαιρέτης κουκουτσιών
drzazga - αγκάθι , αγκίδα
drżeć - τρεμουλιάζω
drzemać - μισοκοιμάμαι, λαγοκοιμάμαι
drzewo - δέντρο
drzwi - πόρτα , θύρα
duchowo - πνευματικά
Duch Święty - Άγιο Πνεύμα
duch - πνεύμα
dudek - τσαλαπετεινός
dulka - σκαρμός
Dunaj - Δούναβης
Duńczyk - Δανός
Dunka - Δανή , Δανέζα
duński - δανέζικος, δανικός; δανέζικα
dupa - κώλος
dupek - παπάρης , μαλάκας
durszlak - σουρωτήρι
dusza - ψυχή
duża litera - κεφαλαίο
dużo - πολύς
duży pokój - σάλα , σαλόνι
duży - μεγάλος
dwoić się i troić - γίνομαι κομμάτια, γίνομαι χίλια κομμάτια
dwoinka zapalenia płuc - πνευμονόκοκκος
dworzec - σταθμός
dwubiegunowy - διπολικός
dwugodzinny - δίωρος
dwujęzyczny - δίγλωσσος
dwukropek - διπλή τελεία
dwumasztowy - δικάταρτος
dwunastnica - δωδεκαδάκτυλο
dwupłat - διπλάνο
dwusieczna - διχοτόμος
dwusylabowy - δισύλλαβος
dwutomowy - δίτομος
dwuznaczny - διφορούμενος
dwuznak - δίψηφο
dycha - δεκάρα
dyftong - δίφθογγος /
dymek - συννεφάκι , μπαλονάκι
dymić - καπνίζω
dymówka - σταυλοχελίδονο
dym - καπνός
dynia - κολοκυθιά ; κολοκύθα , κολοκύθι
dyplomata - διπλωμάτης
dyrektorka - διευθύντρια
dyrektor - διευθυντής ; ''w szkolnictwie średnim'' γυμνασιάρχης , λυκειάρχης
dyrygent - μαέστρος
dysforia - δυσφορία
dyskietka - δισκέτα
dysk twardy - σκληρός δίσκος
dyslalia - δυσλαλία
dysza - ακροφύσιο
dywan - χαλί , τάπητας ; διβάνι
dywiz - κεραία
dżdżownica - γεωσκώληκας
dzeta - ζήτα
dżezwa - μπρίκι
dziadek - παππούς
działo - κανόνι , πυροβόλο
dziąsło - ούλο
Dżibuti - Τζιμπουτί
dziczyzna - κυνήγι
dzieciarnia - παιδοθέμι , παιδολόγι
dziecięcy - παιδικός
dzieciobójca - παιδοκτόνος
dzieciobójczyni - παιδοκτόνος
dzięcioł - δρυοκολάπτης
dziecko - παιδί , τέκνο , τέκνον
dziedzina - τομέας , κλάδος ; πεδίο ορισμού , χωρίο
Dzieje Apostolskie - Πράξεις των Αποστόλων
dziękować - ευχαριστώ
dziękuję bardzo - ευχαριστώ πολύ , ευχαριστούμε πολύ
dziękuję - ευχαριστώ
dzielenie - διαίρεση
dzielić - διαιρώ; διαιρούμαι
dzielnica - συνοικία
dzieło - έργο
dzień dobry - καλημέρα , καλησπέρα
dziennikarz - δημοσιογράφος
dziennik - παρουσιολόγιο-βαθμολόγιο ; εφημερίδα ; είδηση|ειδήσεις , δελτίο ειδήσεων ; ημερολόγιο , σημειωματάριο ; λογιστικό βιβλίο ; ημερολόγιο σκάφους
dzień - ημέρα , μέρα
dziesiątkować - αποδεκατίζω; αποδεκατίζω
dziesięciolecie - δεκαετία ; δέκατος|δέκατη επέτειος
dziewczyna - κορίτσι
dziewica - παρθένα
dziki - άγριος
dzik - αγριογούρουνο
dżinsy - μπλουτζίν
dzioborożec - καλάο
dzisiaj - σήμερα
dzisiejszy - σημερινός; σύγχρονος, τωρινός
dziura - τρύπα ; '''' γούβα , λάκκος
dziurkacz - διακορευτής , περφορατέρ
dziwka - τσούλα
dziwny - παράξενος, σπάνιος
dżudo - τζούντο
dźwiękonaśladowczy - ηχομιμητικός
dźwięk - ήχος
dzwonek - καμπανάκι , καμπανούλα , κουδούνι ; κουδούνι ; καμπανούλα
dzwonnica - κωδωνοστάσιο , καμπαναριό
dzwon - καμπάνα
Ebro - Έβρος
echokardiografia - ηχοκαρδιογραφία
echolalia - ηχολαλία
Edirne - Αδριανούπολη
edredon - πουπουλόπαπια
edukacja - εκπαίδευση
Edward - Εδουάρδος
edytować - επεξεργάζομαι
efekt cieplarniany - φαινόμενο θερμοκηπίου
efemeryczny - εφήμερος
Efialtes - Εφιάλτης
egalitarysta - οπαδός η|της κοινωνικός|κοινωνικής ισότητα|ησότητας
egida - αιγίδα
Egipcjanin - Αιγύπτιος
Egipcjanka - Αιγύπτια
egipski - αιγυπτιακός
egiptolog - αιγυπτιολόγος /
Egipt - Αίγυπτος
egocentryk - εγωκεντρικός
egoista - εγωιστής
egoistka - εγωίστρια
egoistyczny - εγωιστικός
egzaltacja - εγκωμιασμός
egzamin - εξέταση
egzystencjalizm - υπαρξισμός
ejakulacja - εκσπερμάτωση
eklektyczny - εκλεκτικός
ekliptyczny - εκλειπτικός
ekliptyka - εκλειπτική
ekologia - οικολογία
ekonazol - εκοναζόλη
ekonomia - οικονομία
ekonomiczny - οικονομικός
ekran - οθόνη
ekshaustor - αναρροφητήρας , αναρροφητής αερίων
ekskomunikować - αφορίζω
ekspedientka - πωλήτρια
eksperymentalny - πειραματικός
eksplozja - έκρηξη
eksponat - έκθεμα
eksportować - εξάγω
ekspozycja - έκθεση
ekstaza - έκσταση
eksterminacja - εξόντωση , αφανισμός
ekstremizm - εξτρεμισμός
ekstremum - ακρότατο ; ακρότητα
Ekwador - Ισημερινός , Εκουαδόρ
elegancki - κομψός
elekcja - εκλογή
elektroda - ηλεκτρόδιο
elektrolit - ηλεκτρολύτης
elektroliza - ηλεκτρόλυση
elektroniczny - ηλεκτρονικός
elektron - ηλεκτρόνιο
elektrownia wodna - υδροηλεκτρικός σταθμός
elektryk - ηλεκτρολόγος
elementarz - αλφαβητάρι , αλφαβητάριο ; αλφαβητάρι , αλφαβητάριο
element - στοιχείο
elewacja - πρόσοψη ; ύψος
Eliasz - Ηλίας
elipsa - έλλειψη
elita - ελίτ
embargo - εμπάργκο
emerytura - σύνταξη
emeryt - συνταξιούχος
emigrantka - μετανάστρια
emigrant - μετανάστης
empiryczny - εμπειρικός
encyklopedia - εγκυκλοπαίδεια
energia jądrowa - πυρηνική ενέργεια
energia - ενέργεια
enigmatyczny - αινιγματικός
enologia - οινολογία
enolog - οινολόγος
entalpia - ενθαλπία
entomologia - εντομολογία
entropia - εντροπία
entuzjasta - ενθουσιαστής
entuzjastka - ενθουσιάστρια
enzym - ένζυμο
Eos - Ηώς
epidemia - επιδημία
epidemiologia - επιδημιολογία
epiderma - επιδερμίδα
epidiaskop - επιδιασκόπιο
epikureizm - επικουρισμός
epilepsja - επιληψία
epilog - επίλογος
epistoła - επιστολή
epistolografia - επιστολογραφία
epizod - επεισόδιο
epoka - εποχή
epolet - επωμίδα
epsilon - έψιλον
era - εποχή , περίοδος
Eris - Έρις, Έριδα; Έρις, Έριδα
Eros - Έρως , Έρωτας ; Έρως
erotyczny - ερωτικός
erozja - αποσάθρωση
erudycja - ευρυμάθεια , πολυμάθεια
erupcja - έκρηξη
erygować - ανεγείρω
Erytrea - Ερυθραία
erytrocyt - ερυθροκύτταρο
Erywań - Εριβάν
ESBC - Ε.Σ.Κ.Τ.
eseista - δοκιμιογράφος
esperanto - Εσπεράντο
esteta - εστέτ /
estetyka - αισθητική
Estończyk - Εσθονός
Estonia - Εσθονία
Estonka - Εσθονή
estoński - εσθονικός
eta - ήτα
eten - αιθένιο
Etiopczyk - Αιθίοπας
Etiopia - Αιθιοπία
etyka - ηθική
etylen - αιθυλένιο
etymologia - ετυμολογία
eufemizm - ευφημισμός
euforia - ευφορία
Eufrat - Ευφράτης
Eufrozyna - Ευφροσύνη ; Ευφροσύνη
Eugenia - Ευγενία
Eugeniusz - Ευγένιος
Euklides - Ευκλείδης
eurocent - λεπτό , σεντ
eurodeputowany - ευρωβουλευτής
Europa - Ευρώπη
Europejczyk - Ευρωπαίος
europejski - ευρωπαϊκός
eurosceptycyzm - ευρωσκεπτικισμός
eurosceptyk - ευρωσκεπτικός
eurowybory - ευρωεκλογές
euro - ευρώ
eutanazja - ευθανασία
Ewa - Εύα
Ezdrasz - Έσδρας
Ezop - Αίσωπος
ezoteryczny - εσωτερικός
fabryka - εργοστάσιο
facet - τύπος
facjata - σοφίτα ; φάτσα
fagot - φαγκότο
fajka - πίπα
faks - τέλεφαξ , φαξ
fala - κύμα
Falklandy - Νήσοι Φώκλαντ
fallus - φαλλός
falochron - κυματοθραύστης
fałszywy - πλαστός; φάλτσος; ψεύτικος
famotydyna - φαμοτιδίνη
fantastyczny - φανταστικός
fan - φαν /
faraon - φαραώ
farba - μπογιά
farmaceuta - φαρμακοποιός
farmaceutyczny - φαρμακευτικός
farmaceutyk - φάρμακο
farmacja - φαρμακευτική
farmakologia - φαρμακολογία
farsz - γέμιση , γέμισμα
fasola - φασόλι
faszysta - φασίστας
faszyzm - φασισμός
Fatima - Φατιμά ; Φάτιμα
federacja - ομοσπονδία
felga - ζάντα
fellatio - πεολειξία , πίπα
feminizm - φεμινισμός
Fenicjanin - Φοίνικας
Fenicjanka - Φοίνισσα
Fenicja - Φοινίκη
fenicki - φοινικικός; φοινικικά
Ferdynand - Φερδινάνδος
fermion - φερμιόνιο
ferm - φέρμιο
feromon - φερομόνη
festiwal - φεστιβάλ
feta - φέτα
fiasko - φιάσκο
Fidżi - Φίτζι
Fidżyjczyk - Φιτζιανός
Fidżyjka - Φιτζιανή
figa - σύκο
figowiec - φίκος ; συκιά
filipika - φιλιππικός
Filipiny - Φιλιππίνες
Filip - Φίλιππος
filiżanka - φλιτζάνι
filmoteka - φιλμοθήκη
film - ταινία ; ταινία
filologia - φιλολογία
filozofia - φιλοσοφία
filozoficzny - φιλοσοφικός
filozofka - φιλόσοφος
filozof - φιλόσοφος
filtr - φίλτρο
Finka - Φιλανδή , Φιλανδέζα
Finlandia - Φιλανδία
fiński - φινλανδικός, φιλανδικός; φινλανδικά, φιλανδικά
Fin - Φιλανδός
fitogeografia - φυτογεωγραφία
fizyka - φυσική
fizyk - φυσικός; φυσικός
fi - φι
flaga - σημαία
flanela - φανέλα
flauta - γαλήνη
flegmatyczny - φλεγματικός
flet - φλάουτο
Florencja - Φλωρεντία
flota - στόλος
-fobia - -φοβία
fobia - φοβία
Focjusz - Φώτιος
fok - φλόκος
folder - φάκελος ; μπροσούρα , φυλλάδιο
foliogram - διαφάνεια
folklor - φολκλόρ
fontanna - σιντριβάνι , αναβρυτήριο ; πίδακας
forma - μορφή , σχήμα ; φόρμα
forsa - μαλλί , παραδάκι
forteca - οχυρό , κάστρο
fortepian - πιάνο με ουρά
fortuna - τύχη ; τύχη
fosa - τάφρος
fosfor - φωσφόρος , φώσφορος
fosylizacja - απολίθωση
fotel - πολυθρόνα
Fotis - Φώτης
fotodepilacja - φωτοαποτρίχωση
fotografia - φωτογραφία
fotograficzny - φωτογραφικός
fotograf - φωτογράφος
foto- - φωτο-
fragmentacja - θρυμμάτισμα
fragment - απόσπασμα , περικοπή
fraktal - μορφόκλασμα , φράκταλ
Franciszek - Φραγκίσκος
Francja - Γαλλία
francuski pocałunek - γαλλικό φιλί
francuski - γαλλικός; γαλλικά
Francuzka - Γαλλίδα
Francuz - Γάλλος
frankofilia - γαλλοφιλία
frazes - κοινοτοπία
fregata - φρεγάτα , φρεγάδα ; φρεγάτα , φρεγάδα
front - μέτωπο ; όψη , πρόσοψη , φάτσα
Fryderyk - Φρεντερίκ
fryzjer - κουρέας , κομμωτής
funkcja - λειτούργημα ; συνάρτηση
funkcjonować - λειτουργώ
futbolista - ποδοσφαιριστής
futurystyczny - φουτουριστής; φουτουριστής
Gabon - Γκαμπόν
Gabriel - Γαβριήλ
gadożer - φιδαετός
Gad - Γαδ
gad - ερπετό
gaj - άλσος
galaktyka - γαλαξίας
gałąź - κλαδί ; κλάδος
galera - γαλέρα
gałka muszkatołowa - μοσχοκάρυδο
galon - γαλόνι
Gambia - Γκάμπια
gamma - γάμμα , γάμα
Gandawa - Γάνδη
gangster - γκάνγκστερ
garaż - γκαράζ
garbus - καμπούρης ; σκαθάρι
gardło - τράχηλος
garig - φρύγανο|φρύγανα
garncarstwo - αγγειοπλαστική
garnek - κατσαρόλα
garnitur - κουστούμι ; σύνολο , σετ
gąsienica - σαρανταποδαρούσα ; ερπύστρια
gasnąć - σβήνω
gaśnica - πυροσβεστήρας
gatunek - είδος
gawron - χαβαρόνι
Gaza - Γάζα
gaz cieplarniany - αέριο που προκαλεί το φαινόμενο του θερμοκηπίου , αέριο του θερμοκηπίου
gazeciarz - εφημεριδοπώλης
gazeta - εφημερίδα
gaz musztardowy - αέριο μουστάρδας
gazociąg - αγωγός αερίου
gaz ziemny - φυσικό αέριο
gdakać - κακαρίζω
Gdańsk - Γκντανσκ
gdyby - αν
gdzie drwa rąbią, tam wióry lecą - κοντά στα ξερά καίγονται και τα χλωρά
gdzie kucharek sześć, tam nie ma co jeść - όπου λαλούν πολλοί κοκόροι, αργεί να ξημερώσει
gdzie praca, pilność na straży, tam się bieda wejść nie waży - έκατσε η δουλειά στην πόρτα και κυνήγησε τη φτώχεια
gdzie - πού; όπου
gem - παιχνίδι , γκέιμ
generał broni - αντιστράτηγος , αντιπτέραρχος
generał dywizji - υποστράτηγος , υποπτέραρχος
generał - στρατηγός , πτέραρχος
generator - γεννήτρια
genetyka - γενετική
Genewa - Γενεύη
geneza - γένεση
Genua - Γένοβα
genua - τζένοα
geodezja - γεωδαισία
geografia - γεωγραφία
geograficzny - γεωγραφικός
geograf - γεωγράφος
geologia - γεωλογία
geolog - γεωλόγος /
geometria - γεωμετρία
geomorfologia - γεωμορφολογία
gepard - γατόπαρδος
german - γερμάνιο
gęś - χήνα
Ghana - Γκάνα
Gibraltar - Γιβραλτάρ
giełda - χρηματιστήριο
giez - αλογόμυγα
gigant - γίγαντας
gimnazjum - γυμνάσιο
ginekologia - γυναικολογία
ginekolog - γυναικολόγος
gitara - κιθάρα
gitarzysta - κιθαρίστας
gitarzystka - κιθαρίστρια
gladiator - μονομάχος
głaskać - χαϊδεύω
głęboki - βαθύς, βαρύς
głębokość - βάθος
głęboko - βαθιά
glina - πηλός , άργιλος ''lub''
gliniarz - μπάτσος
glin - αλουμίνιο
glob - υδρόγειος
głodnemu chleb na myśli - ο πεινασμένος καρβέλια ονειρεύεται
głodny - πεινασμένος, νηστικός
głód - πείνα ; λιμός
głośno - δυνατά
głos - φωνή ; λόγος ; ψήφος
głowa - κεφάλι
główka - κεφαλάκι
główny - κύριος
głuchoniemy - κωφάλαλος; κωφάλαλος
głupawka - νευρικό γέλιο
głupota - ηλιθιότητα , βλακεία
głuszec - αγριόκουρκος
głuszek - βουνοτσίχλονο
gmina - κοινότητα
gnejs - γνεύσιος
gnu - γκνου
godło - έμβλημα
godny - αξιοπρεπής, άξιος
godzina policyjna - απαγόρευση της κυκλοφορίας
godzina prawdy - ώρα της αλήθειας
godzina - ώρα ; ώρα
gołąbek - λαχανοντολμάς , λάχανο ντολμάδες
gołąb - περιστέρι
gołębica - περιστέρα
gołębi - περιστερίσιος
gołębnik - περιστερώνας
golf - γκολφ
golić - ξυρίζω; σουφρώνω
golonka - κότσι
gołowąs - αμούστακος , αγένειος
gol - γκολ, τέρμα
gondola - γόνδολα
goniec - άγγελος
gorący - θερμός
gorączka złota - πυρετός του χρυσού
gorączka - πυρετός
góra lodowa - παγόβουνο , άισμπεργκ
góra - όρος , βουνό
gorczyca - σινάπι
górnik - ανθρακωρύχος , μεταλλωρύχος
gorset - κορσές
górski - ορεινός, βουνίσιος
goryl - γορίλας
Góry Skaliste - Βραχώδη Όρη
gorzki - πικρός
górzysty - ορεινός
gotówka - μετρητά
gówno - σκατό
goździk - γαριφαλιά ; γαρίφαλο ; γαρίφαλο
grabarz - νεκροθάφτης
grabie - τσουγκράνα
grać w otwarte karty - παίζω με ανοιχτά χαρτιά
gracz - παίκτης , παίχτης
grad - χαλάζι
grafia - γραφή
grafoskop - προβολέας διαφανειών
gramatyka - γραμματική
gramofonowy - γραμμόφωνο|γραμμοφώνου
gramofon - γραμμόφωνο , φωνογράφος
granatowiec - ροδιά
granatowy - μπλε σκούρος
granat - ρόδι
granica - σύνορο|σύνορα ; όριο
granit - γρανίτης
gra słów - λογοπαίγνιο
grawitacja - βαρύτητα
gra - παιχνίδι ; παιχνίδι ; παίξιμο , παιχνίδι
grdyka - καρύδι
Grecja - Ελλάδα , Ελλάς
grecki - ελληνικός; ελληνικά
greckojęzyczny - ελληνόγλωσσος, ελληνόφωνος; ελληνόγλωσσος
Greczynka - Ελληνίδα
grejpfrut - γκρέιπ-φρουτ
Grek - Έλληνας
Grenada - Γρενάδα ; Γρανάδα
Grenlandia - Γροιλανδία
grób - τάφος
groch - μπιζέλι
gronostaj - ερμίνα ; ερμίνα
grosz do grosza, a będzie kokosza - φασούλι το φασούλι γεμίζει το σακούλι
groszek - μπιζελιά ; μπιζέλι
grosz - γρόσι
grubodziób - χοντρομύτης , κοκκοθραύστης
gruby - χοντρός
gruczolak - αδένωμα
gruczoł - αδένας
grudzień - Δεκέμβριος
grupa nominalna - ονοματική φράση
grupa werbalna - ρηματική φράση
grupa - ομάδα
grusza - αχλαδιά ; αχλαδόξυλο
gruszka - αχλάδι
Gruzinka - Γεωργιανή
gruziński - γεωργιανός; γεωργιανά
Gruzja - Γεωργία
gruźlica - φυματίωση
gryka - φαγόπυρο
grypa - γρίπη
gryźć - δαγκώνω
gryzoń - τρωκτικό ; τρωκτικά
grzebać - σκαλίζω; θάβω
grzebień - χτένα
grzechotka - κουδουνίστρα
grzechotnik - κροταλίας
grzech - αμαρτία
grzeszny - αμαρτωλός
grzmot - βροντή
grzybobranie - ξεφυτρώματος
grzyb - μύκητας ; μανιτάρι ; μύκητες
grzywa - χαίτη ; χαίτη
Guam - Γκουάμ , Γκουαχάν
Gujana Francuska - Γαλλική Γουιάνα
Gujana - Γουιάνα
gumno - αλώνι
guzik - κουμπί ; πλήκτρο , διακόπτης
Gwadelupa - Γουαδελούπη
gwałciciel - βιαστής
gwałtownie - βίαια; απότομα
gwara - διάλεκτος
Gwatemala - Γουατεμάλα
gwatemalczyk - Γουατεμαλέζος
Gwatemalczyk - Γουατεμαλέζος
Gwatemalka - Γουατεμαλέζα
Gwiazda Wieczorna - έσπερος , αποσπερίτης
gwiazda - αστέρι , άστρο , αστέρας , άστερας , αστήρ , αστρί
gwiazdozbiór - αστερισμός
Gwinea Bissau - Γουινέα-Μπισσάου
Gwinea Równikowa - Ισημερινή Γουινέα
Gwinea - Γουινέα
gwizdek - σφυρίχτρα ; σφύριγμα
gwóźdź - καρφί
habit nie czyni mnicha - το ράσο δεν κάνει τον παπά
haiku - χαϊκού
Haitańczyk - Αϊτινός
haitański - αϊτινός
Haiti - Αϊτή
haker - χάκερ
hałaśliwy - θορυβοποιός, θορυβώδης
hałas - θόρυβος
halka - κομπινεζόν
hamburger - χάμπουργκερ
hamowanie - φρενάρισμα
hamulec ręczny - χειρόφρενο
hamulec - φρένο
handel - εμπόριο
handlowy - εμπορικός
harcerz - πρόσκοπος
harem - χαρέμι
harfa - άρπα
harować jak wół - δουλεύω σαν σκύλος
harpun - καμάκι
haszysz - χασίς , χασίσι
has - χάσσιο
haubica - ολμοβόλο , χόβιτζερ
Hawana - Αβάνα
hebrajski - εβραϊκός; εβραϊκά
hegemonia - ηγεμονία
Helena - Ελένη
helikopter - ελικόπτερο
Helios - Ήλιος
hełmiatka - ροπαλόπαπια
helmintologia - ελμινθολογία
hełm - κράνος , κάσκα
Helsinki - Ελσίνκι
hel - ήλιο
heparyna - ηπαρίνη
hepatocyt - ηπατοκύτταρο
herbata - τσάι
herezja - αίρεση
Hermes - Ερμής
herold - τελετάρχης ; αγγελιαφόρος , αγγελιοφόρος
herpetologia - ερπετολογία
Hestia - Εστία
hetman - βασίλισσα
hezjodowy - ησιόδειος
Hezjod - Ησίοδος
hiacynt - υάκινθος , ζουμπούλι
Hieronim - Ιερώνυμος
Hindukusz - Χίντου Κους
hiperbola - υπερβολή ; υπερβολή
hipertermia - υπερθερμία , θερμοπληξία
hiponim - υπώνυμο
hipoteka - υποθήκη
hipoteza - υπόθεση
hipo- - υπο-
histogram - ιστόγραμμα
historia - ιστορία
historyk - ιστορικός
histo- - ιστο-
Hiszpania - Ισπανία
Hiszpanka - Ισπανίδα
hiszpański - ισπανικός; ισπανικός|ισπανικά
Hiszpan - Ισπανός
Holandia - Κάτω Χώρες , Ολλανδία
Holenderka - Ολλανδή , Ολλανδέζα
holenderski - ολλανδικός, ολλανδέζικος; ολλανδικός|ολλανδικά , ολλανδέζικος|ολλανδέζικα
Holender - Ολλανδός , Ολλανδέζος
holokaust - ολοκαύτωμα ; ολοκαύτωμα
hołota - συρφετός , όχλος
homarzec - καραβίδα
homar - αστακός
homeopatia - ομοιοπαθητική
homerycki - ομηρικός
homofobia - ομοφοβία
homofonia - ομοφωνία
homoseksualny - ομοφυλοφιλικός
Honduras - Ονδούρα
Hongkong - Χονγκ Κονγκ
hoplita - οπλίτης
horoskop - ωροσκόπιο
horyzont - ορίζοντας
hospitalizacja - νοσοκομειακή περίθαλψη
hotel - ξενοδοχείο
hrabstwo - κομητεία ; κομητεία
hulajnoga - πατίνι
humor - χιούμορ
huragan - τυφώνας ; λαίλαπα
huśtać - κουνώ
huśtawka - κούνια , τραμπάλα
hybryda - υβρίδιο
hycel - μπόγιας
hydrant - κρουνός , πυροσβεστικός κρουνός
hydraulik - υδραυλικός
hydrobiologia - υδροβιολογία
hydrofon - υδρόφωνο
hydrologia - υδρολογία
hydroponika - υδροπονία
hydrostatyka - υδροστατική
hymn - ύμνος
ichtiologia - ιχθυολογία
idea - ιδέα
identyczny - ολόιδιος
ideologiczny - ιδεολογικός
idiolekt - ιδιόλεκτο , ιδιόλεκτος
idiom - ιδιωτισμός
idol - είδωλο
idy - ειδοί
ignorancja - άγνοια , αμάθεια
igrać z ogniem - παίζω με τη φωτιά
igrzyska olimpijskie - ολυμπιακοί αγώνες
ikona - εικόνα ; εικονίδιο
ikosaedr - εικοσάεδρο
ile - πόσος
iloczyn - γινόμενο
iloraz - πηλίκο
ilość - ποσότητα
imbir - ζιγγίβερι ; πιπερόριζα , τζίντζερ
imiesłów - μετοχή
imię - όνομα
imponderabilia - αστάθμητος παράγοντας
impotent - ανίκανος
inauguracja - έναρξη , εγκαίνια
indagować - ερευνώ
Indie - Ινδία
indoeuropejski - ινδοευρωπαϊκός
Indonezja - Ινδονησία
Indonezyjczyk - Ινδονήσιος
Indonezyjka - Ινδονήσια
indonezyjski - ινδονησιακός
indyjski - ινδικός
indyk - γαλοπούλα
infekcja - μόλυνση
inflacja - πληθωρισμός
informacja - πληροφορία ; πληροφορία|πληροφορίες
informatyka - πληροφορική
informować - πληροφορώ
inhibitor - αναστολέας
inny - άλλος
instalować - εγκαθιστώ; εγκαθιστώ; εγκαθίσταμαι
instrument - όργανο
insulina - ινσουλίνη
intencja - πρόθεση
intercyza - γαμήλιο συμβόλαιο
interes - ασχολία
interlingua - ιντερλίνγκουα
internetowy - διαδικτυακός, ιντερνετικός
internet - ίντερνετ
Internet - ίντερνετ , διαδίκτυο , ιντερνέτ
interwencja - επέμβαση
interwencjonizm - επεμβατισμός
interweniować - επεμβαίνω
intifada - ιντιφάντα
intonacja - τονισμός
introligatornia - βιβλιοδετείο
introligator - βιβλιοδέτης
inwalida - ανάπηρος
inwazja - εισβολή , επιδρομή
inwestor - επενδυτής
inwestycja - επένδυση
inżynier - μηχανικός
Io - Ιώ
ipsylon - ύψιλον
Irak - Ιράκ
Irańczyk - Ιρανός
irański - ιρανικός
Iran - Ιράν
Irlandczyk - Ιρλανδός
Irlandia Północna - Βόρεια Ιρλανδία
Irlandia - Ιρλανδία
Irlandka - Ιρλανδή , Ιρλανδέζα
irlandzki - ιρλανδέζικος, ιρλανδικός
ironia - ειρωνεία
ironicznie - ειρωνικά
iść spać - πάω για ύπνο, κοιμάμαι
Islamska Republika Mauretańska - Ισλαμική Δημοκρατία της Μαυριτανίας
Islandia - Ισλανδία
Islandka - Ισλανδή
istnieć - υπάρχω
istnienie - ύπαρξη ; ον
istotny - ουσιώδης, αρχικός; ουσιαστικός
Itaka - Ιθάκη , Θιάκι
-izm - -ισμός
izobara - ισοβαρής καμπύλη
Izrael - Ισραήλ
i - και, κι
jabłko niezgody - μήλον της Έριδος
jabłko - μήλο
jabłoń - μηλιά
jacht - γιοτ , θαλαμηγός
jadalnia - τραπεζαρία ; τραπεζαρία
jadalny - φαγώσιμος, βρώσιμος
jądro - όρχις ; πυρήνας
jagnięcina - αρνί , αρνάκι ; αρνί , αρνάκι
jajeczkowanie - ωορρηξία
jajecznica - ομελέτα
jajko Kolumba - αβγό του Κολόμβου
jajko - αβγό
jajnik - ωοθήκη
jajowaty - ωοειδής, αβγοειδής
jajowód - ωαγωγός
jajo - ωάριο ; αβγό
jąkała - τραυλός
jakikolwiek - οποιοσδήποτε
jako - σαν; όπως
jak się masz? - τι κάνεις
jak sobie pościelesz, tak wyspać się wyśpisz - όπως έστρωσες, θα κοιμηθείς, όπως στρώσεις, θα κοιμηθείς
Jakub - Ιάκωβος
jałmużna - ελεημοσύνη
jałowiec - γιουνίπερος
jama bębenkowa - τυμπανική κοιλότητα
Jamajka - Τζαμάικα ; Τζαμαϊκανή
jamajski - τζαμαϊκανός
jamb - ίαμβος
Jan - Γιάννης, Ιωάννης
Japończyk - Ιάπωνας , Γιαπωνέζος
Japonia - Ιαπωνία
Japonka - Ιαπωνίδα , Γιαπωνέζα
japoński - ιαπωνικός, γιαπωνέζικος; ιαπωνικός|ιαπωνικά
jarzębina - σουρβιά ; σούρβο
jaskinia - σπηλιά
jaskółka - χελιδόνι
jaśmin - γιασεμί
jasne jak słońce - φως φανάρι
jastrząb - διπλοσάινο
jaszczurka - σαύρα
jaźń - εγώ
j.a. - α.μ.
ja - εγώ ; εγώ
jebaka - γαμιάς , γαμίκος
jechać - κυκλοφορώ, κινούμαι, πηγαίνω; οχούμαι, κινούμαι , οδηγώ , πάω ; γλιστρώ, παγοδρομώ; μυρίζω, βρωμάω
jęczmień - κριθάρι ; κριθαράκι
jeden - ένας; ένα
jednokomórkowiec - μονοκύτταρος οργανισμός
jednokomórkowy - μονοκυτταρικός, μονοκύτταρος
jednomasztowy - μονοκάταρτος
jednomyślność - ομοφωνία
jednorożec - μονόκερος
jednoślad - δίτροχος|δίτροχο όχημα
jednym słowem - με μια λέξη
jedwabnictwo - σηροτροφία ; σηροτροφία
jedwabnik - μεταξοσκώληκας
jedwab - μετάξι
jedynak - μοναχογιός
jedynka - μονάδα
jedyny - μοναδικός
jedzenie - φαγητό
jej - της
jeleń - ελάφι
jelito - έντερο
Jemen - Υεμένη
jemioła - γκι , ιξός
jemiołuszka - βομβυκίλα
Jerozolima - Ιεροσόλυμα , Ιερουσαλήμ
jerzyk - πετροχελίδονο
Jerzy - Γεώργιος , Γιώργος
jeść jak wróbelek - τρώω σα σπουργίτι
jeść - τρώω, τρώγω
jesienny - φθινοπωρινός
jesień - φθινόπωρο
jesion - μελιά
jesiotr - μουρούνα , στουριόνι
jeszcze - πάλι
jętka - εφημερόπτερο
jeździec - καβαλάρης , ιππέας
jeżeli - εάν
jezioro - λίμνη
jeżozwierz - ακανθόχοιρος
Jezus Chrystus - Ιησούς Χριστός
Jezus - Ιησούς
język i do Krakowa dopyta - ρωτώντας πας στην Πόλη
język migowy - νοηματική γλώσσα
język ojczysty - μητρική γλώσσα
język programowania - γλώσσα προγραμματισμού
język - γλώσσα
jeż - σκαντζόχοιρος
jidysz - γίντις
Joanna - Ιωάννα
jodła - έλατο
jod - ιώδιο
jogurt - γιαούρτι , γιαούρτη
Jordania - Ιορδανία
Jordan - Ιορδάνης
jotacyzm - ιωτακισμός
jota - γιώτα
Jowisz - Δίας; Ζευς, Δίας
juczny - φορτηγός
judaizm - ιουδαϊσμός
judaszowy pocałunek - φιλί του Ιούδα
judeochrześcijański - ιουδαιοχριστιανικός
Jugosławia - Γιουγκοσλαβία
Juliusz - Ιούλιος
jutro - αύριο αύριο
jutrzejszy - αυριανός
już - κιόλας, ήδη; πια
kabaczek - κολοκυθάκι
kabaret - καμπαρέ
kabotażowy - ακτοπλοϊκός
kabotaż - ακτοπλοΐα
Kabul - Καμπούλ
kaczeniec - κάλθα η ελοχαρής
kaczka - πάπια ; πάπια
kadm - κάδμιο
kadzidło - θυμίαμα
kafejka - καφενείο
kaganek - λύχνος , λυχνάρι
kaganiec - φίμωτρο ; καντήλι
kainowe piętno - σημάδι του Κάιν
Kair - Κάιρο
Kajmany - Νήσοι Καϋμάν
kakadu - κακατόης
kąkol - γόγγολη
kaktus - κάκτος
kalafior - κουνουπίδι
kalafonia - κολοφώνιο
kalarepa - γογγυλοκράμβη , γογγύλι , ραφανοκράμβη ; γογγύλι , γογγυλίδα , καυλοράπα , λαχανόγουλο
Kaledonia - Καληδονία
kalejdoskop - καλειδοσκόπιο
kalendarz - ημερολόγιο
kalendy - καλένδες /
kaligrafia - καλλιγραφία
Kaliopa - Καλλιόπη
kalmar - καλαμάρι
kaloryfer - καλοριφέρ
kałuża - νερόλακκος
kał - περίττωμα , κόπρος
Kambodżanin - Καμποτζιανός
Kambodżanka - Καμποτζιανή
kambodżański - καμποτζιανός
Kambodża - Καμπότζη
kamera - κάμερα
Kameruńczyk - Καμερουνέζος
Kamerunka - Καμερουνέζα
kameruński - καμερουνέζος
Kamerun - Καμερούν
kamienny - πέτρινος, λίθινος
kamień węgielny - αγκωνάρι ; αγκωνάρι , θεμέλιος λίθος
kamień - πέτρα ; λίθος
kamizelka - γελέκι
Kanada - Καναδάς
Kanadyjczyk - Καναδός , Καναδέζος
kanadyjski - καναδικός
kanalia - κανάγιας
kanał - αγωγός , κανάλι ; διώρυγα , κανάλι ; κανάλι ; λάκκος επιθεώρησης ; θέση ορχήστρα|ορχήστρας λούκι
kancerogenny - καρκινογόνος
kandydat - υποψήφιος
kangur - καγκουρό
kanibal - κανίβαλος
kantyna - τραπεζαρία
kapar - κάππαρη ; κάππαρη
kapelusz - καπέλο
kapitalizm - καπιταλισμός
kapitan - λοχαγός , σμηναγός ; καπετάνιος , πλοίαρχος ; αρχηγός
kapitulacja - συνθηκολόγηση
kapłan - ιερέας
kaplica - παρεκκλήσι
kappa - κάπα , κάππα
kapral - δεκανέας
Kapsztad - Κέιπ Τάουν
kapturka - μαυροσκούφης
kapucyn - καπουτσίνος
kapusta - λάχανο
karabińczyk - κρίκος , κλιπ , αρπαγή
karabinek - καραμπίνα
karabin maszynowy - πολυβόλο
karabin - τουφέκι
karangioza - καραγκιόζης
karateka - καρατίστας , καρατέκα
karate - καράτε
karawela - καραβέλα
kara - τιμωρία , ποινή
karczoch - αγκινάρα
kardamon - κάρδαμο
kardiologia - καρδιολογία
kardiologiczny - καρδιολογικός
kardio- - καρδιο-, καρδιό-, καρδι-
kardynał - καρδινάλιος
kariatyda - Καρυάτιδα , Καρυάτις
kark - σβέρκος
karlica - γυναίκα νάνος
karmazyn - κοκκινόψαρο
karmić - τρέφω; θηλάζω, βυζαίνω
karnisz - κουρτινόξυλο
Karpaty - Καρπάθια
karp - κυπρίνος
karta dźwiękowa - κάρτα ήχου
karta graficzna - κάρτα γραφικών
karta kredytowa - πιστωτική κάρτα
kasjer - ταμίας /
kask - κράνος
kasownik - αναίρεση
kastracja - ευνουχισμός
kasyno - καζίνο
kaszalot - φυσητήρας
kaszanka - λουκάνικο με αίμα
kaszel - βήχας
kaszleć - βήχω
kasztanowiec - ιπποκαστανιά , καστανιά
kasztanowy - καστανός
kasztan - καστανιά ; κάστανο ; κάστανο ; καστανό ; καστανός|καστανό άλογο
katalityczny - καταλυτικός
katalizator samochodowy - καταλυτικός μετατροπέας
katalog - κατάλογος
Katalonia - Καταλωνία, Καταλονία
katapulta - καταπέλτης
Katarzyna - Κατερίνα , Αικατερίνη
Katar - Κατάρ
katar - συνάχι , καταρροή
katastrofa - καταστροφή
katechumenka - κατηχούμενη
katechumen - κατηχούμενος
katedra - μητρόπολη , καθεδρικός ναός ; έδρα
Katmandu - Κατμαντού
katoda - κάθοδος
katolicyzm - καθολικισμός
katoliczka - καθολική , καθολικιά
katolik - καθολικός
kąt prosty - ορθή γωνία
kat - δήμιος
kaucja - εγγύηση , ενέχυρο
Kaukaz - Καύκασος
kawałek - κομμάτι , μέρος
kawaleria - ιππικό
kawaler - ανύπαντρος , άγαμος ; ταξιάρχης ; ιππότης ; παλικάρι
kawał - κομμάτι , μέρος ; ανέκδοτο , πλάκα , αστείο
kawa - καφέα ; καφές ; ελληνικός , φραπές , νες
kawiarnia - καφετερία , καφέ , καφενείο
kawior - χαβιάρι
kawka - κάργια ; καφεδάκι
Kazachstan - Καζαχστάν
kazanie - κήρυγμα ; δασκάλεμα
każdy - κάθε
kciuk - αντίχειρας
keczup - κέτσαπ
kelnerka - σερβιτόρα
kelner - μπάρμαν , σερβιτόρος
kemping - κάμπινγκ
Kenia - Κένυα
Kent - Κεντ
kibic - φίλαθλος , οπαδός
kibuc - κιμπούτς
kichać - φταρνίζομαι, φτερνίζομαι
kiedy indziej - άλλοτε, άλλος|άλλη φορά
kiedy - πότε; όταν
kiełbasa - λουκάνικο , σαλάμι
kiełb - μουστακάς , γυφτόψαρο
kieliszeczek - ποτηράκι
kielnia - μυστρί
kierowca - οδηγός
kierownica - τιμόνι ; αντιτροχιά
kierunkowskaz - οδοδείκτης ; φλας
kiesa - πουγκί
kieszeń - τσέπη
kieszonkowe - χαρτζιλίκι
kijanka - γυρίνος
Kijów - Κίεβο
kij - ξύλο
kilowatogodzina - κιλοβατώρα
kilo - κιλό
kilo- - χιλιο-
kimono - κιμονό
kino - κινηματογράφος , σινεμά
kiosk - περίπτερο
Kirgistan - Κιργιζία , Κιργιζιστάν
Kiribati - Κιριμπάτι , Δημοκρατία του Κιριμπάτι
kitel - ποδιά
klacz - φοράδα
kląć - βρίζω, βλαστημώ
klakier - κλακαδόρος
klamka - χερούλι
kłamstwo ma krótkie nogi - το ψέμα έχει κοντά ποδάρια
kłamstwo - ψέμα
klan - πατριά , σόι ; κλίκα
klarnet - κλαρινέτο
klasa - τάξη ; κλάση ; κλάση
klasztor - μοναστήρι , μονή ; μοναστήρι
klatka piersiowa - θώρακας
klatka - κλουβί
klaustrofobia - κλειστοφοβία
klawiatura numeryczna - αριθμητικό πληκτρολόγιο
klawiatura - πληκτρολόγιο
klawisz - πλήκτρο
kłębek - κουβάρι
klej - κόλλα
klepsydra - κλεψύδρα ; νεκρόσημο , κηδειόσημο , αγγελτήριο θάνατος|θανάτου / κηδεία|κηδείας
kler - κλήρος
klęska - ήττα ; καταστροφή , συμφορά
kleszcze porodowe - εμβρυουλκός
kleszcz - τσιμπούρι
klient - πελάτης
klikać - κλικάρω
klika - κλίκα ; πλήρες γράφημα
klimatyzacja - κλιματισμός
klimat - κλίμα
klon - σφεντάμι ; κλώνος
kloszard - αλήτης , αλάνης
kłos - στάχυ
klub - λέσχη
klucz francuski - ρυθμιζόμενο κλειδί
klucz - κλειδί ; κλειδί ; κλειδί ; κλειδί ; κλειδί ; κλειδί
kłusownik - λαθροθήρας
kminek - κύμινο
knować - σκευωρώ, μηχανεύομαι
koalicja - συνασπισμός , συμμαχία
kobalt - κοβάλτιο
kobiecy - γυναικείος
kobieta lekkich obyczajów - γυναίκα ελαφρών ηθών , εύκολη γυναίκα
kobieta - γυναίκα
kobuz - δεντρογέρακο
kobyła - φοράδα , αλόγα ; φοράδα , αλόγα
kochać - αγαπώ
kochanek - εραστής
kochanie - έρωτας, αγάπη; μωρό, αγάπη
kochany - ακριβός; φίλος
kocioł parowy - ατμολέβητας , ατμογεννήτρια
koci - γατίσιος
kocur - γάτος
koc - κουβέρτα
kod źródłowy - πηγαίος κώδικας
kofeina - καφεΐνη
kognitywny - γνωστικός
kogut - πετεινός , κόκορας
kojot - κογιότ
kokietować - ερεθίζω, ερωτοτροπώ, φλερτάρω
kokos - κοκοφοίνικας ; ινδική καρύδα
kok - κότσος
kolacja - δείπνο
kolano - γόνατο
kolarstwo - ποδηλασία
kolarz - ποδηλατοδρόμος , ποδηλατιστής
kołchoz - κολχόζ
kołczan - φαρέτρα
kolczyk - σκουλαρίκι
kołdra - πάπλωμα
kolęda - κάλαντα
kolega - συνάδελφος , συμφοιτητής , συμπαίκτης
kolejarz - σιδηροδρομικός
kolejowy - σιδηροδρομικός
kolej - σιδηρόδρομος , τρένο ; σειρά
kolendra - κολίανδρο , κόλιαντρο , κορίανδρο
koliber - κολιμπρί
kółko i krzyżyk - τρίλιζα
kołnierz - γιακάς , περιλαίμιο
kolokacja - διευθέτηση , ρύθμιση
Kolonia - Κολωνία
koło ratunkowe - σωσίβιο
kolorowy - έγχρωμος, χρωματιστός
kolor - χρώμα
kolos na glinianych nogach - γίγαντας με πήλινα πόδια
koło zębate - οδοντωτός τροχός , γρανάζι
koło - κύκλος ; ρόδα , τροχός ; δίπλα, δίπλα; γύρω, περίπου
Kolumbia Brytyjska - Βρετανική Κολομβία
Kolumbia - Κολομβία
Kolumbijka - Κολομβιανή
kolumbijski - κολομβιανός
komandor podporucznik - πλωτάρχης
komandor porucznik - αντιπλοίαρχος
komandor - πλοίαρχος
komar - κουνούπι
komentator - σχολιαστής
kometa - κομήτης
komfortowy - αναπαυτικός, βολικός
komiks - κόμικς
kominek - εστία , τζάκι
kominiarka - σκούφος , κουκούλα
kominiarz - καπνοδοχοκαθαριστής
komin - φουγάρο , καπνοσωλήνας
Komisja Europejska - Ευρωπαϊκή Επιτροπή
komoda - σκευοθήκη
komora gazowa - θάλαμος αερίων
komora - θάλαμος
komórka - κελάρι ; κύτταρο ; κινητό
Komoryjczyk - Κομορανός
Komoryjka - Κομορανή
Komory - Κομόρες , Κομόρες Νήσοι
kompas - πυξίδα
kompendium - επιτομή
kompleks Medei - σύμπλεγμα της Μήδειας
kompost - λίπασμα , κομπόστ
kompot - κομπόστα
komputer - κομπιούτερ , υπολογιστής
komunista - κομμουνιστής ; αυτός που παίρνω|παίρνει την πρώτος|πρώτη θεία κοινωνία
komunistka - κομουνίστρια
koncert - συναυλία
końcówka - κατάληξη
kondolencje - συλλυπητήρια
konewka - ποτιστήρι
konfederacja - ομοσπονδία
kongijski - κονγκολέζος
Kongo - Κονγκό , Δημοκρατία του Κονγκό ; Κόνγκο
koniak - κονιάκ
koniczyna - τριφύλλι
konieczność - αναγκαιότητα , απαίτηση
koniec - άκρη ; τέλος ; τέρμα
konik morski - ιππόκαμπος , αλογάκι της θάλασσας
konik polny - ακρίδα
koniugacja - συζυγία
konklawe - κονκλάβιο , κογκλάβιο
konkludować - συνοψίζω, συγκεφαλαιώνω
konkubina - παλλακή
koń mechaniczny - ιπποδύναμη
konno - καβάλα
konował - αγύρτης , κομπογιαννίτης
konspekt - σύνοψη , περίληψη
Konstantynopol - Κωνσταντινούπολη , Πόλη
Konstantyn - Κωνσταντίνος
konstelacja - αστερισμός
konsternacja - κατάπληξη
konsul - πρόξενος
konto - λογαριασμός
kontrast - κοντράστ ; αντίθεση
koń trojański - δούρειος ίππος
kontroler - ελεγκτής ; ρυθμιστήρας
kontrolować - ελέγχω
kontuzjować - μωλωπίζω
kontynent - ήπειρος
kontynuować - συνεχίζω
konwalia - μιγκέ
koń - άλογο ; ίππος
kopalnia - ορυχείο , μεταλλείο
koparka - εκσκαφέας
Kopenhaga - Κοπεγχάγη
koperta - φάκελος
koper - άνηθος
kopiowanie - αντιγραφή , λογοκλοπία
kopnięcie - κλοτσιά
koprolalia - κοπρολαλία
Koran - Κοράνιο
Kordowa - Κόρδοβα
Koreańczyk - Κορεάτης
Koreańska Republika Demokratyczna - Λαοκρατική Δημοκρατία της Κορέας
Korea Północna - Βόρεια Κορέα
Korea Południowa - Νότια Κορέα
korektorka - διορθώτρια
korkociąg - τιρμπουσόν ; ελικοειδής πτώση αεροσκάφους
kormoran - κορμοράνος
Korsyka - Κορσική
korytarz - διάδρομος
korzeń - ρίζα ; ρίζα ; ρίζα
korzyść - κέρδος
kosaciec - ίριδα
kosa - κόσα
kościół - εκκλησία
Kościół - Εκκλησία
kość krzyżowa - ιερό οστό
kość słoniowa - ελεφαντοστό , ελεφαντόδοντο
kość - οστό ; ζάρι , κύβος
kosmita - εξωγήινος
kosmologia - κοσμολογία
kosmopolita - κοσμοπολίτης
kosmos - διάστημα , κόσμος , σύμπαν
kosmo- - κοσμο-, κοσμό-, κοσμ-
Kosowo - Κοσσυφοπέδιο , Κόσοβο
Kostaryka - Κόστα Ρίκα
kosteczki słuchowe - ακουστικά οστάρια
kostka Rubika - κύβος του Ρούμπικ
koszmar - εφιάλτης
kosztować - έχω, κάνω, στοιχίζω, κοστίζω; δοκιμάζω, γεύομαι; απολαμβάνω, τέρπομαι
koszula - πουκάμισο
koszykarz - μπασκετμπολίστας ; καλαθοποιός
koszykówka - μπάσκετ , μπάσκετμπολ , καλαθόσφαιρα , καλαθοσφαίριση
koszyk - καλάθι
kosz - καλάθι
kos - κότσυφας , κοτσύφι
Kos - Κως
kotek - γατάκι , γατούλα
kot - γάτα
kowal - σιδεράς
koza - γίδα
kozia bródka - μούσι
kozioł ofiarny - αποδιοπομπαίος τράγος
Koziorożec - Αιγόκερως ''Aigókerös''
koźlątko - κατσίκι , κατσικάκι
kradzież - κλοπή
Kraj Basków - Χώρα των Βάσκων
kraj - χώρα; χώρα
krakać - κρώζω; κακομελετώ
Kraków - Κρακοβία
kraść - κλέβω
kraska - χαλκοκουρούνα
krater - κρατήρας
krawat - γραβάτα
krawężnik - κράσπεδο πεζοδρόμιο|πεζοδρομίου
krawiec - ράφτης
kreda - κιμωλία ; Κρητιδικό
kręgosłup - σπονδυλική στήλη
kręgowiec - σπονδυλωτό
krematorium - κρεματόριο
kreskówka - κινούμενα σχέδια
Kreta - Κρήτη
Kreteńczyk - Κρητικός , Κρής
Kretenka - Κρητικιά , Κρήσσα
krętogłów - στραβολαίμης
kretyn - κρετίνος
kret - τυφλοπόντικας
krewetka - γαρίδα
krewny - συγγενής
krew - αίμα
krnąbrność - πείσμα , ξεροκεφαλιά
krochmalić - κολλάρω
kroić - κόβω, τεμαχίζω
krokodyle łzy - κροκοδείλια δάκρυα
krokodyl - κροκόδειλος
krokus - κρόκος
Królestwo Bhutanu - Βασίλειο του Μπουτάν
królestwo - βασίλειο
królewski - βασιλικός
królik - κουνέλι ; βασιλίσκος
królowa - βασίλισσα , ρήγαινα , ρήγισσα
król - βασιλιάς , ρήγας
kromka - φέτα
kropka w kropkę - λέξη προς λέξη
kropka - τελεία
kropla, która przepełnia czarę - η σταγόνα που ξεχείλισε το ποτήρι
kropla w morzu - σταγόνα στον ωκεανό
kropla - σταγόνα
kroplomierz - σταγονόμετρο
krótkowzroczność - μυωπία
krowa - αγελάδα
krtań - λάρυγγας
kruk krukowi oka nie wykole - κόρακας κοράκου μάτι δε βγάζει
kruk - κόρακας
krużganek - πρόπυλο
krwionośny - αιμοφόρος, καρδιαγγειακός
krwotok - αιμορραγία
krypton - κρυπτόν
Krystian - Χριστιανός
Krystyna - Χριστίνα
kryształ - κρύσταλλος
krytyka - κριτική
kryzys - κρίση
krzak gorejący - φλεγομένη βάτος
krzesło - καρέκλα
krzyk - κραυγή
Krzysztof - Χριστόφορος , Χριστοφόρος
krzywa - καμπύλη ; καμπύλος|καμπύλη
krzywoprzysięzca - ψεύδορκος
Krzyżak - τευτονικός ιππότης
krzyżówka - σταυρόλεξο ; υβρίδιο ; σταυροδρόμι ; πρασινοκέφαλη πάπια
Krzyż Południa - Σταυρός του Νότου
krzyżyk - σταυρουδάκι ; σταυρός ; δεκαετία ; δίεση
krzyż - σταυρός; ιερό οστό , μέση
ksenofobia - ξενοφοβία
ksenon - ξένον
kserograf - φωτοτυπικό μηχάνημα
ksiądz - παπάς
książę - πρίγκιπας
książka telefoniczna - τηλεφωνικός κατάλογος
książka - βιβλίο
księgarnia - βιβλιοπωλείο
Księga Rodzaju - Γένεσις
księga - βιβλίο
księgowość - λογιστική
księgowy - λογιστής
księżyc - φεγγάρι ; σελήνη
ksi - χι
kszyk - μπεκατσίνι
kto nie ma w głowie, ten ma w nogach - όποιος δεν έχει μυαλό έχει πόδια
kto pod kim dołki kopie, sam w nie wpada - όποιος σκάβει το λάκκο του αλλουνού, πέφτει ο ίδιος μέσα
kto pyta, nie błądzi - ρωτώντας πας στην Πόλη
kto rano wstaje, temu Pan Bóg daje - όποιος πρόλαβε, τον Κύριον είδε
który - ποιος, τι; όποιος, που
kto sieje wiatr, ten zbiera burzę - όποιος σπέρνει ανέμους, θερίζει θύελλες
kto szuka, ten znajdzie - όποιος ψάχνει, βρίσκει
ktoś - κάποιος; κάποιος
kto - ποιος; ποιος; κάποιος
Kuba - Κούβα
kubek - μαστραπάς
kucharz - μάγειρας
kuchnia - κουζίνα
kucki - ανακούρκουδα → w kucki
kuć żelazo, póki gorące - στη βράση κολλάει το σίδερο
kujon - φυτό
kukułka - κούκος ; κούκος
kukurydza - καλαμπόκι
kukuryku - κουκουρίκου
kula - σφαίρα ; σφαίρα ; σφαίρα ; δεκανίκι ; σφαίρα ; σφαίρα
kulczyk - σκαρθάκι
kulisty - σφαιρικός
kulon - πετροτριλίδα
kultura - πολιτισμός , κουλτούρα ; πολιτισμός , κουλτούρα
kult - λατρεία
kumkwat - κουμ κουάτ, κουμ-κουάτ, κουμκουάτ
kuna - κουνάβι
kupować kota w worku - αγοράζω γουρούνι στο σακί
kupować - αγοράζω
kura - κότα , όρνιθα
kurczak - κοτόπουλο
kurczę - νεοσσός ; αμάν!
kurek - πετεινός ; καπόνι ; πετεινός
kurnik - κοτέτσι
kuropatwa - πέρδικα
kurtka - μπουφάν
kurwa - πουτάνα
kurz - σκόνη
kusza - βαλλίστρα
Kuwejtczyk - Κουβεϊτιανός
Kuwejt - Κουβέιτ , Κράτος του Κουβέιτ ; Κουβέιτ , Πόλη του Κουβέιτ
kuzynka - ξαδέλφη
kuzyn - ξάδελφος
kwadratowy - τετράγωνος; τετραγωνικός
kwadrat - τετράγωνο ; τετράγωνο
kwadryga - τέθριππο
kwarc - χαλαζίας
kwas akrylowy - ακρυλικό οξύ
kwas azotowy - νιτρικό οξύ
kwas foliowy - φολικό οξύ
kwas krotonowy - κροτονικό οξύ
kwas mlekowy - γαλακτικό οξύ
kwas - οξύ
kwazar - κβάζαρ , κβασάρ
kwiaciarnia - ανθοπωλείο
kwiatostan - ταξιανθία , ανθοταξία
kwiat - λουλούδι , άνθος
kwiecień - Απρίλιος
kwintesencja - πεμπτουσία
kwitnąć - ανθίζω, ανθώ, λουλουδίζω; ανθώ, ακμάζω, ανθίζω
kwoka - κλώσα
kworum - απαρτία
kwota - ποσό , σύνολο ; ποσότητα
łabędzi śpiew - κύκνειο άσμα
łabędź - κύκνος
labirynt - λαβύρινθος
Lachesis - Λάχεση , Λάχεσις ; Λάχεσις
łaciński - λατινικός
lać jak z cebra - βρέχει με το κανάτι, βρέχει με το τουλούμι, βρέχει καρεκλοπόδαρα, ρίχνει καρεκλοπόδαρα
łącznik - συνδετικό ρήμα
łączyć - συνδέω; συνδέω; συνδέω; συνδέω
lada - πάγκος
ładny - όμορφος, ωραίος
ładowarka - φορτιστής
ląd - ξηρά , στεριά , γη
laguna - λιμνοθάλασσα
laicyzacja - εκλαΐκευση
łajdak - κάθαρμα
łąka - λιβάδι
lakier do paznokci - βερνίκι νυχιών
laktaza - λακτάσης
lalka - κούκλα
łamaniec językowy - γλωσσοδέτης
lambda - λάμδα
Lambro - Λάμπρος
Lamia - Λαμία ; Λάμια
lampart - λεοπάρδαλη
łańcuch pokarmowy - τροφική αλυσίδα
łańcuch - αλυσίδα ; αλυσίδα ; αλυσίδα ; αλυσίδα ; αλυσίδα
łania - ελαφίνα
lantan - λανθάνιο
Laos - Λάος
łapówka - λάδωμα , φακελάκι
laptop - φορητός υπολογιστής
larwa - προνύμφη
łasica - νυφίτσα
las - δάσος
latać - πετώ
latarnia Diogenesa - φανάρι του Διογένη
latawiec - χαρταετός
latoś - εφέτος
lato - καλοκαίρι , θέρος
łatwo - εύκολα, ευκόλως
łatwy - εύκολος, βατός
lawenda - λεβάντα
ławka - παγκάκι , πάγκος , σκαμνί ; θρανίο
Łazarz - Λάζαρος
łazienka - λουτρό , μπάνιο
Lazurowe Wybrzeże - Κυανή Ακτή
lazuryt - κύανος
łechtaczka - κλειτορίδα
lecieć - πετώ
leczniczy - ιαματικός, θεραπευτικός
leczyć - γιατρεύω, θεραπεύω
ledwo - μόλις; , μόλις που
legendarny - επικός, θρυλικός, μυθικός; ξακουστός, φημισμένος
legia cudzoziemska - λεγεώνα των ξένων
legion - λεγεώνα ; λεγεώνα
legitymacja - ταυτότητα
lekarstwo - φάρμακο
lekarz - γιατρός
lekceważenie - περιφρόνηση , υποτίμηση
lekceważyć - υποτιμώ, περιφρονώ
lekcja - μάθημα
lekkoatletyka - στίβος
łękotka - μηνίσκος
lemiesz - υνί ; ύνιδα ; λεπίδα , άκρο σάρωση|σάρωσης; αγκύρωση πυροβόλο|πυροβόλου
lemoniada - λεμονάδα , γκαζόζα
lenistwo - τεμπελιά
leniwy - τεμπέλης
Leon - Λέων
lepiej późno niż wcale - κάλλιο αργά παρά ποτέ
lepiej - καλύτερα, κάλλιο
lepszy wróbel w garści niż gołąb na dachu - κάλλιο πέντε και στο χέρι, παρά δέκα και καρτέρει
lesisty - δασοσκέπαστος, δασοσκεπής
leśnik - δασοκόμος , δασοφύλακας
Lesotho - Λεσόθο
letniość - χλιαρότητα
lewarek - γρύλος
lewa - μπάζα , χαρτωσιά , λεβέ
leworęczny - αριστερόχειρας
lewo - αριστερά
lewy - αριστερός
Lew - Λέων
lew - λιοντάρι
leżak - ξαπλώστρα
libański - λιβανέζικος
Liban - Λίβανος
Liberia - Λιβερία
liberia - λιβρέα
Libia - Λιβύη
libijski - λιβυκός
liceum - λύκειο
liczba atomowa - ατομικός αριθμός
liczba całkowita - ακέραιος αριθμός
liczba mnoga - πληθυντικός
liczba pierwsza - πρώτος αριθμός
liczba podwójna - δυϊκός
liczba pojedyncza - ενικός
liczba - αριθμός ; νούμερο
liczebnik - αριθμητικό
Lidia - Λυδία
ligatura - λεγκάτο
likier - λικέρ
lilak - πασχαλιά
lilia - κρίνο , λείριον
limfocyt - λεμφοκύτταρο
limnologia - λιμνολογία
limonit - λειμωνίτης
lingwista - γλωσσολόγος
lingwistyka - γλωσσολογία
linia - γραμμή ; γραμμή ; γραμμή ; γραμμή
linijka - ρίγα
linkomycyna - λινκομυκίνη
link - σύνδεσμος
linoleum - λινόλαιο
lin - γλινάρι , γλινί , γλίνι
lipiec - Ιούλιος
lipień - θύμαλος
lira - λύρα ; λίρα
liściasty - πλατύφυλλος
liść laurowy - φύλλο δάφνης
liść - φύλλο
lista - λίστα
listek figowy - φύλλο συκής
listonosz - ταχυδρόμος
listopad - Νοέμβριος , Νοέμβρης
list otwarty - ανοιχτή επιστολή
list - γράμμα , επιστολή
lis - αλεπού
literatura - λογοτεχνία
litera - γράμμα
litewski - λιθουανικός
Litwa - Λιθουανία
Litwinka - Λιθουανή
Litwin - Λιθουανός
lizać - γλείφω
liza - λύση
Lizbona - Λισαβόνα
Łk - Λκ
locha - γουρούνα
lodołamacz - παγοθραύστης , παγοθραυστικό
lodowiec - παγετώνας
lodówka - ψυγείο ; χιονόπαπια
łódź - βάρκα
lód - πάγος ; πάγος ; παγωτό
-logia - -λογία
logiczny - λογικός
lokalizacja - εντοπισμός
lokalny - επιτόπιος, τοπικός
łokieć - αγκώνας
lokomotywa - μηχανή
lokówka - σίδερο για μπούκλες ; μπικουτί , ρόλεϊ
lombard - ενεχυροδανειστήριο
londyńczyk - Λονδρέζος
Londyn - Λονδίνο , Λόντρα
łopatka - ωμοπλάτη ; σπάλα ; φτυάρι|φτυαράκι
lorens - λορένσιο
łosoś - σολομός
losowy - τυχαίος
łotewski - λετονικός
lotnictwo - αεροπορία
lotniskowiec - αεροπλανοφόρο
lotnisko - αεροδρόμιο , αερολιμένας
Łotwa - Λεττονία , Λετονία
Łotyszka - Λετονή
Łotysz - Λετονός
lot - πτήση ; πτήση
łowić ryby w mętnej wodzie - ψαρεύω σε θολά νερά, ψαρεύω στα θολά
łóżko - κρεβάτι
łozówka - βαλτοποταμίδα
łożysko - τριβέας , ρουλεμάν
lubieżny - λάγνος, φιλήδονος
Lublana - Λιουμπλιάνα
lub - ή
lucerna - αλφάλφα , τριφύλλι
Łucja - Λουκία
łucznictwo - τοξοβολία
łuczniczka - τοξότρια , τοξοβόλος
łucznik - τοξοβόλος
ludność - πληθυσμός
ludobójstwo - γενοκτονία
ludowy - λαϊκός; δημοτικός
ludożerca - ανθρωποφάγος
Ludwik - Λουδοβίκος
ludzie - κόσμος , άνθρωπος|άνθρωποι
ludzki - ανθρώπινος
Łukasz - Λουκάς
Luksemburczyk - Λουξεμβούργιος
Luksemburg - Λουξεμβούργο
luksemburski - λουξεμβουργιανός
luksus - λούσο , τρυφή ; λούσο
Łuk. - Λκ
łuk - τόξο
łupież - πιτυρίαση ; πιτυρίδα
lusterko wsteczne - κεντρικός καθρέφτης , πλαϊνός καθρέφτης
lustro - καθρέφτης
łuszczyca - ψωρίαση
luty - Φεβρουάριος , Φλεβάρης
lwia część - μερίδα του λέοντος
lwica - λέαινα , λιονταρίνα
Lwów - Λβιφ
łydka - γάμπα , γαστροκνημία
łysina - φαλάκρα
łyska - φαλαρίδα
łysy - φαλακρός
łyżeczka - κουταλάκι
łyżka wazowa - μεγάλος|μεγάλη κουτάλα
łyżka - κουτάλι ; κουταλιά
łyżwiarstwo - πατινάζ , παγοδρομία
łza - δάκρυ
macierzanka - θυμάρι
macierzyński - μητρικός
macierz - μήτρα , πίνακας
macocha - μητριά
Madagaskarczyk - Μαλαγάσιος
madagaskarski - μαλγασικός
Madagaskar - Μαδαγασκάρη
Madera - Μαδέρα
mądrość - σοφία
Madryt - Μαδρίτη
mafijny - μαφιόζικος
mafioso - μαφιόζος
magazynować - αποθηκεύω
magazyn - αποθήκη ; περιοδικό
Maghreb - Μαγκρέμπ
magia - μαγεία
magma - μάγμα
magnetyczny - μαγνητικός
magnez - μαγνήσιο
magnolia - μανόλια
Mahomet - Μωάμεθ
majonez - μαγιονέζα
majorowa - ταγματαρχίνα
major - ταγματάρχης i , επισμηναγός
Majotta - Μαγιότ
majstersztyk - αριστούργημα
maj - Μάης/ Μάιος
makaron - μακαρόνι
Makau - Μακάο
mąka - αλεύρι
makijaż - μακιγιάζ , μέικ απ
makówka - κάψα παπαρούνας , κωδία της μήκωνος
maksymalny - μέγιστος
Maksymilian - Μαξιμιλιανός
malachit - μαλαχίτης
malakologia - μαλακολογία , μαλακοζωολογία
Mała Niedźwiedzica - Μικρά Άρκτος
malaria - ελονοσία
malarstwo - ζωγραφική
malarz - μπογιατζής ; ζωγράφος
Malawi - Μαλάουι
Malediwy - Μαλδίβες
maleńki - μικρούλικος
Malezja - Μαλαισία
Małgorzata - Μαργαρίτα
malina - σμεουριά , βατομουριά ; σμέουρο
Mali - Μάλι
malować - βάφω; ζωγραφίζω; βάφομαι; ζωγραφίζομαι
mało - λίγος
małpa - μαϊμού , πίθηκος ; παπάκι
maltański - μαλτέζικος; μαλτέζικα
Malta - Μάλτα
mały - μικρός; μικρός
małżeństwo - γάμος ; αντρόγυνο
mama - μαμά , μάνα
mamusia - μαμάκα , μανούλα
manatki - πράγμα|πράγματα
mandarynka - μανταρινιά ; μανταρίνι ; μανδαρινόπαπια , πάπια μανδαρίνος
mandat - πρόστιμο
mandolina - μαντολίνο
mangan - μαγγάνιο
manna z nieba - μάννα εξ ουρανού
manometr - μανόμετρο
mapa - χάρτης
maraton - μαραθώνιος
marchew - καρότο
Marcin - Μαρτίνος
marcowy - μαρτιάτικος
margaryna - μαργαρίνη
Mariany Północne - Νήσοι Βόρειες Μαριάνες , Κοινοπολιτεία των Νήσων Βόρειες Μαριάνες
Maria - Μαρία
marihuana - χόρτο
marinizm - μαρινισμός
marmur - μάρμαρο
Marokańczyk - Μαροκινός
Maroko - Μαρόκο
Marsylia - Μασσαλία
Mars - Άρης
martwić - στεναχωρώ, στενοχωρώ
martwy - νεκρός
Martynika - Μαρτινίκα
marynarka - σακάκι ; ναυτικό
marynarz - ναύτης
marzec - Μάρτιος , Μάρτης
marzenie - όνειρο
masaż - μασάζ
maseczka - μάσκα
maska - μάσκα ; καπό
maskonur - θαλασσινός παπαγάλος , θαλασσοψιττακός
maślanka - βουτυρόγαλα
masło - βούτυρο
masochistka - μαζοχίστρια
masoneria - μασονία
mason - μασόνος
mastektomia - μαστεκτομή
masturbacja - αυνανισμός , μαλακία
maszt - κατάρτι
maszyna prosta - απλή μηχανή
maszynka do golenia - ξυράφι
matczyny - μητρικός
matematyczny - μαθηματικός
matematyka - μαθηματικά
materac - στρώμα
materia - ύλη ; ύλη
Mateusz - Ματθαίος
matka - μητέρα , μάνα , μαμά
mat - υποναύκληρος ; ματ ; θαμπάδα , ματ
Mauretania - Μαυριτανία
Mauritius - Μαυρίκιος
maurytyjski - μαυρικιανός
mauzoleum - μαυσωλείο
mąż - άντρας , σύζυγος ; άντρας
mebel - έπιπλο
mechanizm - μηχανισμός
meczet - τζαμί
mecz - αγώνας
medalion - μενταγιόν
medal - μετάλλιο
Medea - Μήδεια ; Μήδεια
mediana - διάμεσος
Mediolan - Μιλάνο
meduza - μέδουσα
medycyna - ιατρική
Med - Μήδος
męka - άλγος, κούραση
meksykański - μεξικάνικος
Meksyk - Μεξικό
melancholia - μελαγχολία
melasa - μελάσα
melodia - μελωδία
melon - πεπόνι
mendelew - μεντελέβιο / μεντελεγέβιο
menstruacja - εμμηνόρροια , περίοδος
Merkury - Ερμής ; Ερμής
metafora - μεταφορά
metalizacja - επιμετάλλωση
metal - μέταλλο
meteorologia - μετεωρολογία
meteoryt - μετεωρίτης
metoda - μέθοδος
metr kwadratowy - τετραγωνικό μέτρο
metronidazol - μετρονιδαζόλη
metroseksualny - μετροσεξουαλικός
metro - μετρό
metr - μέτρο
mewa - γλάρος
mężatka - παντρεμένος|παντρεμένη
mężczyzna - άντρας
Mezopotamia - Μεσοποταμία
mgła - ομίχλη
mianownik - ονομαστική ; παρονομαστής
miasto - πόλη
miau - νιαου
miażdżyca - αθηροσκλήρωση
Michał - Μιχαήλ, Μιχάλης
mieć bzika na punkcie czegoś - είμαι τρελός για
mieć ''coś'' na końcu języka - το έχω στην άκρη της γλώσσας μου
mieć węża w kieszeni - έχω καβούρια στην τσέπη
mięczak - μαλάκιο ; μαλακός
miecz Damoklesa - δαμόκλειος σπάθη
miecz - ξίφος , σπαθί
mieć - έχω; έχω; έχω; έχω; έχω; έχω
Międzynarodowa Agencja Energii Atomowej - Διεθνής Οργάνωση Ατομικής Ενέργειας
Międzynarodowy Dzień Kobiet - Διεθνής Ημέρα Γυναικών , Διεθνής Ημέρα της Γυναίκας
międzynarodowy - διεθνής
międzyplanetarny - διαπλανητικός
między - μεταξύ
miedź - χαλκός
miejsce artykulacji - τόπος άρθρωσης
miejsce - μέρος
miejscownik - τοπικός|τοπική πτώση
miejski - αστικός, δημοτικός
miękki - μαλακός
miesiąc - μήνας φεγγάρι
mięsień sercowy - μυοκάρδιο
mięsień - μυς , ποντίκι
mięso mielone - κιμάς
mięsożerny - σαρκοφάγος
mięso - κρέας
mieszaniec - μιγάδας , υβρίδιο
mieszkaniec - κάτοικος
mieszkanie - διαμέρισμα ; κατοικία
mięta - μέντα
migdał - αμυγδαλιά ; αμύγδαλο , μύγδαλο ; αμυγδαλή
migiem - μέχρι να πεις κύμινο, όσο να πεις κύμινο, μάνι μάνι
migrena - ημικρανία
Mikołaj - Νικόλαος
mikrobiologia - μικροβιολογία
mikrofon - μικρόφωνο
Mikronezja - Μικρονησία ; Ομόσπονδες Πολιτείες της Μικρονησίας
mikroorganizm - μικροοργανισμός
mikroskopijny - μικροσκοπικός
mikroskop - μικροσκόπιο
mila - μίλι
milczeć - σιωπώ, σωπαίνω
miliamper - μιλιαμπέρ
miliarder - δισεκατομμυριούχος
milioner - εκατομμυριούχος
mili- - μιλι-
miłość platoniczna - πλατωνικός έρωτας
miłość - αγάπη , έρωτας ; αγάπη
minaret - μιναρές
mina - γκριμάτσα , μορφασμός ; νάρκη
mineralogia - μεταλλειολογία
minerał - ορυκτό
minister - υπουργός
ministrant - παπαδάκι , παπαδοπαίδι
ministra - υπουργός
Mińsk - Μινσκ
mintaj - μπακαλιάρος της Αλάσκας , γάδος της Αλάσκας
minuta - λεπτό
miodowy miesiąc - μήνας του μέλιτος , σελήνη του μέλιτος
miód - μέλι ; υδρόμελι
miotła - σκούπα
Missisipi - Μισσισσιππής , Μισισιπής ; Μισισίπι
Mistra - Μυστράς
mistrzostwo - μαστοριά ; πρωτάθλημα
mitologia - μυθολογία
mitologiczny - μυθολογικός
mitolog - μυθολόγος
mityczny - μυθικός
mit - μύθος ; μύθος
mizantropia - μισανθρωπία
mi - μι
mleczarz - γαλατάς
mlecz - ζωχός ; αγριοράδικο
mleć - αλέθω
mleko - γάλα
młodość - νιότη , νιάτα
młody - νεαρός
młodzieniec - νεαρός
młotek - σφυρί
młynarz - μυλωνάς
młyn - μύλος
mniej więcej - περίπου, πάνω-κάτω
mnogi - πλήθος
mnożenie - πολλαπλασιασμός ; πολλαπλασιασμός ; πολλαπλασιασμός
moczopędny - διουρητικός
mocz - ούρο|ούρα
moc - ισχύς
móc - μπορώ
model - μοντέλο ; μοντέλο
modem - μόντεμ
modlić się - προσεύχομαι
modliszka - αλογάκι της Παναγίας
modlitwa - προσευχή
modrzew - λάριξ
Mojżesz - Μωυσής
mój - ο δικός εγώ|μου
mokry - βρεγμένος, μουσκεμένος
Mołdawia - Μολδαβία
molekuła - μόριο
molibden - μολυβδαίνιο
moment - στιγμή
Monachium - Μόναχο
monakijski - μονεγάσκικος
Monako - Μονακό
monarcha - μονάρχης
monarchia - μοναρχία
monarchista - μοναρχικός
Mongolia - Μογγολία
monitor - οθόνη
monoftong - μονόφθογγος
monokultura - μονοκαλλιέργεια
monoteizm - μονοθεϊσμός
monotonia - μονοτονία
morderca - φονιάς
morderstwo - δολοφονία
morela - βερικοκιά ; βερίκοκο
morena - μοραίνα , λιθώνας
morfem - μόρφημα
morfina - μορφίνη
morświn - φαλιανός
Morze Adriatyckie - Αδριατική Θάλασσα
Morze Bałtyckie - Βαλτική Θάλασσα
Morze Czarne - Μαύρη Θάλασσα
Morze Czerwone - Ερυθρά Θάλασσα
Morze Egejskie - Αιγαίο Πέλαγος , Αιγαίο
Morze Jońskie - Ιόνιο Πέλαγος
Morze Karaibskie - Καραϊβική Θάλασσα
Morze Martwe - Νεκρά Θάλασσα
Morze Śródziemne - Μεσόγειος Θάλασσα , Μεσόγειος
morze - θάλασσα , πέλαγος , πόντος , πέλαγο , πέλαο
mosiądz - ορείχαλκος
moskiewski - μοσχοβίτικος
Moskwa - Μόσχα
mostek - γεφυράκι ; στέρνο ; γέφυρα
most - γέφυρα ; γέφυρα Ουαρόλειος
moszna - όσχεο
motel - μοτέλ
motocykl - μοτοσικλέτα , μηχανάκι
motorniczy - τραμβαγέρης
motorower - μοτοσακό , μοτοποδήλατο , παπάκι
motyl - πεταλούδα
mowa jest srebrem, a milczenie złotem - τα λίγα λόγια είναι ζάχαρη, τα καθόλου μέλι
mówić na ty - μιλώ στον ενικός|ενικό
mówić - μιλώ, μιλάω
Mozambijczyk - Μοζαμβικανός
Mozambik - Μοζαμβίκη
moździerz - όλμος , ολμοβόλο ; γουδί
może - μπορεί
mózg - εγκέφαλος
można - μπορώ να, επιτρέπεται να
mrowisko - μυρμηγκιά
mrówka - μυρμήγκι
mszyca - αφίδα
mucha - μύγα ; παπιγιόν ; ομοίωμα μύγας
muezin - μουεζίνης
mugol - Μαγκλ
muł - μουλάρι , μούλος ; βόρβορος
mundur - στολή
musieć - πρέπει, πρέπει να
muślin - μουσελίνα
muszkiet - μουσκέτο
musztarda - μουστάρδα
muza - μούσα ; μούσα
muzeum - μουσείο ; μουσείο
muzułmanin - μουσουλμάνος
muzykalne ucho - μουσικό αυτί
muzykalny - μουσικός
muzykant - μουζικάντης
muzyka - μουσική
muzyk - μουσικός
myć - πλένω
mydelniczka - θήκη σαπούνι|σαπουνιού
mydło - σαπούνι
mykeński - μυκηναϊκός, μυκηναίος
Mykeny - Μυκήνες ; Μυκήνες
mylny - λανθασμένος, σφαλερός
mysikrólik - χρυσοβασιλίσκος
myśleć - σκέφτομαι
myśliwy - κυνηγός
myśl - σκέψη ; ιδέα
Myszka Miki - Μίκυ Μάους
mysz - ποντίκι ; ποντίκι
my - εμείς
na barana - καβάλα
nacjonalizować - εθνικοποιώ
naczyniak krwionośny - αιμαγγείωμα
naczynie - σκεύος , δοχείο , αγγείο ; αγγείο
naczyniowy - αγγειακός
nadawca - πομπός ; αποστολέας
naddźwiękowy - υπερηχητικός
nadgarstek - καρπός
nadgodzina - υπερωρία
nadir - ναδίρ
nadmiar - περίσσεμα
nadnercze - επινεφρίδιο
nadzieja - ελπίδα
Nadzieja - Ελπίδα
naga prawda - γυμνή αλήθεια
nagi - γυμνός
nagle - ξαφνικά
nagolenica - κνημίδα
nagolennik - περικνημίδα ; κνημίδα
nagranie - ηχογράφηση
nagroda - βραβείο
nagrywarka - συσκευή εγγραφής
naiwny - ναΐφ, απλοϊκός
najemnik - μισθωτός , μεροκαματιάρης ; μισθοφόρος
najpierw - πρώτα, κατ' αρχάς
naj- - + πιο
na końcu świata - τέρμα Θεού
naleśnik - κρέπα , τηγανίτα
należeć - ανήκω; ανήκω; πρέπει
należy - πρέπει
nałóg - εθισμός
Namibia - Ναμίμπια
namiot - σκηνή
na pewno - σίγουρα
napiwek - πουρμπουάρ
napletek - πόσθη
napój - ποτό
na przykład - παραδείγματος χάρη
na razie - για την ώρα, προσωρινά, προς το παρόν; τα λέμε, θα τα πούμε
narciarstwo wodne - θαλάσσιο σκι
Narcyza - Ναρκίσσα
narcyz - νάρκισσος
Narcyz - Νάρκισσος ; Νάρκισσος
narkoman - ναρκομανής , τοξικομανής
narkotyk - ναρκωτικό
narobić bigosu - τα κάνω σαλάτα
narodowość - εθνικότητα
naród - έθνος , λαός
narta - σκι
narzeczona - αρραβωνιαστικιά
narzędzie - εργαλείο
narzekać - παραπονιέμαι, παραπονιούμαι
nasierdzie - επικάρδιο
naskórek - επιδερμίδα
nastawić - ρυθμίζω; ρεγουλάρω; ανοίγω; τοποθετώ; στήνω; βάζω|βάζω1 προετοιμάζω
następca - διάδοχος
następnie - μετά, έπειτα, ύστερα
następny - επόμενος
naszyjnik - περιδέραιο , κολιέ
nasz - δικός εμείς|μας
naturalny - φυσικός
natychmiast - αμέσως
nauczycielka - δασκάλα
nauczyciel - δάσκαλος , καθηγητής
nauka - επιστήμη ; εκμάθηση , σπουδή , διάβασμα
nauki humanistyczne - ανθρωπιστικές επιστήμες
nauki polityczne - πολιτική επιστήμη
nauki społeczne - κοινωνικές επιστήμες
nauki stosowane - εφαρμοσμένες επιστήμες
naukowiec - επιστήμονας
naukowy - επιστημονικός
Nauru - Ναουρού
nawet - ακόμα και
nawias - παρένθεση
na wszelki wypadek - για κάθε ενδεχόμενο, διά παν ενδεχόμενο, καλού κακού
nawyk - χούι , ιδίωμα
na zdrowie - γείτσες!!; γειά μας, στην υγειά , εις υγείαν
nazwa - όνομα
nazwisko - επώνυμο
nazywać rzeczy po imieniu - λέω τα σύκα-σύκα και τη σκάφη-σκάφη, λέω τα πράγματα με τ' όνομά τους
nazywać - ονομάζω
Neapol - Νεάπολη , Νάπολη
negacja - άρνηση
nektarynka - νεκταρίνι
neologizm - νεολογισμός
neon - νέον
neo- - νέο-, νεο-, νιο-, νιό-
Nepal - Νεπάλ
nepotyzm - νεποτισμός
Neptun - Ποσειδώνας
nerka - νεφρό
nerpa - δακτυλιοφόρο φώκια
neutron - νετρόνιο
n.e. - μ.Χ.
nić Ariadny - μίτος της Αριάδνης
Nicea - Νίκαια
nić - κλωστή
nic - τίποτα, τίποτα δεν
Niderlandy - Κάτω Χώρες
niebezpieczeństwo - κίνδυνος
niebezpieczny - επικίνδυνος
niebieskooki - γαλανομάτης, μπλαβομάτης
niebo - ουρανός
niecierpliwie - ανυπόμονα
nieczystość - ακαθαρσία
niedaleko pada jabłko od jabłoni - το μήλο πέφτει κάτω από τη μηλιά
niedojrzały - ανώριμος; πράσινος, ανώριμος
niedokrwistość - αναιμία
niedopałek - γόπα
niedostatek - έλλειψη
niedouczony - αγράμματος
Niedziela Palmowa - Κυριακή των Βαΐων
niedziela - Κυριακή
niedźwiedzica - αρκούδα , άρκτος
niedźwiedź - αρκούδα , άρκτος
nielegalnie - παράνομα, παρανόμως
nielegalny - παράνομος, έκνομος
nie ma róży bez kolców - δεν υπάρχει ρόδο χωρίς αγκάθι
Niemcy Wschodnie - Ανατολική Γερμανία
Niemcy Zachodnie - Δυτική Γερμανία
Niemcy - Γερμανία
Niemiecka Republika Demokratyczna - Λαϊκή Δημοκρατία της Γερμανίας ''Laïkē Dëmokratía tës Germanías''
niemiecki - γερμανικός; γερμανικά
Niemiec - Γερμανός
Niemka - Γερμανίδα
niemowlę - μωρό , βρέφος
nienawidzić - μισώ
nieobecny - απών
nieoczekiwanie - ξαφνικά
nieoczekiwany - απροσδόκητος, ανέλπιστος
nie od razu Kraków zbudowano - η Ρώμη δε χτίστηκε σε μια μέρα
nieograniczony - απεριόριστος
niepełnosprawność - μειονέκτημα
niepewność - αβεβαιότητα
niepodległość - ανεξαρτησία
niepokoić - ανησυχώ
niepokój - ανησυχία
nieporozumienie - παρεξήγηση
niepotrzebny - περιττός
niepowodzenie - αποτυχία
nieprzytomny - λιπόθυμος, αναίσθητος
nieruchomo - ακίνητα
nieść - κουβαλώ
nieskończony - απέραντος, ατέλειωτος; ατέλειωτος, ατέρμων
nieśmiertelność - αθανασία
niesprawiedliwość - αδικία ; αδικία , αδίκημα
niestałość - αστάθεια , μεταβλητότητα
niestety - δυστυχώς
nie szata zdobi człowieka - το ράσο δεν κάνει τον παπά, τα ράσα δεν κάνουν τον παπά
nieszczęśliwy - καημένος, δυστυχισμένος, κακόμοιρος; άτυχος
nietoperz - νυχτερίδα
nieuwaga - απροσεξία , αμέλεια , αβλεψία
nie wierzyć własnym oczom - δεν πιστεύω στα μάτια μου
niewinny - αθώος
niewola - σκλαβιά , ''o zwierzęciu:'' αιχμαλωσία ; αιχμαλωσία
niewolnictwo - σκλαβιά , δουλεία
niewolnik - σκλάβος , δούλος
nie wszystko złoto, co się świeci - ό,τι λάμπει δεν είναι χρυσός
niewybaczalny - ασυγχώρητος
niewyobrażalny - αφάνταστος
niezadowolenie - δυσαρέσκεια
niezależny - ανεξάρτητος
niezapominajka - μυοσωτίς , μη με λησμόνει
nieznany - άγνωστος
nieznośny - αβάσταχτος, ανυπόφορος
nie - όχι, μην, δεν, μη
nigdy indziej - ποτέ άλλοτε‏
nigdy - ποτέ
nigdzie indziej - πουθενά αλλού
Nigerczyk - Νιγήριος
Nigeria - Νιγηρία
Nigeryjczyk - Νιγηριανός
Niger - Νίγηρας , Νίγηρ
Nikaraguańczyk - Νικαραγουανός
Nikaraguanka - Νικαραγουανή
Nikaragua - Νικαράγουα
nikiel - νικέλιο
Nikodem - Νικόδημος
nikotyna - νικοτίνη
Nikozja - Λευκωσία
nikt nie jest prorokiem we własnym kraju - ουδείς προφήτης στον τόπο του
nikt - κανένας, κανείς
Nil - Νείλος
niski - χαμηλός; ταπεινός
niszczyć - γκρεμίζω
Niue - Νιούε
ni - νι
nocny marek - ξενύχτης
nocny - νυχτερινός, νυχτιάτικος
noc - νύχτα
noga - πόδι ; πόδι
nora - φωλιά ; αχούρι
normalny - κανονικός
Norwegia - Νορβηγία
Norweg - Νορβηγός
norweski - νορβηγικός; νορβηγικά
Norweżka - Νορβηγίδα
nosiciel - φορέας
nosówka - μόρβα , νόσος του Carré , νόσος του Καρέ
nostalgia - νοσταλγία
nostalgiczny - νοσταλγικός
nos - μύτη ; ρύγχος
notes - σημειωματάριο , ατζέντα
Nowa Kaledonia - Νέα Καληδονία
nowalijka - πρώιμο οπωροκηπευτικό
Nowa Zelandia - Νέα Ζηλανδία
nowogrecki - νεοελληνικός; νέα ελληνική , νεοελληνική γλώσσα
noworodek - νεογέννητο , νεογνό
nowotwór - νεόπλασμα, όγκος
Nowozelandczyk - Νεοζηλανδός
Nowozelandka - Νεοζηλανδή
nowożeniec - νιόπαντρος
Nowy Rok - Πρωτοχρονιά
Nowy Świat - Νέος Κόσμος
nowy - καινούριος, καινούργιος, νέος
nów - νέα σελήνη , νέο φεγγάρι , νουμηωία
nożyczki - ψαλίδι
nóż - μαχαίρι
np. - π.χ.
numeryczny - αριθμητικός
numer - νούμερο
Numidia - Νουμιδία
nurkować - βουτώ
nurkowanie - βουτιά ; κατάδυση
nuta - νότα
NWD - Μ.Κ.Δ. ''''
oaza - όαση
obalać - ανατρέπω
obcas - τακούνι
obecny - σύγχρονος; παρών
obejmować - αγκαλιάζω; αναλαμβάνω; περιλαμβάνω, περιέχω
obezwładniać - αδρανοποιώ, ακινητοποιώ
obiad - γεύμα
obiecywać - τάζω
obieżyświat - κοσμογυρισμένος , ταξιδευτής
objaśniać - εξηγώ
objaw - σύμπτωμα
oblężenie - πολιορκία
obmierzły - σιχαμένος, βδελυρός
obojczyk - κλείδα
obój - όμποε
obora - βουστάσιο
obóz koncentracyjny - στρατόπεδο συγκεντρώσεως , στρατόπεδο συγκέντρωσης
obrócić w popiół - κάνω στάχτη
obrona - άμυνα
obrotnik - άξονας
obrus - τραπεζομάντιλο
obrzydliwiec - σκουλήκι
obserwować - παρατηρώ
obsesja - έμμονη ιδέα ; ιδεοληψία
obszar euro - ζώνη ευρώ
oburęczny - αμφιδέξιος
oburzenie - αγανάκτηση
obywatel - πολίτης
Ocean Arktyczny - Αρκτικός Ωκεανός
Ocean Atlantycki - Ατλαντικός Ωκεανός
Oceania - Ωκεανία
Ocean Indyjski - Ινδικός Ωκεανός
oceanografia - ωκεανογραφία
Ocean Spokojny - Ειρηνικός Ωκεανός
ocean - ωκεανός
ocena - εκτίμηση ; βαθμός
ocet - ξίδι
ochota - κέφι , προθυμία
och - ωχ
oczko - ματάκι ; εικοσιένα , εικοσιμία , στούκι
oczywisty - φανερός, ολοφάνερος
odbyt - πρωκτός
odcień - τόνος
odcisk palca - δακτυλικό αποτύπωμα
odcisk - αποτύπωμα ; κάλος
od czasu do czasu - κάπου κάπου, πότε πότε, κατά καιρούς, από καιρού εις καιρόν, από καιρό σε καιρό
oddawać - επιστρέφω
oddech - αναπνοή
oddychanie - αναπνοή
odejmowanie - αφαίρεση ; αφαίρεση
odjemna - μειωτέος
odjemnik - αφαιρετέος
odkurzacz - ηλεκτρική σκούπα
odległy - μακρινός
odmiana - κλίση
odpowiadać - απαντώ; απαντώ; αντιστοιχώ; απαντώ; απαντώ; ταιριάζω
odpowiedzialność - ευθύνη
odpowiedź - απάντηση
odwaga - θάρρος , τόλμη
odważnik - βαρίδι , σταθμά
odważny - γενναίος, άφοβος, θαρραλέος
odwłok - κοιλία
Ofelia - Οφηλία
oficjalny - επίσημος
ogień - φωτιά
ogłoszenie - άγγελμα , ανακοίνωση ; αγγελία
ogólnie - γενικά, γενικώς
ogólny - γενικός
ogon - ουρά
ogórek - αγγουριά ; αγγούρι
ogródek jordanowski - παιδική χαρά
ogrodnik - κηπουρός
ogród - κήπος
ogromny - τεράστιος, πελώριος
ohar - βαρβάρα
ojciec chrzestny - νονός
ojciec - πατέρας
ojcowie - γονείς , πατεράδες
ojczenasz - Πάτερ
ojczym - πατριός
ojczyzna - πατρίδα
okaryna - οκαρίνα
okienko - παραθυράκι ; θυρίδα
oklejarka - ρολό αυτοκόλλητη ταινία|αυτοκόλλητης ταινίας
okno - παράθυρο
okolicznik - προσδιορισμός
okołoporodowy - περιγεννητικός
około - περίπου, γύρω
okostna - περιόστεο
oko za oko, ząb za ząb - οφθαλμόν αντί οφθαλμού και οδόντα αντί οδόντος
oko - μάτι , οφθαλμός , όμμα
okrąg - περιφέρεια
okrakiem - καβάλα
okra - μπάμια
okresowy - περιοδικός; προσωρινός
okres - περίοδος
okręt - πολεμικό πλοίο , πολεμικό
okrutny - στυγνός
oktan - οκτάνιο
oktawa - οκταήμερο ; οκτάβα
okularnik - γυαλάκιας ; νάγια
okulary przeciwsłoneczne - γυαλιά ηλίου
okulary - γυαλιά
okulista - οφθαλμίατρος , οφθαλμολόγος
okupacja - κατοχή ; κατάληψη
okup - λύτρα
olbrzym - γίγας , γίγαντας
olej - λάδι
olimpijski - ολύμπιος; ολυμπιακός
Olimp - Όλυμπος
oliwa - έλαιο , ελαιόλαδο
oliwka - ελιά , ελαιόδεντρο ; ελιά
ołówek - μολύβι
ołów - μόλυβδος
ołtarz - βωμός
o mały włos - παρά τρίχα
Omańczyk - Ομανός
Omanka - Ομανή
omański - ομανικός
Oman - Ομάν
omega - ωμέγα
omikron - όμικρον
omlet - ομελέτα
omnipotencja - παντοδυναμία
omocznia - αλλαντοειδής υμένας , αλλαντοΐδα
onanizm - αυνανισμός
ona - αυτή
one - αυτοί, αυτές, αυτά
onomatopeja - ονοματοποιία
ono - αυτό, εκείνο
ontologia - οντολογία
ONZ - Ο.Η.Ε.
on - αυτός
opactwo - αβαείο
opalenizna - μαύρισμα
opat - αβάς , αββάς
opieka - φροντίδα
opinia publiczna - κοινή γνώμη
opinia - γνώμη ; όνομα , φήμη
opium - όπιο
opona - λάστιχο ; μηνίγγι
oportunizm - οπορτουνισμός , καιροσκοπισμός
opowiadać - λέγω, αφηγούμαι, ιστορώ, διηγούμαι
opozycja - αντίρρηση ; αντιπολίτευση ; αντίθεση
oprócz - εκτός
oprogramowanie - λογισμικό
optować - επιλέγω, διαλέγω
optymizm - αισιοδοξία , οπτιμισμός
oralny - προφορικός, στοματικός; στοματικός
orangutan - ουραγκοτάγκος , ουρακοτάγκος
oranżada - πορτοκαλάδα
Oran - Οράν
Orchomenos - Ορχομενός
ordalia - αγνεία|αγνείας πείρα
oregano - ρίγανη
Organizacja Narodów Zjednoczonych - Οργανισμός Ηνωμένων Εθνών
organizacja - οργανισμός ; διοργάνωση
organizm - οργανισμός
organizować - οργανώνω
ornitologia - ορνιθολογία
ornitolog - ορνιθολόγος /
oronim - ορώνυμο
ortografia - ορθογραφία
orzech ziemny - αραχίδα
orzech - καρυδιά ; καρυδιά
orzeczenie - ρήμα , κατηγόρημα
osądzić - δικάζω
osąd - κρίση
Osaka - Οσάκα
osa - σφήκα
oscylacja - ταλάντωση
Osetia Południowa - Νότια Οσετία
oset - γαϊδουράγκαθο
osiedle - συνοικία , οικισμός
osiemnastolatek - δεκαοχτάρης, δεκαοχτάχρονος
osiemnastoletni - δεκαοχτάρης, δεκαοχτάχρονος; δεκαοχτάχρονος
osiołek Buridana - γαϊδούρι του Μπουριντάν
osiołek - γαϊδουράκι
osioł - γάιδαρος , γαϊδούρι
oskarżony - κατηγορούμενος
osłomuł - μουλάρι
Oslo - Όσλο
ośmiornica - χταπόδι
ósmy cud świata - όγδοο θαύμα του κόσμου
osm - όσμιο
osoba - άτομο ; πρόσωπο
osobistość - προσωπικότητα
ostatnia deska ratunku - σανίδα σωτηρίας
Ostatnia Wieczerza - Μυστικός Δείπνος
ostatnio - πρόσφατα; τελευταία
ostatni - τελευταίος
osteoporoza - οστεοπόρωση
ostrokrzew - ίλεξ , αρκουδοπούρναρο
ostrosłup - πυραμίδα
ostrożnie - προσεχτικά
ostryga - στρείδι
ostrzegawczy - προειδοποιητικός
ostrzeżenie - προειδοποίηση
ostrze - κόχη , λάμα , λεπίδα
osuwisko - κατολίσθηση
Oświęcim - Οσβιέτσιμ; Άουσβιτς
oszczepnik - ακοντιστής
oszukańczy - δόλιος, απατηλός, πλανερός
oś - άξονας
otchłań - άβυσσος
otoczak - βότσαλο
otręby - πίτουρο
otwarty - ανοικτός
otwieracz - ανοιχτήρι
otwierać - ανοίγω
otwór - άνοιγμα
owadobójczy - εντομοκτόνος
owadożerca - εντομοφάγο
owadożerny - εντομοφάγος
owad - έντομο
owca - πρόβατο , προβατίνα
owczy - πρόβιος, προβατίσιος
Owernia - Οβέρνη
owies - βρόμη
o wilku mowa, a wilk tu - κατά φωνή κι ο γάιδαρος, κατά φωνή και το πουλί
owoc - φρούτο
ozdabiać - στολίζω
ożenić - νυμφεύομαι, '''' παντρεύομαι, στεφανώνομαι
ozon - όζον
Ozyrys - Όσιρις
pacha - μασχάλη
pachnieć - μυρίζω
pacjent - ασθενής , πελάτης γιατρός|γιατρού
pafijski - πάφιος
pagaj - παγαία
pajac - παλιάτσος , αρλεκίνος ; νευρόσπαστο
pająk - αράχνη
pajęczyna - ιστός η|της αράχνη|αράχνης
Pakistańczyk - Πακιστανός
Pakistanka - Πακιστανή
Pakistan - Πακιστάν
palacz - καπνιστής ; θερμαστής
Palau - Παλάου
palec - δάχτυλο , δάκτυλος ; δείκτης ; δάχτυλο
paleografia - παλαιογραφία
paleolityczny - παλαιολιθικός
paleo- - παλαιο-
Palermo - Παλέρμο
Palestyna - Παλαιστίνη
Palestynka - Παλαιστίνια
palestyński - παλαιστινιακός
palić jak smok - καπνίζω σαν Αράπης
palić za sobą mosty - γκρεμίζω τις γέφυρες, κόβω τις γέφυρες
paliczek - φάλαγγα
palimpsest - παλίμψηστο
palindrom - καρκινικός στίχος
paliwo - καύσιμο
pallad - παλλάδιο
pamięć - μνήμη
panaceum - πανάκεια
Panama - Παναμάς
Panamczyk - Παναμέζος
Pan Bóg nierychliwy, ale sprawiedliwy - ο Θεός αργεί, μα δε λησμονεί
pancernik - αρμαδίλιο , αρμαντίλλο ; θωρηκτό
pancerz - καύκαλο ; θώρακας
pandeizm - παντεϊσμός
pandemia - πανδημία
panichida - μνημόσυνο
panna - δεσποινίδα , δεσποινίς
Panna - Παρθένος ''Parthénos''
panorama - πανόραμα
panoramiczny - πανοραμικός
państwowy - κρατικός
państwo - κράτος ; ομάδα άτομο|ατόμων με άντρας|άντρες και γυναίκα|γυναίκες, κυρίες και κύριοι; ανδρόγυνο , ο κύριος και η κυρία; αφεντικό|αφεντικά
pan - κύριος ; δεσπότης
Pan - Κύριος ; Παν
papierośnica - τσιγαροθήκη , ταμπακιέρα
papieros - τσιγάρο
papier wartościowy - τίτλος , αξιόγραφο , αξία
papier - χαρτί ; χαρτί
papieski - παπικός
papież - πάπας , ποντίφικας
paproć - φτέρη
Papua-Nowa Gwinea - Παπουασία-Νέα Γουινέα
papużka falista - παπαγαλάκι
parabola - παραβολή ; παραβολή
paradoksalny - παράδοξος
paradygmat - παράδειγμα
paragraf - παράγραφος
Paragwaj - Παραγουάη
paraliż - παράλυση
paralotniarstwo - παραπέντε , αλεξίπτωτο πλαγιάς
parametr - παράμετρος
parazytologia - παρασιτολογία
para - ζευγάρι ; ζευγάρι ; ζευγάρι ; ζευγάρι ; ταίρι ; ατμός
para- - παρα-, παρά-, παρ-
parch - ψώρα
paremia - παροιμία
parkinson - πάρκινσον
park narodowy - εθνικός δρυμός
park - πάρκο
parlamentarny - βουλευτικός, κοινοβουλευτικός
Parlament Europejski - Ευρωπαϊκό Κοινοβούλιο
parlament - κοινοβούλιο
parmezan - παρμεζάνα
parówka - λουκάνικο , λουκάνικο Φρανκφούρτη|Φρανκφούρτης
parowóz - ατμάμαξα , ατμομηχανή
parter - ισόγειο
partykuła - μόριο
paruzja - παρουσία
paryski - παρισινός
paryżanin - Παρισινός , Παριζιάνος
paryżanka - Παρισινή , Παριζιάνα
Paryż - Παρίσι
parzyć - ζεματίζω
parzysty - ζυγός
pasek narzędzi - γραμμή εργαλείων
pasożyt - παράσιτο ; παράσιτος
pasterka - νυχτερινός|νυχτερινή δοξολογία της παραμονής ο|των Χριστούγεννα|Χριστουγέννων; βοσκοπούλα
pasterz - βοσκός , ποιμένας ; ποιμένας
pasticjo - παστίτσιο
pastisz - παστίτσιο
pasywność - παθητικότητα
pasza - πασάς ; κτηνοτροφή
paszkwil - λίβελος ; φώκια , μπάζο
paszport - διαβατήριο
pasztet - πατέ
patelnia - τηγάνι
patetyczny - παθητικός
patio - μεσαύλιο
patriotyzm - πατριωτισμός
patronimiczny - πατρωνυμικός
patrzeć - κοιτάζω
patyczek do szaszłyków - καλαμάκι
patyk - ξύλο
patyna - πατίνα
pat - πατ
Paweł - Παύλος
pawian - βαβουίνος
paw - παγόνι
październik - Οκτώβριος
paznokieć - νύχι
pchnięcie kulą - σφαιροβολία
pedał - πεντάλ ; πούστης , κίναιδος , αδελφή
pediatra - παιδίατρος
pedikiurzystka - πεντικιουρίστα
pęd - ταχύτητα , ορμή ; ορμή ; βλαστάρι ; ορμή
pejoratywny - εξευτελιστικός
Pekin - Πεκίνο
pelikan - πελεκάνος
pełnia - πανσέληνος
pełzanie - ερπυσμός ; ερπυσμός
penis - πέος
Pentateuch - Πεντάτευχος
pępek - ομφαλός
pergola - κληματαριά , πέργκολα
perkusista - ντράμερ , ντραμίστας
perła - μαργαριτάρι
perliczka - φραγκόκοτα
peron - πλατφόρμα
Perseusz - Περσέας ; Περσεύς
personel - προσωπικό
peruka - περούκα
Peruwiańczyk - Περουβιανός
Peruwianka - Περουβιανή
peruwiański - περουβιανός
pestycyd - φυτοφάρμακο
pesymizm - πεσιμισμός
petrografia - πετρογραφία
petrologia - πετρολογία
pewien - κάποιος; σίγουρος
piana - αφρός
pianino - πιάνο
pianista - πιανίστας
pianistka - πιανίστρια , πιανίστα
piasek - άμμος
piąte koło u wozu - πέμπτος τροχός της αμάξης , τελευταίος τροχός της αμάξης
piątek - Παρασκευή
pić jak szewc - πίνω σαν σφουγγάρι
pić - πίνω
piechota - πεζικό
pięciobój - πένταθλο
pięciokąt - πεντάγωνο
pięciokrotnie - πεντάκις
Pięcioksiąg - Πεντάτευχος
pięciolecie - πενταετία
pieczeń - ψητό
pieczona głowa - κεφαλάκι
pieczywo - αρτοσκεύασμα
piec - φούρνος , κλίβανος , σόμπα , θερμάστρα ; ψήνω, ψένω; τσούζω, καίω; καίω
piędź - παλάμη
piegus - φακιδιάρης
piegża - λαλοτσιροβάκος
pieg - φακίδα , πανάδα
piekarnia - αρτοποιείο ; αρτοπωλείο ; φούρνος
piekarz - αρτοποιός , φούρναρης
piekło - κόλαση
piękno - κάλλος , ομορφιά
piękny - όμορφος
pielęgniarka - νοσοκόμα
pieniądz - χρήμα
pień - κορμός
pieprzyca siewna - κάρδαμο
pieprz - πιπεριά ; πιπέρι
pierdolić - γαμώ, πηδάω; δεν|Δε γαμώ|γαμείς!
pierdzieć - κλάνω, πορδίζω
pierścień - δαχτυλίδι ; δακτύλιος
pierścionek - δαχτυλίδι
pierś - μαστός , στήθος ; στήθος
pierwiastek - στοιχείο ; ρίζα
pierworodny - πρωτότοκος
pierwsza pomoc - πρώτες βοήθειες
pięść - γροθιά
piesek preriowy - κυνόμυς
pieśń - τραγούδι
pies policyjny - λαγωνικό η|της αστυνομία|αστυνομίας
pieszo - περπατώ|περπατώντας, με τα πόδια, πεζή
pies - σκύλος , σκυλί
pięta Achillesa - αχίλλειος φτέρνα
pięta - φτέρνα
piętro - όροφος
pietruszka - μαϊντανός
pigment - χρωστική ; χρώμα , μπογιά
pigwa - κυδωνιά ; κυδώνι
pijany - μεθυσμένος
pijawka - βδέλλα
piksel - πίξελ , εικονοστοιχείο
pilaster - πίλαστρο
piłka nożna - ποδόσφαιρο
piłka ręczna - χειροσφαίριση
piłkarski - ποδοσφαιρικός
piłkarz - ποδοσφαιριστής
piłka - μπάλα ; μπάλα ; μπάλα ; πριονάκι
pilot - πιλότος ; τηλεχειριστήριο
pinakoteka - πινακοθήκη
pinezka - πινέζα
pinyin - πινγίν
pionier - πιονέρος
piorun - κεραυνός , αστραπή
piosenkarka - τραγουδίστρια
piosenkarz - τραγουδιστής
piosenka - τραγούδι
Piotr - Πέτρος
piramida - πυραμίδα ; πυραμίδα ; πυραμίδα
pirat - πειρατής ; πειρατής
Pireus - Πειραιάς
Pismo - Γραφή , Γραφές
pismo - γραφή ; έγγραφο ; έντυπο ; γραφή
pistacja - φιστίκι
pistolet maszynowy - οπλοπολυβόλο
pisuar - ουρητήριο ; ουρητήριο
Pitagoras - Πυθαγόρας
piuska - καλότα
piwiarnia - μπιραρία , μπυραρία
piwo - μπύρα
piżama - πιτζάμα
Pizydia - Πισιδία
pi - πι
PKB - Α.Ε.Π.
płaca - μισθός
płacić - πληρώνω
płacz - κλάμα
plac - πλατεία
płakać jak bóbr - αναλύομαι σε δάκρυα, αυλάκι τρέχουν τα δάκρυα μου
płakać - κλαίω
plama słoneczna - ηλιακή κηλίδα
plama - λεκές ; κηλίδα , στίγμα
planetarium - πλανητάριο
planeta - πλανήτης
planisfera - επιπεδόσφαιρο
plastelina - πλαστελίνη
płaszczka - σαλάχι
płaszczyzna - επίπεδο
płaszcz - πανωφόρι , παλτό
płatek śniegu - νιφάδα
platfus - πλατυποδία ; πλατύποδας
Platon - Πλάτων
Platon - Πλάτωνας
plaża - παραλία
płaz - αμφίβιο
płciowy - σεξουαλικός
plecak - σακίδιο
plecy - πλάτη
płeć - φύλο
plemię - φυλή
plemnik - σπερματοζωάριο
płetwa - πτερύγιο ; βατραχοπέδιλο
plik - μάτσο ; αρχείο
plotkara - κότα
plotka - κουτσομπολιό
plotkować - κουτσομπολεύω, κουτσομπολιάζω
płuco - πνεύμονας
pług - αλέτρι , άροτρο
Pluton - Πλούτωνας ; Πλούτωνας
pluton - πλουτώνιο ; ουλαμός , θάλαμος
płynny - ρευστός
płyn - υγρό
płyta główna - μητρική κάρτα
płytkarz - πλακάς
pływanie - κολύμβηση
p.n.e. - π.Χ.
pobożny - θρησκευόμενος
pobudliwy - ευερέθιστος
pocałunek - φιλί
pochodnia - πυρσός
pochodzenie - καταγωγή
pochodzić - κατάγομαι, προέρχομαι
pochwa - κόλπος : θηκάρι
pociąg - τρένο ; έλξη
pocieszać - παρηγορώ
pocisk manewrujący - πύραυλος τύπου Κρουζ , πύραυλος Κρουζ
początek - αρχή , έναρξη
początkowy - αρχικός
poczekalnia - αίθουσα αναμονή|αναμονής
poczta pantoflowa - ράδιο αρβύλα
poczta - ταχυδρομείο
pocztówka - καρτ ποστάλ
pocztowy - ταχυδρομικός
poczucie humoru - αίσθηση του χιούμορ
podatek od wartości dodanej - φόρος προστιθέμενης αξίας
podatek od zysków kapitałowych - φορολογία επί των κεφαλαιακών κερδών
podatek - φόρος , φορολογία
podatnik - φορολογούμενος
pod egidą - υπό την αιγίδα
podejrzewać - υποψιάζομαι, υποπτεύομαι
Podgorica - Ποντγκόριτσα
podgorzałka - βαλτόπαπια
podium - βάθρο ; βάθρο
podkolanówka - κάλτσα ως ο|το γόνατο
podkoszulek - φανέλα
podkowa - πέταλο
podłoga - δάπεδο , πάτωμα
podmiot - υποκείμενο
podniebienie - υπερώα , ουρανίσκος ; ουρανίσκος
podnosić kogoś na duchu - τονώνω το ηθικό
podnośnik - ανυψωτήρας
podobać się - αρέσω
podobny - όμοιος
podpis - υπογραφή
podpułkownik - αντισυνταγματάρχης
podręcznik - εγχειρίδιο
podróżniczek - γαλαζολαίμης
podróżnik - ταξιδιώτης
podróżować - ταξιδεύω
podróż - ταξίδι
podrywać - καμακώνω
podstawa - βάση , υπόβαθρο ; αρχή ; στοιχείο|στοιχεία
podstawowy - βασικός
podstrunnica - ταστιέρα
podstrunnik - ταστιέρα
poduszka powietrzna - αερόσακος
poduszka - μαξιλάρι
podwójna moralność - δύο μέτρα και δύο σταθμά
podwójny - διπλός; διπλάσιος
podwórze - αυλή
podziękowanie - ευχαριστία
poeta - ποιητής
poetka - ποιήτρια
poetycki - ποιητικός
poezja - ποίηση
pogarda - περιφρόνηση
pogoda - καιρός
pojawiać się - εμφανίζομαι
pojazd - όχημα ; αμάξι
pojedynczy - ενικός, μεμονωμένος, μονός, απλός
pojemnik - αγγείο
pojutrze - μεθαύριο
pokój - ειρήνη ; ειρήνη ; ειρήνη ; δωμάτιο , κάμαρα
pokrzywa - τσουκνίδα
pokrzywka - ουρτικάρια
pokuta - επιτίμιο
Polak - Πολωνός
polecony - συστημένος
poliandria - πολυανδρία
policjant - αστυνόμος , αστυνομικός
policja - αστυνομία ; τμήμα ; κοσμιότητα , ευπρέπεια
policzek - μάγουλο ; χαστούκι , μπάτσος
poliglota - πολύγλωσσος
polimeryzacja - πολυμερισμός
Polinezja Francuska - Γαλλική Πολυνησία
Polinezja - Πολυνησία
polityczny - πολιτικός
polityk - πολιτικός
Polka - Πολωνίδα
północnokoreański - βορειοκορεατικός
północny zachód - βορειοδυτικός|βορειοδυτικά
północny - βόρειος
północ - μεσάνυχτα ; βορράς
połóg - λεχωνιά , λοχεία
polon - πολώνιο
polowanie na czarownice - κυνήγι μαγισσών
polowanie - κυνήγι ; κυνηγητό
połowa - μισός
półprzewodnik - ημιαγωγός
Polska - Πολωνία
polski - πολωνικός; πολωνικά , πολωνική γλώσσα
półton - ημιτόνιο
półtora - ενάμισης , ενάμισι
półtorej - μιάμιση
południe - μεσημέρι ; νότος
południowy - νότιος
Półwysep Bałkański - Βαλκανική Χερσόνησος
półwysep - χερσόνησος
pół - μισό
pomagać - βοηθώ
pomalutku - σιγά σιγά
pomarańcza - πορτοκάλι πορτοκαλιά
pomarańczowy - πορτοκαλής
pomidorówka - ντοματόσουπα
pomidor - ντοματιά ; ντομάτα
pomimo - παρά
pomocnik - βοηθός; βοηθός
pomoc - βοήθεια
po moim trupie - πάνω από το πτώμα μου
pompa - αντλία ; νεροποντή ; πομπή
pomurnik - τοιχοδρόμος , σβαρνίστρα
ponad - πάνω από
poniedziałek - Δευτέρα
ponieważ - αφού, γιατί, επειδή
poniewczasie - πάρα πολύς|πολύ αργός|αργά
po omacku - στα τυφλά
popielniczka - τασάκι
popiół - στάχτη
poprawny - σωστός, άσφαλτος
poprzednio - προηγουμένως
poprzedni - προηγούμενος
poranny - πρωινός
pora roku - εποχή
poród - τοκετός , γέννα
poronienie - αποβολή
porównanie - σύγκριση ; παρομοίωση
porównywać - συγκρίνω
portfel - πορτοφόλι
Portoryko - Πουέρτο Ρίκο
portret - πορτρέτο ; πορτρέτο
Portugalczyk - Πορτογάλος
Portugalia - Πορτογαλία
Portugalka - Πορτογαλίδα
portugalski - πορτογαλικός
port - λιμάνι , λιμένας ; αερολιμένας
porucznik - υπολοχαγός , υποσμηναγός
poruszać - κινώ
poruszyć niebo i ziemię - κινώ γη και ουρανό
porządek dorycki - δωρικός ρυθμός
porządek joński - ιωνικός ρυθμός
porządek koryncki - κορινθιακός ρυθμός
por - πράσο
posadzka - πάτωμα
posag - προίκα
Posejdon - Ποσειδώνας , Ποσειδών
posiadać - έχω, διαθέτω
posiłek - φαγητό , τροφή
pośladek - γλουτός , κωλομέρι , μπσύτι
pośpiech - βιασύνη
postępować - δρω, ενεργώ; προχωρώ, αναπτύσσω
postępowanie - διαδικασία , δικονομία ; συμπεριφορά, διαγωγή
postrzegać - διακρίνω
post - νηστεία ; νηστεία
poświęcać - αφιερώνω, αφοσιώνω, θυσιάζω; αφιερώνομαι, αφοσιώνομαι, θυσιάζομαι
potas - κάλιο
potem - μετά, έπειτα, ύστερα
potencjometr - ποτενσιόμετρο , ρεοστάτης , ροοστάτης
potocznie - συνήθως, γενικά
potomek - απόγονος , τέκνον
potomstwo - απόγονος|απόγονοι
potop - κατακλυσμός ; πλημμύρα
potrawa - φαγητό
potrzeba - ανάγκη ; ανάγκη ; πρέπει
potrzebować - θέλω
potwór - τέρας
pot - ιδρώτας
poważny - σοβαρός; σοβαρός; σοβαρός
powiedzieć - λέω
powieka - βλέφαρο
powieść - μυθιστόρημα
powietrze - αέρας
powinność - καθήκον
powodzenie - επιτυχία , προκοπή
powódź - πλημμύρα
powód - αιτία ; λόγος ; ενάγων
powoli - σιγά, αργά
pożar - πυρκαγιά
poza - πόζα ; εκτός
pozbawiać - στερώ, αφαιρώ
pozew - αγωγή
poziomica - αλφάδι ; ισοϋψής
poziomy - οριζόντιος
poziom - επίπεδο
późno - αργά
prababcia - προγιαγιά
pracodawca - εργοδότης
pracować - δουλεύω, εργάζομαι
pracownica - εργαζόμενη
pracownik - εργαζόμενος
praczka - πλύντρια
prądnica - γεννήτρια , δυναμό
pradziadek - προπαππούς
prąd - ρεύμα
Praga - Πράγα ; Πράγα
pragnąć - επιθυμώ, ποθώ
pragnienie - δίψα
pralka - πλυντήριο
prasowanie - σιδέρωμα
prawa człowieka - ανθρώπινα δικαιώματα
prawa zwierząt - δικαιώματα των ζώων
prawda - αλήθεια
prawdopodobnie - πιθανόν, πιθανώς
prawidłowy - σωστός, ορθός, ευπρεπής
prawie - σχεδόν, παραλίγο
prawo ciążenia Newtona - νόμος της βαρύτητας του Νεύτωνα , νόμος της παγκόσμιας έλξης
prawo jazdy - άδεια οδηγήσεως , δίπλωμα οδήγησης
prawo karne - ποινικό δίκαιο
prawo pierwszej nocy - δικαίωμα της πρώτης νύχτας
prawo publiczne - δημόσιο δίκαιο
prawoskrętny - δεξιόστροφος
prawosławny - ορθόδοξος; ορθόδοξος
prawowity - νόμιμος
prawy - δεξιός
prażyć - ψήνω
pręcik - στήμονας
precz - κάτω
prędkościomierz - κοντέρ
predylekcja - προτίμηση
prehistoria - προϊστορία
prekolumbijski - προκολομβιανός
prekursor - πρόδρομος
premier - πρωθυπουργός
prenumerata - συνδρομή
prezent - δώρο
prezydent - Πρόεδρος
primaaprilisowy - πρωταπριλιάτικος
prima aprilis - πρωταπριλιά
primogenitura - πρωτοτόκια
priorytet - προτεραιότητα
próba - πρόβα , δοκιμή ; προσπάθεια ; δείγμα
problem - πρόβλημα
próbować - δοκιμάζω; κάνω πρόβα
proca - καταπέλτης
procesor - επεξεργαστής
produkt krajowy brutto - ακαθάριστο εγχώριο προϊόν
profesorka - καθηγήτρια
prognatyzm - προγναθισμός , προγναθία
programista - προγραμματιστής
próg - τάστο
proletariat - προλεταριάτο
promień - ακτίνα ; ακτίνα ; ακτίνα
promocja - προώθηση
prom - φέριμποτ
propan - προπάνιο
proponować - προτείνω
proroctwo - προφητεία
proroczy - προφητικός
prorokini - προφήτισσα
prorok - προφήτης
prośba - παράκληση , αίτηση
prosić - παρακαλώ
prosię - γουρουνόπουλο , γουρουνάκι
proso - κεχρί
prosta - ευθεία
prostokątny - ορθογώνιος
prostokąt - ορθογώνιο
prostopadłościan - ορθογώνιο παραλληλεπίπεδο
prostytucja - πορνεία
prostytutka - πόρνη
protaktyn - πρωτακτίνιο
proteina - πρωτεΐνη
protekcjonizm - προστατευτισμός
protesis - πρόθεση
protokół - πρωτόκολλο
proton - πρωτόνιο
protozoologia - πρωτοζωολογία
proto- - πρωτο-
prowansalski - Οσιτανικά
prowizja - προμήθεια
prowokacyjny - προκλητικός, προβοκατόρικος
próżnia - κενό
Prusy - Πρωσία
pryk - γεροξεκούτης
prymas - πριμάτος
prysznic - ντους
prywatny - ιδιωτικός
przebaczenie - συγχώρηση, συχώρεση
przebiegły - πονηρός
przechadzka - περίπατος , βόλτα
przeciąg - ρεύμα
przecinek - κόμμα
przeciwciało - αντίσωμα
przeciwczołgowy - αντιαρματικός
przeciwgruźliczy - αντιφυματικός
przeciwlotniczy - αντιαεροπορικός
przeciwnik - αντίπαλος , αντίμαχος
przeciwpancerny - αντιαρματικός
przeciwstawiać - αντιτάσσω, αντιθέτω; αντιστέκομαι, εναντιώνομαι, αντιτίθεμαι
przeciwutleniacz - αντιοξειδωτικό , αντιοξειδωτικός|αντιοξειδωτική ουσία
przeciwzapalny - αντιφλεγμονώδης
przeczuwać - διαισθάνομαι, προαισθάνομαι
przedostatni - προτελευταίος
przedpogrzebowy - επικήδειος
przedsiębiorstwo - επιχείρηση , εταιρεία
przedstawiciel - αντιπρόσωπος ; πρότυπο , δείγμα
przedstawienie - παράσταση ; παρουσίαση
przedszkole - νηπιαγωγείο
przedwczesny - πρόωρος
przedwczoraj - προχθές, προχτές
przedział - κουπέ ; διάστημα , πεδίο
przegroda nosowa - ρινικό διάφραγμα
przekąska - μεζές , μεζεδάκι ; ορντέβρ
przekątna - διαγώνιος
przekraczać - ξεπερνώ
przelew - μεταφορά ; υπερχείλιση
przemoc - βία ; βίαια
przemysłowy - βιομηχανικός
przemysł zbrojeniowy - βιομηχανία όπλων
przemysł - βιομηχανία
przemytnik - λαθρέμπορας
przenikliwy - διαπεραστικός, δριμύς; διορατικός, οξυδερκής
przenośnie - μεταφορικά
przenośny - φορητός; μεταφορικός
przepaść - γκρεμός
przepiórka - ορτύκι
przepraszam - συγνώμη, συγγνώμη; με συγχωρείς '''', με συγχωρείτε ''''
przerwa - διακοπή ; διάλειμμα ; άνοιγμα
przesadny - υπερβολικός
prześcieradło - σεντόνι
przestarzały - απαρχαιωμένος
przestępca - παραβάτης
przestępczość - εγκληματική συμπεριφορά ; εγκληματικότητα
przestępstwo - αδίκημα
przestrzeń - χώρος ; περιβάλλον ; διάστημα
przestworze - απεραντοσύνη , άπειρο
przesyłka - αποστολή
przeszkadzać - εμποδίζω, ενοχλώ, δυσκολεύω
przeszkoda - εμπόδιο
przeszłość - παρελθόν
przewaga - υπεροχή
przeważać - επικρατώ, υπερισχύω; βαραίνω
przewodnik - ξεναγός, οδηγός; οδηγός; αγωγός
przewrażliwienie - υπερευαισθησία
przeziębienie - κρυολόγημα
przeżuwacz - μηρυκαστικό
przybity - καρφώνω|καρφωμένος; αποθαρρύνω|αποθαρρημένος, θλιμμένος
przychodzić - έρχομαι, φτάνω
przychylny - ευμενής, ευνοϊκός
przyczyna - αιτία
przy drzwiach zamkniętych - κεκλεισμένων των θυρών
przyimek - πρόθεση
przyjaciel - φίλος
przyjaźń - φιλία
przykład - παράδειγμα
przymiotnik - επίθετο
przymrozek - παγετός
przypadek - τυχαία; πτώση ; περίπτωση
przyprawa - άρτυμα
przyprawiać komuś rogi - κερατώνω, φορώ τα κέρατα σε κάποιον
przyprawić komuś rogi - φορώ τα κέρατα σε κάποιον
przyroda - φύση
przyrodnik - φυσιοδίφης
przyrostek - επίθημα
przysięga - όρκος
przysłówek - επίρρημα
przysłowie - παροιμία
przyśpieszenie - επιτάχυνση
przystanek autobusowy - στάση λεωφορείο|λεωφορείου
przystanek - στάση
przyszłość - μέλλον
przyszły - μελλοντικός, μέλλων; ερχόμενος, επόμενος
przywiązywać wagę do czegoś - δίνω αξία
przywilej - προνομία , προνόμιο
psalm - ψαλμός
psi - ψι
psowate - Κυνίδες
pstry - ποικιλόχρωμος, παρδαλός
psychologia - ψυχολογία
psycholog - ψυχολόγος
psychosocjologia - ψυχοκοινωνιολογία
psychoza - ψύχωση
pszczelarstwo - μελισσοκομία
pszczoła - μέλισσα
pszenica - σιτάρι
ptactwo - πτηνό|πτηνά
ptak - πουλί
ptaszek - πουλάκι
publiczność - κοινό
publikacja - έκδοση , δημοσίευση ; δημοσίευση
puchacz - κουκουβάγια
pudełko - κουτί , κουτάκι
pudło - κούτα , κουτί ; κλούβα
pułkownik - συνταγματάρχης
puma - πούμα
punicki - καρχηδονιακός, καρχηδονικός
punktualność - ακρίβεια
punkt wyjścia - σημείο εκκινήσεως , αφετηρία
punkt - σημείο ; στιγμή ; σημείο , πόντος , βαθμός ; τελεία ; ακριβώς
pupa - ποπός
purpurowy - πορφυρένιος
pustelnik - ερημίτης ; ερημίτης , μαγκούφης
pustułka - βραχοκιρκίνεζο
pustynia - έρημος
pusty - αδειανός, κενός
puszczyk - χουχουριστής
puszka Pandory - κουτί της Πανδώρας
pył - σκόνη , κονιοστός
pyrrusowe zwycięstwo - πύρρειος νίκη
pytać - ρωτώ; εξετάζω
pytanie retoryczne - ρητορική ερώτηση
pytanie - ερώτηση
rabin - ραβίνος
rachatłukum - λουκούμι
racica - χηλή
raczej - μάλλον
rączka - χερούλι
raczkować - μπουσουλώ, μπουσουλίζω
radar - ραντάρ
rada - συμβουλή ; επιτροπή ; συμβούλιο
radioliza - ραδιόλυση
radio - ραδιόφωνο , ράδιο ; ραδιόφωνο , ράδιο
radon - ραδόνιο
radość - χαρά
radosny - χαρούμενος
radzić - συμβουλεύω; συμβουλεύομαι
rafinacja - διύλιση
raj na ziemi - επίγειος παράδεισος
raj podatkowy - φορολογικός παράδεισος
rajstopy - καλτσόν , καλσόν
raj - παράδεισος
rak - καρκίνος
Rak - Καρκίνος
ramię w ramię - δίπλα-δίπλα
ramię - ώμος ; βραχίονας , μπράτσο
rana - πληγή
randka - ραντεβού
ranić - πληγώνω; πληγώνομαι
raniuszek - μακρονούρης , αιγίθαλος
rano - πρωί; πρωί
raper - ράπερ
rasa - φυλή , ράτσα
rasistowski - ρατσιστικός
raszpla - άγγελος ; ξυλοφάγος , ράσπα
rata - δόση
razem - μαζί
raz na wozie, raz pod wozem - μια στο καρφί και μια στο πέταλο
raz - φορά ; φορά, μερίδα ; περίπτωση ; ένα
rdza - σκουριά ; ερυσίβη , σκωρίαση
reagować - αντιδρώ
reakcja katalityczna - καταλυτική αντίδραση
reaktor katalityczny - καταλύτης
reaktor - αντιδραστήρας
ręcznik - πετσέτα
refrakcja - διάθλαση , διάθλαση του φωτός
regionalizacja - περιφερειοποίηση
regularny - τακτικός; κανονικός
reimport - επανεισαγωγή
reinkarnacja - μετενσάρκωση , μετεμψύχωση
rękawica - γάντι
rękaw - μανίκι
ręka - χέρι
rekin - καρχαρίας , σκυλόψαρο , σκύλος
reklama - διαφήμιση
rękopis - χειρόγραφο
rekuperator - εναλλάκτης θερμότητα|θερμότητας
religia - θρησκεία
religijny - θρησκευτικός, θρήσκος
Remigiusz - Ρεμίγηος
remis - ισοπαλία
renesansowy - αναγεννησιακός
renifer - τάρανδος
renoma - υπόληψη , φήμη
Ren - Ρήνος
reorientacja - αναπροσανατολισμός
repertuar - ρεπερτόριο
reprezentacja - αντιπροσωπεία
Republika Czeska - Δημοκρατία της Τσεχίας
Republika Federalna Niemiec - Ομοσπονδιακή Δημοκρατία της Γερμανίας
Republika Konga - Δημοκρατία του Κονγκό
Republika Południowej Afryki - Νότια Αφρική , Δημοκρατία της Νοτίου Αφρικής
Republika Słowacka - Σλοβακική Δημοκρατία
Republika Środkowoafrykańska - Κεντροαφρικανική Δημοκρατία
Republika Zielonego Przylądka - Πράσινο Ακρωτήριο , Δημοκρατία του Πράσινου Ακρωτηρίου
republika - δημοκρατία
respekt - σεβασμός
restauracja - εστιατόριο ; αποκατάσταση
reszka - γράμματα
rewolucja - επανάσταση
rezerwuar - δεξαμενή , υδροταμιευτήρας
re - ρε
robak - σκουλήκι
robić loda - κάνω πίπα
robić na drutach - πλέκω
robota - δουλειά , εργασία
robotnica - εργάτρια
robotnik - εργάτης
robotyka - ρομποτική
robot - ρομπότ
rocha - άγγελος , καρκάνι , κιθάρα , ρίνα , ρινόβατος , σαλάχι
rocznica - επέτειος
roczny - μονοετής; ετήσιος
rodzajnik nieokreślony - αόριστο άρθρο
rodzajnik określony - οριστικό άρθρο
rodzajnik - άρθρο
rodzaj - είδος ; γένος , είδος ; είδος , ύφος
rodzice - γονείς
rodzić - γεννώ; γεννιέμαι
rodzina - οικογένεια
rodzynek - σταφίδα
Róg Afryki - Κέρας της Αφρικής
rogal - κουλουράκι
róg obfitości - κέρας της Αμάλθειας
rój - σμήνος
rok przestępny - δίσεκτο έτος , δίσεκτη χρονιά
rok świetlny - έτος φωτός
rok - χρόνος , έτος
rolnik - αγρότης
romantyczny - ρομαντικός
ropień - απόστημα
rosa - δροσιά
Rosjanin - Ρώσος
Rosjanka - Ρωσίδα
Rosja - Ρωσία
roślina oleista - ελαιούχο φυτό
roślina - φυτό
roślinożerny - φυτοφάγος, χορτοφάγος
rosyjska ruletka - ρώσικη ρουλέτα
rosyjski - ρωσικός; ρωσικά
roszada - ροκέ
rowerowy - ποδηλατικός
rowerzystka - ποδηλάτισσα
rower - ποδήλατο
rówieśnik - συνομήλικος, συνηλικιώτης
równanie - εξίσωση
również - επίσης, και
równik - ισημερινός
równina - πεδιάδα
równolegle - παράλληλα
równoległy - παράλληλος
równość - ισότητα ; ισότητα ; ισότητα ; λειότητα
róża - ροδή , τριανταφυλλιά ; ρόδο ; ερυσίπελας
rożeniec - σουβλοπάπια
rozgrzeszenie - άφεση
rozgwiazda - αστερίας
rozkaz - διαταγή , εντολή
rozmowa - κουβέντα
rozmówki - διάλογος|διάλογοι
różnica - διαφορά
różnobarwny - πολύχρωμος, ποικιλόχρωμος
różowy - ροζ
rozrywka - διασκέδαση
rozsądny - λογικός, μυαλωμένος, μετρημένος
roztargniony - αφηρημένος, απρόσεκτος
rozumieć - καταλαβαίνω
rozważać - υπολογίζω
rozwiązanie - λύση ; λευτεριά ; διάλυση
rozwód - διαζύγιο
różyczka - ερυθρά
ro - ρο , ρω
rtęć - υδράργυρος
rubid - ρουβίδιο
rubin - ρουμπίνι
ruchomy - κινητός
ruch - κίνηση ; κίνημα
rudzik - κοκκινολαίμης
rufa - πρύμνη , πρύμη
Rumunia - Ρουμανία
Rumunka - Ρουμάνα
Rumun - Ρουμάνος
rum - ρούμι
rupia - ρουπία
rupieć - σαράβαλο , σακαράκα
ruszać - κινώ
rusztowanie - σκαλωσιά
ruten - ρουθήνιο
rutyna - ρουτίνα
rwać - βγάζω, αποσπώ; σκίζω, σχιζω; τρώω; βγάζω
rwa kulszowa - ισχιαλγία
Rwanda - Ρουάντα
rwandyjski - ρουαντέζικος
ryba - ψάρι , ιχθύς
rybitwa - γλάρονο
rybołów - θαλασσαετός
Ryby - Ιχθείς
rycerz - ιππότης
rydz - λακτάριος ο νόστημος
Ryga - Ρίγα
rynek pieniężny - αγορά χρήματος , χρηματαγορά
rysować - σχεδιάζω; ζωγραφίζω; χαράζω
ryś - λύγκας
ryż - ρύζι
rzadki - σπάνιος; νερουλός; αραιός
rzadko - σπάνια; αραιά
rząd - κυβέρνηση ; διακυβέρνηση ; σειρά , αράδα
rzeczownik - ουσιαστικό
rzeczywistość - πραγματικότητα
rzeka - ποταμός
rzepak - ελαιοκράμβη
rzęsa - βλεφαρίδα
rzeżączka - βλεννόρροια
rzeźnia - σφαγείο
rzeżucha - κάρδαμο ; κάρδαμο
rzodkiewka - ραπάνι
rzut dyskiem - δισκοβολία
rzut karny - πέναλτι
rzut młotem - σφυροβολία
rzutnik - προβολέας
rzut oszczepem - ακοντισμός
rzut rożny - κόρνερ , χτύπημα κόρνερ
rzymianin - Ρωμαίος
Rzymianin - Ρωμαίος
rzymski - ρωμαϊκός
Rzym - Ρώμη
sabotaż - σαμποτάζ , δολιοφθορά
Sąd Ostateczny - Δευτέρα Παρουσία , μέλλουσα κρίση
sądowy - δικαστικός
Sahara - Σαχάρα
sakrament - μυστήριο
saksofonista - σαξοφωνίστας
saksofonistka - σαξοφωνίστρια
saksofon - σαξόφωνο
salamandra - σαλαμάντρα
salami - σαλάμι
sałata - μαρούλι
sałatka - σαλάτα
Saloniki - Θεσσαλονίκη
salon - καθιστικό , λίβινγκ ρουμ
Salwador - Ελ Σαλβαδόρ
Samaria - Σαμάρεια ; Σαμάρεια ; Σαμαριά
samar - σαμάριο
samica - θηλυκός|θηλυκό
samiec - αρσενικός|αρσενικό
Samoa Amerykańskie - Αμερικανική Σαμόα
Samoa - Σαμόα
samobójstwo - αυτοκτονία
samochód - αυτοκίνητο , αμάξι
samogłoska - φωνήεν
samolot - αεροπλάνο
samotność - μοναξιά
samotny - έρημος
sampler - δειγματολήπτης , σάμπλερ
sam - μόνος, μοναδικός; ο ίδιος ; ακριβώς αυτός ; σελφ σέρβις σουπερμάρκετ
sandacz - ποταμολάβρακο
sanie - έλκηθρο
sanki - έλκηθρο
San Marino - Άγιος Μαρίνος
santuri - σαντούρι
Sarajewo - Σαράγεβο
Sardynia - Σαρδηνία
sardynka - σαρδέλα
sari - σάρι
sarkazm - σαρκασμός
sarkofag - σαρκοφάγος
sarna - ζαρκάδι
sąsiad - γείτονας
satelita - δορυφόρος
Saturn - Κρόνος ; Κρόνος
satysfakcjonować - ικανοποιώ
Saudyjczyk - Σαουδάραβας
Saul - Σαούλ
sauna - σάουνα
sążyca - σμιγάδι ''''
scena - σκηνή ; σκηνικό
scenografia - σκηνογραφία
schronienie - καταφύγιο
schronisko - καταφύγιο; άσυλο
ściągawka - σκονάκι
ściąga - σκονάκι
ściana - τοίχος ; πλευρά , έδρα
ściany mają uszy - και οι τοίχοι έχουν αφτιά
ścięgno - τένοντας
ścierka - πετσέτα κουζίνας
ścierny - λειαντικός
ścieżka dźwiękowa - τμήμα ήχου
ścieżka - μονοπάτι ; διαδρομή
Sebastian - Σεβαστιανός
sebum - σμήγμα
sedno - ουσία , ταμπακιέρα
sędzia - δικαστής ; διαιτητής
Sejm - Δίαιτα
sejsmologia - σεισμολογία
seks oralny - στοματικό σεξ
seksualny - σεξουαλικός, γεννητικός
seks - σεξ
sekunda - δευτερόλεπτο
seler - σέλινο
semestr - εξάμηνο
senator - γερουσιαστής
Senegalczyk - Σενεγαλέζος
Senegalka - Σενεγαλέζα
Senegal - Σενεγάλη ; Σενεγάλης
sen - ύπνος ; όνειρο
sepsa - σήψη
Serbia i Czarnogóra - Σερβία και Μαυροβούνιο
Serbka - Σέρβα
serbski - σερβικός, σέρβικος; σερβικά , σέρβικα
Serb - Σέρβος
serce - καρδιά
serwer - εξυπηρετητής , διακομιστής
ser - τυρί , τυρός , φέτα , μυζήθρα , κασέρι , ανθότυρο
Seszelczyk - Σεσελουά
Seszele - Σεϋχέλλες
setka - εκατό , εκατοντάδα , κατοσταριά , κατοστάρα ; κατοστάρι , κατοστάρικο , κατοστάρα ; κατοστάρι ; κατοσταράκι ; κατοστάρα
Seul - Σεούλ
Sewilla - Σεβίλη
sezam - σουσαμιά ; σουσάμι
Sfederowane Stany Mikronezji - Ομόσπονδες Πολιτείες της Μικρονησίας
sfera - σφαίρα
siać - σπέρνω
siano - σανός , σανό
siara - κολάστρα
siarka - θειάφι
siatka - δίχτυ
siatkówka - βόλεϊμπολ
siedmiokrotnie - επτάκις
siedziba - έδρα
siedzieć po turecku - κάθομαι αλά τούρκα, κάθομαι οκλαδόν
siekiera - τσεκούρι
sierpień - Αύγουστος
sierpniowy - αυγουστιάτικος
sierp - δρεπάνι
sierść - μαλλί
sigma - σίγμα
sikora bogatka - καλόγερος
sikora sosnówka - ελατοπαπαδίτσα
siła wyższa - ανωτέρα βία
silnik - κινητήρας
silny - δυνατός; χοντρός
silos - σιλό
Singapurczyk - Σιγκαπουριανός
singapurski - σιγκαπουριανός
Singapur - Σιγκαπούρη
sinolog - σινολόγος
sinus - ημίτονο
siodło - σέλα
siostra - αδελφή/αδερφή
siostrzeniec - ανιψιός , ανεψιός
sitko - στραγγιστήρι , κόσκινο
skała - πέτρωμα ; βράχος , πέτρα
skala - σκάλα , κλίμακα
Skałosz - Πέτρος
skalpel - νυστέρι
skandaliczny - σκανδαλώδης
skandynawski - σκανδιναβικός
skand - σκάνδιο
skaner - σαρωτής , σκάνερ
skaningowy mikroskop tunelowy - μικροσκόπιο σάρωσης σήραγγας
skąpstwo - τσιγκουνιά
skarpeta - κάλτσα
skazywać - καταδικάζω
sklepikarz - μπακάλης , παντοπώλης
sklep rybny - ιχθυοπωλείο
sklep - μαγαζί
skoczek - ίππος
skok o tyczce - άλμα επί κοντώ
skok wzwyż - άλμα εις ύψος
skolion - σχόλιο
skolioza - σκολίωση
Skopje - Σκόπια
skóra - δέρμα , πετσί ; φλούδα
skorpion - σκορπιός
Skorpion - Σκορπιός ''Skorpiós''
skowronek - σιταρήθρα
skręcać - στρίβω; βιδώνω
skręt - στριφτό
skroń - κρόταφος
skrót - συντομογραφία
skryba - γραφέας
skrzydłówka - κορνέτο , κορνέτα με βαλβίδα|βαλβίδες
skrzypce - βιολί
skrzypek - βιολιστής
skrzyp polny - εκουίζετο
skunks - μεφίτιδα
słaba płeć - αδύνατο φύλο
słaby - αδύνατος; μικρός
slajd - σλάιντ
Śląsk - Σιλεσία
śledziona - σπλήνα
śledź - ρέγκα ; πάσσαλος , παλούκι
ślepa uliczka - αδιέξοδο στενό ; αδιέξοδο
ślepota - τύφλωση
ślepy pasażer - λαθρεπιβάτης
ślepy - τυφλός; αδιέξοδος
śliczny - πανέμορφος
ślimak - σάλιαγκας , σαλιγκάρι
ślina - σάλιο
śliwka - δαμάσκηνο
słodki - γλυκός
słodycze - γλυκίσματα , ζαχαρωτά
słoiczek - βαζάκι
słoik - βάζο
słoma - άχυρο
słomka - καλαμάκι ; καλαμάκι
słońce - ήλιος
Słońce - Ήλιος
słoneczny - ηλιακός; ηλιόλουστος
słoniątko - ελεφαντάκι
słonica - ελεφαντίνα
słonina - λαρδί
słonka - μπεκάτσα , ξυλόκοτα
słoń - ελέφαντας
Słowacja - Σλοβακία
słowa - στίχος|στίχοι
Słowenia - Σλοβενία
słoweński - σλοβενικός, σλοβενικά
słownik - λεξικό ; λεξιλόγιο
słowny - λεξικός
słowo - λόγος , λέξη
ślub - γάμος
słuchać - ακούω, γρικώ
słuchawka - ακουστικό , ακουστικά ; στηθοσκόπιο
słuch - ακοή
słup - στήλη , στύλος , κίονας
słyszeć - ακούω
smacznego - καλή όρεξη
smaczny - νόστιμος, εύγευστος
smakować - γεύομαι, δοκιμάζω; έχω γεύση; αρέσω
smak - γεύση ; γεύση , νοστιμάδα , νοστιμιά ; νοστιμάδα , νοστιμιά
smalec - λαρδί
smerf - στρουμφ , στρουμφάκι
śmieć - σκουπίδι ; σκουπίδι ; τολμώ
śmierć - θάνατος
śmiertelny - θανάσιμος, θανατηφόρος; θνητός
smok - δράκοντας , δράκος
smółka - μηκώνιο
smutek - θλίψη , λύπη
smutny - θλιβερός, λυπητερός, θλιμμένος
śniadanie - πρωινό
śnieguła - χιονοτσίχλονο
śnieg - χιόνι
Śnieżka - Χιονάτη
sobota - Σάββατο
socjalista - σοσιαλιστής
socjalistka - σοσιαλίστρια
socjologia - κοινωνιολογία
socjolog - κοινωνιολόγος
soczewica - φακή
soczysty - ζουμερός
sód - νάτριο
sofa - καναπές
Sofia - Σόφια
sójka - κίσσα
sokolnik - γερακάρης , ιερακοτρόφος
sokół - γεράκι
Sokrates - Σωκράτης
sok żołądkowy - γαστρικό υγρό
sok - χυμός
solfeż - σολφέζ
solić - αλατίζω
solidarność - αλληλεγγύη
solniczka - αλατιέρα
sól - αλάτι ; άλας
Somalia - Σομαλία
Somalijczyk - Σομαλός
somalijski - σομαλικός; σομαλικά
sosna - πεύκο
sowa - κουκουβάγια
spacer - περίπατος , βόλτα
spać - κοιμάμαι
spadanie - πτώση
spadochroniarz - αλεξιπτωτιστής
spadochron - αλεξίπτωτο
Sparta - Σπάρτη
spektrometria - φασματομετρία
spermatozoid - σπερματοζωάριο
śpiąca królewna - ωραία κοιμωμένη
śpiący - νυσταγμένος, νυσταλέος
śpiewać - τραγουδώ
śpiewak - τραγουδιστής
spinacz - κλιπ , συνδετήρας
śpiwór - υπνόσακος
spiżarnia - κελάρι
spódnica - φούστα
spodnie - παντελόνι
spójnik - σύνδεσμος
spojrzenie - βλέμμα
spółdzielnia - συνεταιρισμός
społeczeństwo - κοινωνία
spółka akcyjna - ανώνυμη εταιρεία
spółka - εταιρεία
sponsorować - σπονσοράρω, σπονσονάρω, χορηγώ
sponsor - χορηγός
spontaniczność - αυθορμητισμός
sport - άθλημα , αθλητισμός , σπορ
spór - διένεξη , διαφωνία
spotkanie - συνάντηση
spot - σποτ
spowiednik - εξομολογητής
spowiedź - εξομολόγηση
spóźniać się - αργώ
spożywczy - φαγώσιμος, θρεπτικός; μπακάλικο
sprawa - ζήτημα , υπόθεση
sprawiedliwość - δικαιοσύνη
sprzątaczka - καθαρίστρια
sprzeciwiać się - εναντιώνομαι, αντιτίθεμαι
sprzedawać - πουλώ
sprzedawca - πωλητής
sprzedawczyni - πωλήτρια
sprzedaż - πώληση
sprzęgło - συμπλέκτης ; συμπλέκτης , πεντάλ του συμπλέκτη
spychacz - μπουλντόζα
sp. z o.o. - Ε.Π.Ε.
sraczka - τσίρλα
srać - χέζω
srebrny medal - αργυρό μετάλλιο
srebrny - αργυρός
srebro - άργυρος ; ασήμι ; ασημικό , ασήμι ; αργυρό μετάλλιο
średnik - άνω τελεία
średniowiecze - μεσαίωνας
średniowieczny - μεσαιωνικός
średni - μέτριος; μεσαίος; μέσος
Sri Lanka - Σρι Λάνκα
Środa Popielcowa - καθαρά Τετάρτη
środa - Τετάρτη
środki masowego przekazu - μέσα μαζικής ενημέρωσης
środkowoafrykański - κεντροαφρικανικός
środkowy - μέσος, μεσαίος
śródręcze - μετακάρπιο
śródziemnomorski - μεσογειακός
srogi - αυστηρός, σκληρός
sroka - καρακάξα
srokosz - διπλοκεφαλάς
srom - αιδοίο
śrubokręt - κατσαβίδι , βιδολόγος
ssak - θηλαστικό
stacja benzynowa - βενζινάδικο
stacja - σταθμός
stadium - στάδιο
stajnia Augiasza - κόπρος του Αυγείου
stalagmit - σταλαγμίτης
stała - σταθερά ; σταθερή
stal - ατσάλι
Stambuł - Κωνσταντινούπολη
stan cywilny - προσωπική κατάσταση
stan wojenny - στρατιωτικός νόμος
Stany Zjednoczone Ameryki - Ηνωμένες Πολιτείες Αμερικής
Stany Zjednoczone - Ηνωμένες Πολιτείες Αμερικής , Ηνωμένες Πολιτείες
starannie - προσεκτικός|προσεκτικά, επιμελώς
starość - γεράματα /, γήρας
starożytność - αρχαιότητα
starożytny - αρχαίος
Stary Testament - Παλαιά Διαθήκη
statek - σκάφος ; καράβι , πλοίο
statki - ναυμαχία
stawiać wszystko na jedną kartę - βάζω όλα τα αβγά μου σε ένα καλάθι
stawonóg - αρθρόποδο
Stawros - Σταύρος ; Σταυρός
Stawrula - Σταυρούλα
staw - άρθρωση
Stefan - Στέφανος
step - στέπα
stewardesa - αεροσυνοδός , συνοδός ο|του πλοίο|πλοίου
stocznia - ναυπηγείο
stolarz - ξυλουργός , επιπλοποιός
stołeczny - πρωτευουσιάνικος
stolica - πρωτεύουσα
stołówka - εστία , τραπεζαρία
stół - τραπέζι , τράπεζα
stonoga - σαρανταποδαρούσα , σκολόπενδρα
stopień - σκαλί , βαθμίδα ; μοίρα ; βαθμός ; βαθμίδα, βήμα
stop - κράμα
stosunek przerywany - διακεκομμένη συνουσία
stowarzyszenie - σύλλογος , συνεταιρισμός , σωματείο
stożek - κώνος
strach - φόβος , τρόμος ; σκιάχτρο
strajk włoski - λευκή απεργία
strajk - απεργία
straszny - τρομερός
strategia - στρατηγική
strateg - στρατηγός
strażak - πυροσβέστης
Strefa Gazy - Λωρίδα της Γάζας
streszczenie - περίληψη
strofa - στροφή
strona bierna - παθητική φωνή
strona czynna - ενεργητική φωνή
strona - σελίδα ; πλευρά ; μέρος
stront - στρόντιο
stróż - φύλακας
strug - πλάνη , ροκάνι
struktura - δομή , διάρθρωση
struna - χορδή
strunowy - έγχορδος
struś - στρουθοκάμηλος
strychnina - στρυχνίνη
strych - σοφίτα
stryczek - αγχόνη ; κρεμάλα
strzała - βέλος
Strzelec - Τοξότης
strzemiączko - αναβολέας
studencki - φοιτητικός; φοιτητικός
student - φοιτητής
studiować - σπουδάζω, μελετώ, φοιτώ; διαβάζω; μελετώ
studnia kwantowa - κβαντικό πηγάδι
studnia - πηγάδι
stulejka - φίμωση
stwardnienie rozsiane - πολλαπλή σκλήρυνση
styczeń - Ιανουάριος
ST - Π.Δ.
substancja czynna - ενεργό συστατικό
substancja - ουσία
suchy - ξερός
Sudanka - Σουδανή, Σουδανέζα
sudański - σουδανικός, σουδανέζικος
Sudan - Σουδάν
sufiks - επίθημα
sufit - ταβάνι
suka - σκύλα
sukces - επιτυχία
sukienka - φόρεμα ; ράσο
suknia - φόρεμα
Sułtanat Brunei - Σουλτανάτο του Μπρουνέι
sułtanat - σουλτανάτο
suma - άθροισμα ; ποσό ; μεγάλος|μεγάλη λειτουργία
sumienie - συνείδηση
supermarket - σούπερ μάρκετ
Surinam - Σουρινάμ
suszarka do włosów - σεσουάρ
susza - ανομβρία , ξηρασία
sutanna - ράσο
sutener - νταβατζής
suterena - υπόγειο , κάτω
sweter - πουλόβερ
świadek Jehowy - μάρτυρας του Ιεχωβά
świadomość - συνείδηση
świat arabski - αραβικός κόσμος
światłowód - οπτική ίνα
światłowstręt - φωτοφοβία
światło - φως ; φανάρι / φανάρια
świątynia - ναός
świat - κόσμος , ντουνιάς
świeca - κερί ; κηρίο , καντέλα ; μπουζί , σπινθηριστής
świecić - λάμπω, φέγγω; φωτίζω
świecznik - κηροπήγιο ; κολοφώνας
świerk - έλατο
świerszczyk - μικρός γρύλος
świerszcz - τριζόνι , γρύλος
świerzb - ψώρα
święta wojna - ιερός πόλεμος
święto ruchome - κινητή εορτή
święto - γιορτή
święty Mikołaj - Άγιος Βασίλης , Άι-Βασίλης , Αγιοβασίλης , Άη Βασίλης ; Άγιος Νικόλαος
święty - άγιος; άγιος, θείος, ιερός; άγιος; άγιος
świeży - φρέσκος, νωπός
świnia - γουρούνι
świński - χοιρινός
świstak - μαρμότα
świt - αυγή , ξημέρωμα , χάραμα
św. - Αγ.
Syberia - Σιβηρία
Sybiraczka - Σιβηριανή
Sybirak - Σιβηριανός
Sycylia - Σικελία
Sycylijczyk - Σικελός , Σικελιώτης
sylaba - συλλαβή
sylur - Σιλούριο
Sylwester - Συλβέστρος
symbol - σύμβολο
sympatyczny - συμπαθητικός
symptom - σύμπτωμα
synagoga - συναγωγή
syndrom sztokholmski - σύνδρομο της Στοκχόλμης
synekura - αργομισθία
synergia - συνεργία , συνέργεια
synonim - συνώνυμο
syntetyczny - πλαστικός
syn - γιος
sypialnia - κρεβατοκάμαρα , υπνοδωμάτιο
Syriusz - Σείριος
systematyczny - συστηματικός
system - σύστημα
sytuacja - κατάσταση
syzyfowa praca - σισύφεια προσπάθεια
szablodziób - αβοκέτα
szachista - σκακιστής
szachistka - σκακίστρια
szachownica - σκακιέρα
szachy - σκάκι
szafa - ντουλάπα , ερμάρι
szafir - ζαφείρι
szafot - ικρίωμα
szafran - κρόκος , ζαφορά , σαφράν ; σαφράν
szakal - τσακάλι ; τσακάλι
szałwia - φασκομηλιά
szambowóz - βοθρατζίδικο
szambo - βόθρος
szampan - σαμπάνια
szantażować - εκβιάζω
szantaż - εκβιασμός
szarooki - γκριζομάτης
szarytka - καστανοπαπαδίτσα
szary - γκρίζος
szatniarz - ιματιοφύλακας
szczaw - λάπαθο , ξινόχορτο
szczegół - λεπτομέρεια
szczekać - γαβγίζω
szczęka - σαγόνι , γνάθος
szczelina - χαραμάδα , σχισμή , ρωγμή
szczenię - κουτάβι , σκυλάκι
szczęściarz - κωλόφαρδος
szczęście - ευτυχία ; τύχη
szczęśliwego Nowy Nowego Roku - Αίσιον και ευτυχές το νέον έτος!
szczoteczka do zębów - οδοντόβουρτσα
szczoteczka - βούρτσα
szczotka - βούρτσα ; ψήκτρα
szczupak - λούτσος
szczupły - λεπτός
szczur - αρουραίος
szczypawka - ψαλίδα
szczypiornista - χαντμπολίστας
szelka - τιράντα
szeptać - ψιθυρίζω
szereg - σειρά
szermierka - ξιφασκία; ξιφασκία
szeroki - πλατύς; φαρδύς
sześcian - εξάεδρο
sześciokąt foremny - κανονικό εξάγωνο
sześciokątny - εξαγωνικός; εξάγωνος
sześciokąt - εξάγωνο ; εξάγωνο
sześciokrotnie - εξάκις
szewc - τσαγκάρης , παπουτσής , υποδηματοποιός
szezlong - ανάκλιντρο , σεζλόνγκ
szkic - σκίτσο , σχέδιο
szkielet - σκελετός
szklanka - ποτήρι
szkło - γυαλί
Szkocja - Σκοτία
szkocki - σκοτσέζικος
szkoda - ζημιά ; κρίμα
szkoła podstawowa - δημοτικό
szkoła - σχολείο
szkolny - σχολικός
szlachar - λοφοπρίστης
szlachetny - ευγενής
szlafrok - μπουρνούζι
szminka - κραγιόν
sznurowadło - κορδόνι
sznur - κορδόνι , σκοινί , σχοινί
szosa - δρόμος
szósty zmysł - έκτη αίσθηση
szowinizm gatunkowy - σπισισμός
szowinizm - σωβινισμός
szpak - ψαρόνι
szpieg - κατάσκοπος
szpilka - καρφίτσα
szpinak - σπανάκι
szpital - νοσοκομείο
szrapnel - θραύσμα
szron - πάχνη ; άσπρος|άσπρα/γκρίζος|γκρίζα μαλλί|μαλλιά
sztandar - σημαία
sztolnia - στοά , γαλαρία
sztufada - στιφάδο
sztuka - καλλιτεχνία
sztuki piękne - καλές τέχνες
sztylet - εγχειρίδιο , στιλέτο
szubienica - κρεμάλα , αγχόνη
szuflada - συρτάρι
szukać igły w stogu siana - γυρεύω ψύλλους στ' άχερα
szukać - ψάχνω
szukajcie, a znajdziecie - γυρεύετε και θα βρείτε
szum - θόρυβος
Szwabia - Σουηβία, Σουαβία
szwagier - κουνιάδος ; γαμπρός
Szwajcaria - Ελβετία
Szwecja - Σουηδία
szwedzki - σουηδικός; σουηδικά
szyba - τζάμι
szyberdach - ηλιοροφή
szybki - γρήγορος
szybko - γρήγορα
szybowiec - ανεμόπτερο , ανεμοπλάνο
szyć - ράβω
szydełko - κροσέ , βελονάκι , βελόνα κέντημα|κεντήματος
szydło - σουβλί
szyja - λαιμός
szympans - χιμπαντζής
szynszyla - τσιντσιλά
szyszka - κουκουνάρι , κώνος
szyszynka - επίφυση
tablica interaktywna - διαδραστικός πίνακας
taboret - σκαμνί
tabu - ταμπού
taca - δίσκος , πιατέλα ; δίσκος
taczka - καροτσάκι
Tadżykistan - Τατζικιστάν ''Tatzikistán''
tahini - ταχίνι
tajemnica - μυστικό
tajfun - τυφώνας
tajga - τάιγκα
Tajlandia - Ταϊλάνδη
Tajwan - Ταϊβάν
tak czy owak - έτσι κι αλλιώς
taki - τόσος; τέτοιος
tak sobie - έτσι κι έτσι
taksówkarka - ταξιτζού
taksówkarz - ταξιτζής
taksówka - ταξί
taktyka - τακτική
takt - χρόνος
tak zwany - λεγόμενος
tak - τόσο; έτσι; ναι, μάλιστα
talasemia - θαλασσαιμία
talent - ταλέντο ; τάλαντο
talerz - πιάτο ; κύμβαλο , πιατίνι , πιάτο ; κύμβαλο , πιατίνι , πιάτο
talk - τάλκης , ταλκ ; ταλκ , πούδρα
Tallinn - Ταλίν
tal - θάλλιο
tamburyn - ντέφι
tamten - εκείνος
tam - εκεί
tancerka - χορεύτρια
tancerz - χορευτής
tańczyć - χορεύω
tangens - εφαπτομένη
Tangier - Ταγγέρη
tango - τανγκό
taniec brzucha - χορός της κοιλιάς
taniec - χορός
tani - φτηνός
tantal - ταντάλιο
Tantal - Τάνταλος
Tanzania - Τανζανία
tanzański - τανζανικός
taoista - ταοϊστής
tarantula - ταραντούλα
tartak - πριονιστήριο
taśma - ταινία
tatarski - ταταρικός; ταταρικά
tata - μπαμπάς
tatuować - κάνω τατουάζ
tatuś - μπαμπάκας
tau - ταυ
Tbilisi - Τιφλίδα
tchawica - τραχεία
tchórzostwo - δειλία , λιγοψυχία
tchórz - δειλός ; βρωμοκούναβο
teatr - θέατρο
technet - τεχνήτιο
technika - τεχνική
technokracja - τεχνοκρατία
techno- - τεχνο-, τεχνό-
tęcza - ουράνιο τόξο , ίριδα
teczka - χαρτοφύλακας ; φάκελος
tęczówka - ίριδα
tędy - από δω, από|απ' αυτός|αυτόν ο|το δρόμος|δρόμο
tegoroczny - εφετινός, φετινός
tekszla - αρκτική βάτος
telefoniczny - τηλεφωνικός
telefon komórkowy - κινητό
telefon - τηλέφωνο
telegraficzny - τηλεγραφικός
telegram - τηλεγράφημα
telewizja - τηλεόραση
telewizor - τηλεόραση
tellur - τελλούριο
temat - θέμα
temperatura bezwzględna - απόλυτη θερμοκρασία
temperatura - θερμοκρασία
temperówka - ξύστρα
temu - πριν
tenisista - τενίστας
tenisistka - τενίστρια
ten śmiać się śmieje, kto śmiać się śmieje ostatni - γελάει καλύτερα όποιος γελάει τελευταίος
ten - αυτός, τούτος
teodolit - θεοδόλιχος
teolatria - θεολατρεία
teologia - θεολογία
teoretyczny - θεωρητικός
teoria - θεωρία
terapia - θεραπεία
teraźniejszy - τωρινός, ενεστώς, ενεστωτικός; ενεστώτας
teraz - τώρα
terb - τέρβιο
teriologia - θηλαστικολογία
termodynamiczny - θερμοδυναμικός
termodynamika - θερμοδυναμική
termometr - θερμόμετρο
Terpsychora - Τερψιχόρη
terrorysta - τρομοκράτης
terrorystka - τρομοκράτισσα
terrorystyczny - τρομοκρατικός
teściowa - πεθερά
teść - πεθερός
tętniak - ανεύρυσμα
tętnica szczękowa - γναθιαία αρτηρία
tetraplegia - τετραπληγία
tetraplegik - τετραπληγικός
tetrarcha - τετράρχης
Tetyda - Θέτις
tezaurus - θησαυρός
Tezeusz - Θησέας
theta - θήτα
tiamina - θειαμίνη
tik - τικ
Timor Wschodni - Ανατολικό Τιμόρ, Ανατολικό Τίμορ
Timor - Τιμόρ
Tirana - Τίρανα
tkanka - ιστός
tlenek węgla - μονοξείδιο του άνθρακα
tlen - οξυγόνο
tłok - έμβολο ; συνωστισμός , στρίμωγμα
tłumaczenie - μετάφραση , εξήγηση
tłumaczka - μεταφράστρια
tłumacz - μεταφραστής
tłum - πλήθος
tłusty czwartek - Τσικνοπέμπτη
tofu - τόφου
Togo - Τόγκο
tokarka - τόρνος
Tokio - Τόκιο , Τόκυο
Tomasz - Θωμάς
tom - τόμος
tonąć - βυθίζομαι, βουλιάζω; πνίγομαι
Tonga - Τόνγκα
topaz - τοπάζι
topnienie - τήξη
topografia - τοπογραφία
topograficzny - τοπογραφικός
topologia - τοπολογία
Tora - Τορά
tornado - τυφώνας
tor - θόριο
toster - φρυγανιέρα
tost - φρυγανιά
totalitaryzm - ολοκληρωτισμός
towarzysz - σύντροφος , συνοδοιπόρος , συνοδίτης ; σύντροφος
tożsamość - ταυτότητα
tracić - χάνω; θανατώνω
tradycja - παράδοση ; Ιερά Παράδοση
tradycyjny - παραδοσιακός
trąd - λέπρα
tragedia - τραγωδία
tramwaj - τραμ
transformator - μετασχηματιστής
transkrypcja - μεταγραφή ; μεταγραφή ; μεταγραφή
transmisja - μετάδοση
transport - μεταφορά
trapez - τραπέζιο ; μπάρα σε σκοινί|σκοινιά
tratwa - σχεδία
traumatologia - τραυματολογία
trawa - χόρτο
trawienie - πέψη
trawnik - χλόη , γκαζόν
trenerka - προπονήτρια
trener - προπονητής
tren - θρήνος , μοιρολόγι ; ουρά
treść - περιεχόμενο
triada - τριάδα
trochę - λίγο
troglodyta - τρωγλοδύτης ; τρωγλοδύτης ; τρωγλοδύτης , τρυποφράχτης
Troja - Τροία
Trójca Święta - Αγία Τριάδα
trójkąt - τρίγωνο
trójlistny - τρίφυλλος
trójmasztowiec - τρικάταρτο
trójmasztowy - τρικάταρτος
trójpłat - τριπλάνο
trójskok - άλμα τριπλούν
trójwymiarowy - τρισδιάστατος
trolejbus - τρόλεϊ
tron - θρόνος
trucizna - δηλητήριο , φαρμάκι
trudność - δυσκολία
trudny - δύσκολος
trujący - δηλητηριώδης, ιώδης
trumna - φέρετρο
trupia czaszka - νεκροκεφαλή
trup - πτώμα
truskawka - φραουλιά , φράουλα ; φράουλα
tryb rozkazujący - προστακτική , προστακτική έγκλιση
tryb - έγκλιση
tryk - κριός , κριάρι
Trynidad i Tobago - Τρίνινταντ και Τομπάγκο
tryptyk - τρίπτυχο ; τρίπτυχο
trzcina - καλαμιά ; καλαμιώνας ; καλάμι
trzeba - πρέπει να +
trzeciorzęd - Τριτογενές
Trzeci Świat - Τρίτος Κόσμος
trzepaczka - χτυπητήρι
trzęsienie ziemi - σεισμός
trzewik - παπούτσι
trzmielojad - σφηκιάρης
trzustka - πάγκρεας
trzydziestolatek - τριαντάρης
trzysylabowy - τρισύλλαβος
tsunami - τσουνάμι
Tuareg - Τουαρέγκ
tulipan - τουλίπα
tułów - κορμός ; θώρακας
tuńczyk - τόνος
Tunezja - Τυνησία
Tunezja - Τυνησία
Tunezyjczyk - Τυνήσιος
Tunezyjka - Τυνήσια
tunezyjski - τυνησιακός
turban - τουρμπάνι
Turcja - Τουρκία
Turczynka - Τουρκάλα , Τούρκισσα
turecki - τούρκικος
Turek - Τούρκος
turkawka - τρυγόνι
Turkmenistan - Τουρκμενιστάν
turysta - τουρίστας
tusz - σινική μελάνη
tuż - σχεδόν
tu - εδώ
twardy - σκληρός
twaróg - ανθότυρο
twarzą w twarz - πρόσωπο με πρόσωπο
twarz - πρόσωπο
twój - εσύ|σου
twórca - δημιουργός , πλάστης
twórczość - δημιουργία ; δημιουργικότητα
twórczyni - δημιουργός , πλάστρια
tyć - παχαίνω
tydzień - εβδομάδα , βδομάδα
tygrysica - τίγρη
Tygrys - Τίγρης
tygrys - τίγρη , τίγρης
tykanie - τικ τακ , τίκι τακ
tyłek - πισινός
tylko - μόνο; αλλά
tynkarz - σοβατζής
tyrać - μοχθώ, κοπιάζω
tysiąclecie - χιλιετία
tytan - τιτάνιο ; τιτάνας
tytoń - καπνός
ty - εσύ
ubezpieczenie na życie - ασφάλεια ζωής
ubiegłoroczny - περσινός
ubierać - ντύνω; ντύνομαι
ubiór - ενδυμασία
ubogi - φτωχός
ubóstwiać - θαυμάζω υπερβολικά, αποθεώνω; θεοποιώ
ubranie - ρουχισμός , ρούχο|ρούχα
ucho środkowe - μέσο αυτί
ucho wewnętrzne - έσω ους
ucho - αφτί , αυτί ; χερούλι , λαβή ; μάτι
uciekać - φεύγω, δραπετεύω; αποφεύγω; ξεχειλίζω
uczennica - μαθήτρια
uczeń - μαθητής
uczestniczyć - μετέχω, συμμετέχω; μετέχω, ενέχω, εμπεριέχω
uczestnik - συμμετέχων
uczęszczać - συχνάζω
uczucie - αίσθημα
uczynny - πρόθυμος
udawać Greka - κάνω την πάπια, κάνω τον Κινέζο, παριστάνω τον Κινέζο
uderzyć - χτυπώ; χτυπιέμαι
udo - μηρός , μπούτι
udział - συμμετοχή , μέρος
udziec - πόδι
UE - ΕΕ
ugryźć się w język - δαγκώνω τη γλώσσα μου
ujemny - αρνητικός
ukąszenie - δάγκωμα , δάγκαμα ; δαγκωματιά , δαγκωνιά , δαγκανιά
układ krwionośny - καρδιαγγειακό σύστημα
układ okresowy pierwiastków - περιοδικός πίνακας των χημικών στοιχείων
układ okresowy - περιοδικός πίνακας
układ planetarny - πλανητικό σύστημα
Układ Słoneczny - ηλιακό σύστημα
układ wydechowy - σύστημα εξάτμισης
Ukraina - Ουκρανία
ułamek - κλάσμα
ulewa - μπόρα
ulica - οδός
uliczka - σοκάκι , στενάκι
ulotka - φυλλαράκι , φυλλάδιο
ultradźwiękowy - υπερηχητικός
ultrafioletowy - υπεριώδης
ul - κυψέλη
umarł król, niech żyje król - ο βασιλιάς απέθανε, ζήτω ο βασιλιάς!, ο βασιλεύς απέθανε, ζήτω ο βασιλεύς!
umierać ze śmiechu - πεθαίνω στα γέλια
umierać - πεθαίνω
umieszczać - βάζω
umowa - συμβόλαιο , σύμβαση , συνθήκη
umyślnie - επίτηδες, θελημένα, σκόπιμα
umysł - νους
Unia Europejska - Ευρωπαϊκή Ένωση
uniwersytet - πανεπιστήμιο
upadek - πτώση
uparty - πεισματάρης, επίμονος
Ural - Ουράλια ; Ουράλης
Urania - Ουρανία ; Ουρανία ; Ουρανία
uran - ουράνιο
Uran - Ουρανός ; Ουρανός
urbanizacja - αστικοποίηση
urodziny - γενέθλια ; γέννηση
Urugwajczyk - Ουρουγουανός
urugwajski - ουρουγουανός
Urugwaj - Ουρουγουάη
urwisko - γκρεμός
urzeczywistniać - πραγματοποιώ
USA - ΗΠΑ , Η.Π.Α.
usługa - χάρη ; υπηρεσία
uśmiechać się - χαμογελώ
uśmiech - χαμόγελο
uspokajać - καθησυχάζω
usta - στόμα
ustny - στοματικός; προφορικός
utrudniać - δυσκολεύω, εμποδίζω
utwór - έργο
uwertura - ουβερτούρα
uwodzicielka - ξελογιάστρα
uwodziciel - ξελογιαστής
uzbecki - ουζμπεκικός
Uzbeczka - Ουζμπέκα
Uzbekistan - Ουζμπεκιστάν
Uzbek - Ουζμπέκος
uzdrowienie - γιατρειά
uzurpować - σφετερίζομαι
użyteczność - χρησιμότητα ; ευχρηστία
użytkować - χρήση
użytkownik - χρήστης
używać - χρησιμοποιώ
używany - χρησιμοποιημένος; μεταχειρισμένος
vice versa - αντιστρόφως
wąchać kwiatki od spodu - πάω στα κυπαρίσσια
wachlarz - βεντάλια , ριπίδι ; περιοχή
wacik - μπάλα βαμβάκι|βαμβακιού , βαμβακάκι ; μπατονέτα
wada - ελάττωμα
wademekum - εγκόλπιο , εγχειρίδιο
Waga - Ζυγός ''Zygós''
wagon - βαγόνι
walczyć - παλεύω
Walencja - Βαλένθια
walizka - βαλίτσα
walka - αγώνας
waltornia - γαλλικό κόρνο
wampir - βρυκόλακας
wanad - βανάδιο
wandal - βάνδαλος
wapień - ασβεστόλιθος
wapń - ασβέστιο
warga - χείλος , χείλι
wariacja - παραλλαγή
wariat - τρελός
Warkocz Bereniki - Κόμη Βερενίκης
warkoczyk - κοτσιδάκι
Warszawa - Βαρσοβία
wartownia - φυλάκιο
warto - αξίζω|αξίζει να, αξίζει τον κόπο να
warzywo - χορταρικό , λαχανικό
wąsatka - μουστακαλής
wąski - στενός
wątpliwość - αμφιβολία
wątpliwy - αμφίβολος, αβέβαιος
wątroba - συκώτι , ήπαρ
Watykan - Βατικανό ''Vatikanó''
wawrzyn - δάφνη
wazektomia - αγγειεκτομή , εκτομή σπερματικών πόρων
ważenie - ζύγισμα
ważny - σημαντικός, σπουδαίος; έγκυρος, ισχυρός
ważyć - ζυγίζω
wąż - φίδι ; φίδι ; μάνικα
wcześniej - πριν
wczesny - πρώιμος
wczorajszy - χθεσινός
wczoraj - χτες, χθες
w cztery oczy - κατ' ιδίαν
wdowa - χήρα
węch - όσφρηση
wędlina - αλλαντικό
według - κατά, σύμφωνα με
wegetarianizm - χορτοφαγία
węgiel - άνθρακας ; κάρβουνο
Węgierka - Ουγγαρέζα
węgierski - ουγγαρέζικος, ουγγρικός
Węgier - Ούγγρος , Ουγγαρέζος
węgorz - χέλι
Węgry - Ουγγαρία
wełna - μαλλί ; μαλλί
Wełtawa - Μολδάβας
wena - φλέβα , ταλέντο
Wenecja Euganejska - Βένετο
Wenecja - Βενετία
Wenezuela - Βενεζουέλα
Wenus - Αφροδίτη ; Αφροδίτη
weranda - βεράντα
Weronika - Βερενίκη
Wesołych Świąt - Καλά Χριστούγεννα; Καλό Πάσχα
wesoły - χαρούμενος
wesz - ψείρα
weterynaria - κτηνιατρική
weterynarz - κτηνίατρος
wewnątrzmaciczny - ενδομήτριος
wewnątrzotrzewnowy - ενδοπεριτοναϊκός
wewnątrz - μέσα
węzeł gordyjski - γόρδιος δεσμός
węzeł - κόμβος
wiadomości - γνώση|γνώσεις / είδηση|ειδήσεις /
wiadro - κουβάς
wiatrak - ανεμόμυλος ; ανεμιστήρας
wiatr - αέρας
wiciokrzew - αγιόκλημα , αιγόκλημα
widelec - πιρούνι
widłonóg - κωπήποδο
widły - δικράνι
widoczność - ορατότητα
widzieć - βλέπω
więcej - περισσότερο
Wieczne Miasto - αιώνια πόλη
wieczność - αιωνιότητα
wieczny - παντοτινός, αιώνιος
wieczorny - βραδινός
wieczór - βράδυ , εσπέρα
więc - επομένως, άρα
wiedeńczyk - Βιεννέζος
wiedenka - Βιεννέζα
wiedeński - βιεννέζικος
Wiedeń - Βιένη , Βιέννη
wiedza - γνώση
wiedzieć - ξέρω, γνωρίζω
wiejski - χωριάτικος
większość - πλειονότητα , πλειοψηφία
wiek - ηλικία ; αιώνας ; ζαμάνι
wielbłąd - καμήλα
Wielka Brytania - Μεγάλη Βρετανία
Wielka Niedźwiedzica - Μεγάλη Άρκτος
Wielkanoc - Πάσχα
Wielki Piątek - Μεγάλη Παρασκευή
wielojęzyczny - πολύγλωσσος
wielokąt - πολύγωνο
wielokrążek - πολύσπαστο
wielomian - πολυώνυμο
wieloryb - φάλαινα
Wieluń - Βιέλουν
wieniec - στεφάνι
wieprzowina - χοιρινό
wierny - πιστός; ακριβής
wierzba płacząca - κλαίουσα , κλαίουσα ιτιά
wierzba wawrzynkowa - ιώδης ιτιά
wierzba - ιτιά
wierzchołek - κορυφή ; βουνοκορφή
wierzyć - πιστεύω
wieśniak - χωριάτης ; χωριάτης
wieś - χωριό ; ύπαιθρος , εξοχή
Wietnam - Βιετνάμ
wiewiórka - σκίουρος
wieża Babel - πύργος της Βαβέλ
wieża - πύργος ; πύργος
więzienie - δεσμωτήριο , φυλακή ; φυλάκιση , φυλακή
więzy krwi - δεσμοί αίματος
Wigilia - παραμονή Χριστουγέννων , Άγια Νύχτα
Wikipedia - Βικιπαίδεια
Wikisłownik - Βικιλεξικό
Wikiźródła - Βικιθήκη
wiki- - βίκι-
Wiktoria - Βικτόρια
wilczę - λυκόπουλο
wilczyca - λύκαινα
wilczy pazur - πισόνυχο
Wilczy Szaniec - Λημέρι του λύκου
wilga - συκοφάγος
wilkołak - λυκάνθρωπος
wilk syty i owca cała - θέλει και την πίτα ολάκερη και τον σκύλο χορτάτο
wilk w owczej skórze - λύκος ντυμένος πρόβατο, λύκος εις δέρμα προβάτου
wilk - λύκος
Wilk - Λύκος
Wilno - Βίλνιους , Βίλνα
wina - σφάλμα , αμάρτημα , φταίξιμο
winda - ανελκυστήρας , ασανσέρ
Windhuk - Βίντχουκ
winnica - αμπέλι
winogrono - σταφύλι
winorośl - αμπέλι
wino - κρασί
wiolonczela - βιολοντσέλο
wioślarstwo - κωπηλασία
wiosło - κουπί
wiosna - άνοιξη
wirusowe zakażenie przewodu pokarmowego - γαστρεντερίτιδα
wirus - ιός
Wisła - Βιστούλας ; Βίσλα
wiśnia - βύσσινο
wist - ουίστ
witać - χαιρετώ
witlinek - ταούκι του Ατλαντικού , νταούκι του Ατλαντικού
witraż - υαλογράφημα , βιτρό
wiza - βίζα
wizerunek - είδωλο , ομοίωμα
wizjer - μάτι , ματάκι
wkrótce - σε λίγος|λίγο, προσεχώς, σύντομα
władca - ηγεμόνας
Włochy - Ιταλία
Włoch - Ιταλός , Ιταλιάνος
włoski - ιταλικός; ιταλικά
Włoszka - Ιταλίδα , Ιταλιάνα
włos - μαλλιά
w mgnieniu oka - εν ριπή οφθαλμού
w międzyczasie - εν τω μεταξύ, στο μεταξύ
wnuczka - εγγόνα , εγγονή
wnuk - εγγονός
woalka - βέλο
w objęcia objęciach Morfeusza - στην αγκαλιά του Μορφέα
woda królewska - βασιλικό νερό
woda utleniona - οξυζενέ , οξυγονούχο νερό , υπεροξίδιο του υδρογόνου
woda - νερό , ύδωρ
wódka - βότκα
wodnik - νεροκοτσέλα
Wodnik - Υδροχόος ''Ydrohóos''; Υδροχόος ''Ydrohóos''
wodolot - υδρόπτερο , υδροπτέρυγο , ιπτάμενο δελφίνι
wodopój - ποτίστρα
wodór - υδρογόνο
wodospad - καταρράκτης
wodzić kogoś za nos - τραβώ κάποιον από τη μύτη, σέρνω κάποιον από τη μύτη
w ogóle - γενικά; καθόλου
wojewoda - βοεβόδας
wojna domowa - εμφύλιος πόλεμος
wojna - πόλεμος
wojownik - πολεμιστής , μαχητής , αγωνιστής
wojska - στρατός
wołacz - κλητική
woleć - προτιμώ
Wołga - Βόλγας
wolnomularz - ελεύθερος τέκτονας
wolny rynek - ελεύθερη αγορά
wolny - ελεύθερος; άγαμος; αργός
wołowina - κρέας βοδινός|βοδινό / μοσχαρίσιος|μοσχαρίσιο, μοσχάρι
wolt - βολτ
wół - βόδι
wosk - κερί
wózek inwalidzki - αναπηρική καρέκλα , αναπηρική πολυθρόνα
wóz - αμάξι
w porę - εγκαίρως, έγκαιρα
wrażenie - αίσθημα
wrażliwy - ευαίσθητος
wróbel - σπουργίτης
wrogi - εχθρικός
wróg - εχθρός
wrona - κουρούνα
w rzeczywistości - στην πραγματικότητα
wrzesień - Σεπτέμβριος
Wschód - Ανατολή
wschód - ανατολή ; ανατολή
wścibski - μαϊντανός
wścieklizna - λύσσα
wskazywać - δείχνω
wspaniale - θαυμάσια
wspaniały - υπέροχος, θαυμάσιος
współczesny - σύγχρονος, τωρινός; σύγχρονος, ταυτόχρονος
współczynnik załamania - δείκτης διάθλασης
wspólnota - κοινότητα
wspólny - κοινός, κοινόχρηστος; κοινός
współpraca - συνεργασία
współpracownik - συνεργάτης
współzawodnictwo - άμιλλα , συναγωνισμός , διαγωνισμός
wśród - μέσα, ανάμεσα, μεταξύ
wstawać - σηκώνομαι
wstępny - εισαγωγικός
wstęp - είσοδος ; εισαγωγή
wszechmocny - παντοδύναμος, πανίσχυρος
wszechświat - σύμπαν
wszędzie - παντού, πανταχού
wszystek - όλος
wszystkie drogi prowadzą do Rzymu - όλοι οι δρόμοι οδηγούν στη Ρώμη
wtedy - τότε
wtorek - Τρίτη
wtyczka - φις
wuef - γυμναστική
wujek - θείος
wulgaryzm - χυδαιολογία
wulkaniczny - ηφαιστειακός
wulkan - ηφαίστειο
wybaczać - συγχωρώ
wybawca - σωτήρας
wybierać - διαλέγω, επιλέγω; εκλέγω, επιλέγω
wyborca - ψηφοφόρος , εκλογέας
Wybrzeże kość Kości Słoniowej - Ακτή Ελεφαντοστού
wybrzeże - παραλία
wychodzić za mąż - παντρεύομαι
wychowanie - εκπαίδευση , αγωγή
wycieczka - εκδρομή
wycieraczka - υαλοκαθαριστήρας ; χαλάκι
wyczerpywać - εξαντλώ
wydarzenie - γεγονός
wydatek - έξοδο
wydma - αμμόλοφος
wydra - βίδρα ; ενυδρίδα
wyjątek potwierdza regułę - η εξαίρεση κάνει τον κανόνα, η εξαίρεση επιβεβαιώνει τον κανόνα
wyjątkowy - εξαιρετικός, εκπληκτικός
wyjazd - έξοδος
wyjście - έξοδος
wyjść z siebie - γίνομαι κομμάτια, γίνομαι χίλια κομμάτια
wykałaczka - οδοντογλυφίδα
wykonawczy - διοικητικός, εκτελεστικός
wykopaliska - ανασκαφή|ανασκαφές
wykorzenienie - ξερίζωμα , εκρίζωση
wykorzystywanie seksualne dzieci - παιδική σεξουαλική κακοποίηση
wykrzyknik - θαυμαστικό ; επιφώνημα
wyłącznie - μόνο, αποκλειστικά
wymagać - απαιτώ, ζητώ
wymiana - εναλλαγή
wymioty - εμετός ; εμετός
wymowa - προφορά ; σημασία , νόημα
wynajmować - ενοικιάζω, νοικιάζω
wynajmowanie - ενοικίαση , νοίκιασμα
wynikać - προκύπτω
wynik - αποτέλεσμα
wyobcowany - αποξενωμένοι
wyobrażać sobie - φαντάζομαι; φαντάζομαι
wyobraźnia - φαντασία ; φαντασία
wyprzedaż - ξεπούλημα
wyprzedzanie - προσπέρασμα
wyrafinowany - φίνος, λεπτός, ευγενικός; εκλεκτός, φίνος
wyrażenie - φράση
wyrób - προϊόν , είδος ; κατασκευή , παραγωγή
wyrostek soczewkowaty kowadełka - φακοειδής απόφυση
wysiłek - προσπάθεια
wysokie napięcie - υψηλή τάση
wysoki - ψηλός; ψηλός; ψηλός; ψηλός; ψηλός
wysoko - ψηλά
Wyspa Bożego Narodzenia - Νήσος των Χριστουγέννων
Wyspa Książęca - Πρίνσιπε
Wyspa Świętego Tomasza - Σάο Τομέ
Wyspa Świętego Wyspy Świętego Tomasza i Wyspa Książęca - Σάο Τομέ και Πρίνσιπε , Άγιος Θωμάς και Πρίγκηπας
wyspa - νησί , νήσος ; νησίδα
Wyspy Cooka - Νήσοι Κουκ
Wyspy Eolskie - Αιολίδες Νήσοι , Νησιά του Αιόλου
Wyspy Kanaryjskie - Κανάριες Νήσοι, Κανάριοι Νήσοι
Wyspy Kokosowe - Νησιά Κόκος
Wyspy Marshalla - Νήσοι Μάρσαλ
Wyspy Owcze - Νήσοι Φερόες , Φαιρόες
Wyspy Salomona - Νήσοι Σολομώντος
wystawa - βιτρίνα ; έκθεση
wytłumaczyć - εξηγώ; δικαιολογώ
wytrysk - ανάβλυση
wytwarzać - παράγω, κατασκευάζω; δημιουργώ
wywoływanie - εμφάνιση
wyznacznik - ορίζουσα
wyższość - ανωτερότητα
wy - εσείς
wzdręga - κοκκινοφτέρα
względem - γύρω από
względność - σχετικότητα
wzgórze - λόφος
wzrok - όραση
wzrost - ύψος , μπόι ; αύξηση , ανάπτυξη
wzruszyć ramionami - σηκώνω τους ώμους μου
yeti - χιονάνθρωπος των Ιμαλαΐων
zabawka - παιχνίδι
żaba - βάτραχος , βατράχι
ząbek czosnku - σκορδοσκελίδα , σκελίδα
zabijać czas - σκοτώνω την ώρα μου
zabijać - σκοτώνω; σφαλίζω, πεθαίνω
żabnica - πεσκαντρίτσα , βατραχόψαρο
ząb - δόντι
zachodni - δυτικός
Zachód - Δύση
zachód - δύση ; δύση ; κόπος
zachować zimną krew - κρατώ την ψυχραιμία μου
zachowanie - συμπεριφορά
zaćma - καταρράκτης
zaćmienie - έκλειψη ; σκοτοδίνη
żądać - απαιτώ, ζητώ
zadek - πισινός
żaden - κανένας
żądło - κεντρί
zadowolony - ευχαριστημένος
zagadnienie - ζήτημα , πρόβλημα
żagiel - πανί
żaglowiec - ιστιοφόρο
zagraniczny - ξένος
Zagrzeb - Ζάγκρεμπ
zaimek - αντωνυμία
zainteresowanie - ενδιαφέρον
zajmować - απασχολούμαι
zakazany owoc - απαγορευμένος καρπός
zakażenie - μόλυνση
zakaz - απαγόρευση
zakładka - σελιδοδείκτης
zakładnik - όμηρος &amp;
zakonnica - αδελφή , αδερφή
zakonnik - μοναχός , καλόγερος
zakręt - στροφή ; στροφή
żałoba - πένθος
żałobny - πένθιμος
załoga - πλήρωμα ; προσωπικό
żal - λύπη ; θλίψη
zamach stanu - πραξικόπημα
Zambia - Ζάμπια
zambijski - ζαμπιανός
zamek błyskawiczny - φερμουάρ
zamężna - παντρεμένος|παντρεμένη
zamiast - αντί
zamiataczka - σκουπιδιάρα
zamiatacz - σκουπιδιάρης
zamieniać (zamienić, zmienić) się w słuch - είμαι όλος/όλη αφτιά
zamknąć zamknij się! - βούλωσ' το!
zamknąć - κλείνω
zamorski - υπερπόντιος
Zamość - Ζάμοστς, Ζάμος
zamrażarka - καταψύκτης
zamsz - καστόρι
zapach - οσμή , μυρωδιά ; άρωμα
zapalenie płuc - πνευμονία
zapalenie skóry - δερματίτιδα
zapałka - σπίρτο ; στύλος οροφής
zapalniczka - αναπτήρας
zapominać - ξεχνώ; ξεχνώ
zapowiadać - αναγγέλλω
zapraszać - καλώ, προσκαλώ; προσκαλώ
zapuścić korzenie - ρίχνω άγκυρα
zarabiać - παίρνω
Zaratusztra - Ζαρατούστρα
żargon - αργκό
żarłok - φαγάς , λαίμαργος
zarodnik - σπόριο
żarówka - λάμπα
żartować - αστειεύομαι
żartowniś - πλακατζής
zasada - αρχή ; βάση
zasłona - κουρτίνα
zasługa - αξία , προσόν , προτέρημα
zasłużony - διακεκριμένος; επάξιος
zastępca - αναπληρωτής , αντικαταστάτης
zastrzyk - ένεση ; ένεση ; ένεση
Zatoka Biskajska - Βισκαϊκός Κόλπος
zatoka - κόλπος
zatrudniać - προσλαμβάνω, απασχολώ
zatrzymywać - σταματώ; σταματώ; κρατώ; συλλαμβάνω; σταματώ
zaufanie - εμπιστοσύνη
zauważyć - προσέχω, διακρίνω, παρατηρώ; παρατηρώ
zawieszenie broni - ανακωχή , εκεχειρία
zawód - επάγγελμα ; απογοήτευση
zawór bezpieczeństwa - ασφαλιστική βαλβίδα
zawór - βαλβίδα
zawsze - πάντα, πάντοτε
zazdrosny - ζηλιάρης
żbik - αγριόγατα
zbiór - σύνολο ; σοδειά , συγκομιδή , τρύγος ; συλλογή
zboże - δημητριακό
z braku laku dobry kit - στην αναβροχιά καλό και το χαλάζι
zbrodnia - έγκλημα
zdanie podrzędne - δευτερεύουσα πρόταση
zdanie - πρόταση , φράση ; γνώμη , άποψη
zdarzenie - γεγονός
zdawać sobie sprawę - αντιλαμβάνομαι, καταλαβαίνω
zderzak - προφυλακτήρας
zdobywca - κατακτητής , πορθητής ; θριαμβευτής , νικητής
zdolność - ικανότητα , δεξιότητα ; ικανότητα , δεξιότητα
zdolny - ικανός
zdrobnienie - υποκοριστικό
zdrowaśka - χαίρε
zdrowie - υγεία
zdrowy - υγιής; υγιεινός
źdźbło - κάρφος ; ψίχουλο
zębodół - οδοντικό φατνίο , οδοντική κοιλότητα
zębowa wróżka - νεράιδα των δοντιών
żebraczka - ζητιάνα
żebrak - ζητιάνος
zebranie - συνέλευση , συγκέντρωση
zebra - ζέβρα ; διάβαση πεζών
żebro - πλευρό
żeby - να
zegar biologiczny - βιολογικό ρολόι
zegarmistrz - ρολογάς
zegar słoneczny - ηλιακό ρολόι
zegar - ρολόι
żeglarz - ιστιοπλόος , ναύτης
żelazko - σίδερο
żelazny - σιδερένιος
żelazo - σίδερο , σίδηρος
żelbet - οπλισμένο σκυρόδεμα
zelota - ζηλωτής
żel - ζελέ
żenada - στενοχώρια , ντροπή
żeneta - μοσχογαλή
żenić się - νυμφεύομαι, '''' παντρεύομαι, στεφανώνομαι
żeński - γυναικείος; θηλυκός
zespół kanału nadgarstka - σύνδρομο καρπιαίου σωλήνος
zespół napięcia przedmiesiączkowego - προεμμηνορροϊκό σύνδρομο
zeszły - περασμένος
zeszyt - τετράδιο
Zeus - Ζευς, Δίας
zewnątrz - έξω
zęza - σεντίνα
zez - στραβισμός ; αλληθώρισμα
że - ότι, πως
zgaga - καούρα , καΐλα
zgoda - συμφονία ; εντάξει, σύμφωνοι
zgodny - σύμφωνος; σύμφωνος, ομόφωνος
z góry - προκαταβολικά; εξαρχής; αφ᾿ υψηλού
zgromadzenie zakonne - μοναστική τάξη
ziąb - κρύο
ziarnko do ziarnka, a zebrać zbierze się miarka - φασούλι το φασούλι γεμίζει το σακούλι
zięć - γαμπρός
zielnik - ερμπάριο
zielonawy - πρασινωπός
zielony - πράσινος; άγουρος
ziemia obiecana - γη της επαγγελίας
Ziemia - Γη
ziemniak - πατατιά , πατάτα
żigolo - ζιγκολό
zima - χειμώνας
Zimbabwe - Ζιμπάμπουε
zimna wojna - ψυχρός πόλεμος
zimorodek - αλκυόνα
zimowy - χειμερινός, χειμωνιάτικος
zjarany - ηλιοκαμένος
zjawa - φάντασμα
Zjednoczone Emiraty Arabskie - Ηνωμένα Αραβικά Εμιράτα
Zjednoczone Królestwo Wielka Wielkiej Brytanii i Irlandia Irlandii Północnej - Ηνωμένο Βασίλειο της Μεγάλης Βρετανίας και της Βόρειας Ιρλανδίας
Zjednoczone Królestwo - Ηνωμένο Βασίλειο
złamać komuś serce - ραγίζω την καρδιά κάποιου
złamać - σπάζω; αθετώ, παραβιάζω
źle dziać się dzieje w państwie duńskim - κάτι σάπιο υπάρχει στο βασίλειο της Δανιμαρκίας
zlew - νεροχύτης
źle - κακά, κακώς, άσχημα
złodziej - κλέφτης
złota rączka - χρυσοχέρης
złotnictwo - χρυσοχοΐα
złotniczy - χρυσοχοϊκός
złotnik - χρυσοχόος , αργυροχόος
złotopióry - χρυσόφτερος
złotousty - χρυσόστομος
złoto - χρυσός ; χρυσός ; χρυσάφι ; χρυσό μετάλλιο
złoty cielec - μαμμωνάς
złoty medal - χρυσό μετάλλιο
złoty - χρυσαφένιος, χρυσός, μαλαματένιος; χρυσαφής, χρυσαφένιος; χρυσός; ζλότι
złoże - κοίτασμα
zło - κακό
złudzenie - ψευδαίσθηση
zły - κακός
zł - ζλότι
Zmartwychwstanie - Ανάσταση
zmieniać kogoś/coś jak rękawiczki - αλλάζω κάποιον/κάτι σαν τα πουκάμισα
zmieniać - αλλάζω
zmienna - μεταβλητή ; μεταβλητή
żmija - οχιά , έχιδνα
zmniejszać - μειώνω
zmysł - αίσθηση
zmywarka - πλυντήριο, πλυντήριο πιάτων
znaczek pocztowy - γραμματόσημο
znaczenie - σημασία , νόημα
znać - γνωρίζω; ξέρω
znajdować - βρίσκω
znajomy - γνωστός ; γνωστός
znak zapytania - ερωτηματικό , λατινικός|λατινικό ερωτηματικό
znany - γνωστός, γνώριμος
zniczek - πυροβασιλίσκος
znienacka - αναπάντεχος|αναπάντεχα, απροσδόκητος|απροσδόκητα
żniwa - θερισμός
znowu - ξανά, πάλι
Zofia - Σοφία
żołądek - στομάχι , στόμαχος
żołądź - βελανίδι ; σπαθί ; βάλανος
żółć - χολή
żołd - στρατιωτικός μισθός
żołnierz - στρατιώτης , φαντάρος
żółtaczka - χρυσή , ίκτερος
żółta kartka - κίτρινη κάρτα
żółtko - κρόκος του αβγού , λέκιθος
żółty - κίτρινος
żółwi - χελωνίσιος
żółw - χελώνα
żonaty - παντρεμένος
żona - γυναίκα , σύζυγος
zoolatria - ζωολατρία
zoologia - ζωολογία
zoonoza - ζωονόσος
zootechnika - ζωοτεχνία
z poważaniem - με εκτίμηση, με τιμή, μετά τιμής
źrebić się - γεννώ
źrebię - πουλάρι
źrebna - έγκυος
z reguły - κατά κανόνας|κανόνα, σαν γενικός κανόνας
źrenica - κόρη
źródłosłów - ετυμολογία
źródło - πηγή
zrywać - κόβω
ZSRR - Ε.Σ.Σ.Δ.
zszywacz - συρραπτικό
z tarczą lub na tarczy - ή ταν ή επί τας
żubr - βόνασος , ευρωπαϊκός βίσονας
żuchwa - πιγούνι , σαγόνι , κάτω γνάθος
żulia - κατακάθι|κατακάθια
zupa - σούπα
żurawina - μύρτιλλο
żuraw - γερανός ; γερανός ; γερανός
żurek - ξινόσουπα
żużel - σκουριά
żwacz - προστόμαχος ; μασητήρας
zwalniać - ελευθερώνω; απολύω; επιβραδύνω; απολύομαι
związek frazeologiczny - φράση
Związek Radziecki - Σοβιετική Ένωση
Związek Socjalistycznych Republik Radzieckich - Ένωση Σοβιετικών Σοσιαλιστικών Δημοκρατιών
zwierzę domowe - κατοικίδιο ζώο
zwierzę - ζώο
zwierzyna - κυνήγι , θήραμα ; κυνήγι
zwinąć się w kłębek - γίνομαι κουβάρι
żwir - χαλίκι
zwoływać - συγκαλώ, καλώ
zworka - βραχυκυκλωτήρας
zwrócić - επιστρέφω, γυρίζω; κάνω εμετό; γυρίζω, στρέφω; απευθύνομαι; γυρίζω
zwrotnica - βελόνα
zwrotnik - τροπικός
zwrot - φράση
zwycięstwo - νίκη
zwyciężać - νικώ
zwycięzca - νικητής
zwykle - συνήθως
zwykły - κοινός, απλός, συνήθης
życica - ζιζάνιο , λόλιο
życie - ζωή , βίος ; ζην ; ζωή
życiowy - ζωτικός, βιοτικός; πρακτικός
żyć jak pączek w maśle - καλοπερνώ σαν πασάς
żyć jak pies z kotem - σαν το σκύλο με τη γάτα
żyć na wysokiej stopie - κάνω μεγάλη ζωή
życzenie - ευχή
życzyć - εύχομαι
żyć - ζω
Żydówka - εβραία
żyd - εβραίος
Żyd - Ιουδαίος , Εβραίος
zygzakowaty - ζικζακωτός
żylak - κιρσός
żyła wrotna - πηλαία φλέβα
żyła - φλέβα
żyletka - ξυραφάκι , λεπίδα
żyrafa - καμηλοπάρδαλη
żyrandol - πολυέλαιος , πολύφωτο
zysk - κέρδος
żytni - η|της σίκαλη|σίκαλης; σίκαλη|σικάλεως
żyto - σίκαλη
żywe srebro - ζουζούνι
żywica - ρητίνη
żywić - τροφοδοτώ, τρέφω; τρέφω, συντηρώ; τρέφομαι, συντηρούμαι
żywopłot - φράχτης από θάμνους
żywy - ζωντανός, ζωηρός
żyzny - γόνιμος
z zamkniętymi oczami - με κλειστά μάτια, τυφλοίς όμμασι
z - από; με, μαζί
