abakus - abaco
abażur - abat-jour
abdykować - abdicar
abiogeneza - abiogenese, abiogenesis
abiotyczny - abiotic
Abisyńczyk - abyssino
Abisynia - Abyssinia
abnegacja - abnegation
abonament - subscription, abonamento
abonent - subscriptor
aborcja - abortamento
absolutyzm - absolutismo
absorbent - absorbente
abstynencja - abstinentia
abstynent - abstinente
aceton - acetona
acetylen - acetylen
adadżio - adagio
adaptować - adaptar, appropriar, aptar
addendum - addendum
adiunkt - adjuncto
adiutant - adjutante
administracyjny - administrative
administrator - administrator
admirał - admiral; admiral
admirator - admirator
adopcja - adoption
adrenalina - adrenalina
Adriatyk - Adriatico
adwokat - advocato
aerobus - aerobus
aerodynamika - aerodynamica
aerologia - aerologia
aeronauta - aeronauta
aeronautyka - aeronautica
afazja - aphasia
afekt - affecto
afektowany - affectate
Afganistan - Afghanistan
afiks - affixo
afrodyzjak - aphrodisiaco
agat - agata
agitator - agitator
agnostycyzm - agnosticismo
agnostyk - agnostico
agonia - agonia
agora - agora
agorafobia - agoraphobia
agresywny - aggressive
agronomia - agronomia
akacja - acacia
akademia - academia
akademik - academico; academico
akademizm - academismo
akant - acanto
akcent - accento
akcja - compartir
aklamacja - acclamation
akordeonista - accordionista
akr - acre
akrobata - acrobata
akronim - acronymo
akselbant - agulietta
akt - acto
aktywować - activar
akumulator - accumulator
akupunktura - acupunctura
akwamaryna - aquamarina
akwarela - aquarella
akwarium - aquario
akwatinta - aquatinta
akwedukt - aqueducto
alabaster - alabastrite, alabastro
alarm - alerta, allerta
Albańczyk - albaniano, albanese
Albania - Albania
albański - albanese; albaniano
albatros - albatros
album - album
albumina - albumina
albuminuria - albuminuria
alegoria - allegoria
aleja - allee, vico
alergen - allergene
alergia - allergia
alfa - alpha
alfabet - alphabeto
alfabetyczny - alphabetic
algebra - algebra
Algier - Alger
Algierczyk - algeriano
Algieria - Algeria
algierski - algerian
algo- - algo-
algometria - algometria
algorytm - algorithmo
alias - alias
alibi - alibi
aliteracja - alliteration
alkalizować - alcalisar
alkoholik - alcoholico
alkoholizm - alcoholismo
alkoholowy - alcoholic
alkowa - alcova
alpejski - alpestre, alpin
alpinista - alpinista
Ałtaj - Altai
altruista - altruista
ałun - alume
aluzja - allusion
Alzacja - Alsatia
alzacki - alsatian
amalgamator - amalgamator
amant - amante
amazoński - amazonie
ambasada - ambassada
ambasador - ambassator
ambicja - ambition
ambitny - ambitiose, arriviste
ambulans - ambulantia
ameba - ameba
Ameryka - America
Ameryka Łacińska - America Latin
Amerykanin - americano
amerykanizm - americanismo
amerykański - american
Ameryka Północna - America del Nord
Ameryka Południowa - America del Sud
Ameryka Środkowa - America Central
amfibia - amphibio
amfiteatr - amphitheatro
aminokwas - aminoacido
amnestia - amnestia
amnestionować - amnestiar
amoniak - amoniak, ammoniaco
amonit - ammonite
amplituda - amplitude
ampułka - ampulla
Amsterdam - Amsterdam
amulet - amuleto
anachronizm - anachronismo
anagram - anagramma
analfabeta - analphabeto
analityk - analysta
analiza - analyse
analizator - analysator
analizować - analysar
analogiczny - analoge, analogic
anarchia - anarchia
anarchizm - anarchismo
anatomia - anatom
Andaluzja - Andalucia
Andaluzyjczyk - andaluso
Andora - Andorra
andorski - andorran
anegdociarz - anecdotista
anegdota - anecdota
aneksja - annexion
anektować - annecter, annexar
anestezja - anesthesia
Angielka - anglese
angielski - anglese; anglese
angio- - angio-
angiografia - angiographia
angiologia - angiologia
Anglia - Anglaterra
anglicyzm - anglicismo
Anglik - anglese, anglo
anglomania - anglomania
anglosaski - anglosaxone
anilina - anilina
Anioł Pański - angelus
anoda - anodo
antagonista - antagonista
antidotum - antidoto
antonim - antonymo
antracyt - anthracite
antropologia - anthropologia
antropomorfizm - anthropomorphismo
antybiotyk - antibiotico
antyczny - antique
antyinflacyjny - antiinflationari
antyk - antiquo, antiquitate
antykatolicki - anticatholic
antyklerykalizm - anticlericalismo
antykoncepcyjny - anticonceptional
antykwariusz - antiquario
antylopa - antilope
antymon - antimonio
antypapież - antipapa
antyreligijny - antireligiose
antysemicki - antisemitic
antysemityzm - antisemitismo
antyseptyczny - antiseptic
antywirusowy - antiviral; antiviral
anulować - annullar
aorta - aorta
aparat - apparato
apartament - appartamento
apartheid - apartheid
apeniński - apennin
apetyt - appetentia, appetito
apologia - apologia
apostata - apostata
apostazja - apostasia
apostrof - apostropho
apoteoza - apotheosis
aprobata - accollada, approbation, sanction
apsyda - apside
apteka - apotheca, pharmacia
aptekarz - apothecario
Arab - arabe
Arabia Saudyjska - Arabia Saudi
arabista - arabista
arabski - arabe, arabic
arbiter - arbitro
arbitralny - arbitrari
archanioł - archangelo
archeolog - archeologo
archeologia - archeologia
archetyp - archetypo
archipelag - archipelago
architekt - architecto
architektoniczny - architectonic, architectural
architektura - architectonica
architraw - architrave
arcybiskup - archiepiscopo
areał - area
arena - arena
aresztant - arrestato
Argentyna - Argentina
Argentyńczyk - argentino
argentyński - argentin, argentinian
argon - argon
argument - argumento
aria - aria
Ariadna - Ariadna
Arizona - Arizona
arkada - arcada
Arkansas - Arkansas
arlekinada - arlequinada
armeński - armenie, armenian
armia - armea
arsenał - arsenal
artefakt - artefacto
arteria - arteria; arteria
artykuł - articulo
artyleria - artilleria, cannoneria
artystycznie - artisticamente
artystyczny - artistic
Aryjczyk - aryano
aryjski - aryan
Arystoteles - Aristotele
arytmetycznie - : arithmeticamente
arytmetyka - arithmetica
arytmetyk - arithmetico
arywista - arrivista
as - asse
asfalt - asphalto
aspiracja - aspiration
aspiryna - aspirina
astrofotografia - astrophotographia
astrolog - astrologo
astrologia - astrologia
astronautyka - astronautica
astronomia - astronomia
astronomiczny - astronomic
asymetryczny - asymmetric, asymmetre
asymptota - asymptote
atawizm - atavismo
ateista - atheista, atheo
ateizm - atheismo
Ateny - Athenas
atlas - atlas
atmosfera - atmosphera; atmosphera
atol - atollo
atrybucja - attribution
audytorium - auditorio
aukcja - auction
Austria - Austria
austriacki - austriac
auszpik - aspic
auto - auto
autobiografia - autobiographia
autobus - autobus, omnibus, bus
autodafe - autodafe
autograf - autographo
autoklaw - autoclave
autokracja - autocratia
autonomia - autonomia
autonomiczny - autonomic
autopsja - autopsia
autostop - autostop
awantura - altercation
awanturnik - picaro; aventurero
awaria - avaria, emergentia
awokado - avocato
Azerbejdżan - Azerbaidzhan
Azjata - asiatico
azjatycki - asiatic
azot - nitrogeno, nitro
bachanalia - bacchanalia
bachantka - bacchante
Bachus - Baccho
bać się - angustiar
badminton - badminton
Bagdad - Baghdad
bagnet - baionetta, bayonetta
bagno - palude
bagrować - dragar
bakcyl - bacillo
bakelit - bakelite
bakteria - bacterio
bakteriobójczy - antiseptic, bacteriocide, germicidal
bakteriolog - bacteriologo
bakteryjny - bacterial
bałałajka - balalaika
balansowanie - balanciamento
balista - ballista
bałkański - balkanic
Bałkany - Balkanes
ballada - ballada
balsam - balsamo, unguento
balsamiczny - unguentari
balustrada - balustrada
bałwan - beotio
banan - banana
bandaż - bandage
banjo - banjo
bank - banca
bankowy - bancari
barani - arietari
barkarola - barcarola; barcarola
bark - humero
barman - barman
barokowy - baroc
barykada - barricada
baskijski - basco
baśń - fabula
batożyć - flagellar
Bawaria - Bavaria
bawełna - coton
bawić - amusar
bazooka - bazooka
Bazylea - Basel
beatyfikacja - beatification
bęben - tamburo
bednarz - barrilero, cupero
Beduin - beduin
befsztyk - beefsteak
bękart - bastardo
beletrystyka - belles-lettres
Belg - Belga
Belgia - Belgica
belgijski - belge
benedyktyn - benedictino
Benin - Benin
benzol - benzol
benzyna - gasolina, benzina
Berlin - Berlin
Berno - Bern
beryl - beryllium, beryllo
beton - beton
bezbarwny - achromate, achromatic
bezbożny - athee
bezdyskusyjnie - indisputabilemente, indiscutibilemente
beznadzieja - desperantia
beżowy - beige
bezpieczeństwo - securitate
bezpośredni - directe
białaczka - leucemia
białko - albumine
Białoruś - Bielorussia, Belorussia
białoruski - belorusse; belorusso
biały - albe
Biblia - Biblia
bibliotekarz - bibliothecario
biblista - biblista
bić - bastonar, colpar, disgranar, frappar, massar, percuter; palpitar
bieda - miseria, paupertate, povressa
biegacz - currero, cursor
biegunka - diarrhea, lienteria
Bielsko-Biała - Bielsko-Biala
biernik - accusativo
bigot - bigot
bigoteria - bigoteria
bikini - bikini
bilateralny - bilateral
bileter - billetero
biograf - biographo
biotechnologia - biotechnologia
Birma - Burma
biseksualny - bisexual
biskup - episcopo
biskupi - episcopal; episcopal
biurko - bureau, scriptorio
biust - busto
bizantyjski - byzantin
bizon - bisonte
blaga - auripelle
błagać - deprecar, obsecrar, rogar, supplicar, implorar
błaganie - obsecration; prece, conjuration
blagier - bluffator, prevaricator
błahy - futil
blef - bluff
błękit - azurato
blisko - proksima
bliskość - proximitate
blizna - cicatrice
blondyn - blonde
blondynka - blonda, blondessa
błotnik - guardafango
bluza - blusa
bóbr - castor
bocian - ciconia
bogactwo - ricchessa
bogacz - ricco
bogaty - ric; affluente
Bóg - Deo
bojkot - boycott, boycottage
ból - algesia; algesia
boleściwy - dolorose
bolesny - dolorose; afflictive
Boliwia - Bolivia
Boliwijczyk - boliviano
bombardować - bombar, cannonar
bor - boro
bośniacki - bosnie
Bośniak - bosniaco
botanika - botanica, botanologia
botanik - botanista
boży - divin, dive
brać - sumer
brakować - mancar, carer
bratanek - nepote
braterstwo - fraternitate, confraternitate
brat - fratre
bratobójstwo - fratricidio
brąz - bronzo
brązowy - brun
Brazylia - Brasil
broda - barba, mento
brokuł - broccoli
brom - bromo
broń - arma, armamento
bronować - hirpicar
broszka - broche
broszura - brochure
bruk - pavimento
brylant - brillante
Brytyjczyk - Britanno, anglo
bryza - brisa
brzeg - ripa
brzoskwinia - albricoc
brzoza - betula
brzuchomówca - ventriloquo
brzuchomówstwo - ventriloquia
brzydki - fede
buda - canil
buddyzm - buddhismo
budowa ciała - corporatura
budować - struer
budowlany - constructive
budzić - eveliar
Bug - Bug
Bukareszt - Bucarest
bukiet - bouquet
bukszpan - buxo
Bułgar - bulgaro
bułgarski - bulgare; bulgaro
bumelować - otiar
burdel - bordello
Burkina Faso - Burkina Faso
burnus - burnus
burżuj - burgese
burzyć - fermentar
busola - bussola
butelka - bottilia
but - scarpa
być - esser, ser
byk - tauro
bystry - argute
całkiem - assatis
car - czar/tsar
carski - czarian, czarista
cebula - cibolla
cecha - contramarca
cegła - bricca
Cejlon - Ceylon
cela - cella
celny - doanal
celofan - cellophan
celownik - dativo
cenotaf - cenotaphio
centaur - centauro
centrum - centro
centymetr - centimetro
cesarzowa - imperatrice
cewka moczowa - urethra
Cham - Cham
chamicki - chamitic
chamski - aspere
chamstwo - crassitude
chaos - chaos
chciwość - avidia, aviditate, rapacitate, cupiditate
chciwy - insatiabile, avide, rapace
chemia - chimia
chemiczny - chimic
chemik - chimico, chimista
chemioterapia - chimotherapia
cherubin - cherubin
Chiny - China
chirurg - chirurgo
chirurgia - chirurgia
chirurgiczny - chirurgic
chleb - pan
chłodny - frigide
chłodzić - refrigidar
chlor - chloro
chlorek - chloruro, chlorido
chmura - nube
choinka - arbore de Natal
cholera - cholera
choroba morska - cinetosis, nausea
Chorwacja - Croatia
Chorwat - croato
chować - abstruder
chrapać - roncar
chrom - chromo
chromosom - chromosoma
chronić - albergar
chronologia - chronologia
chronometria - chronometria
Chrystus - Christo
chryzantema - chrysanthemo
chrząstka - cartilagine, chondro
chrześcijanin - christiano
chrześcijański - christian
chrzest - baptismo
ciążowy - gestatori
cichy - quiete
ciemność - tenebrositate
ciemny - obscur, tenebrose; analphabete, analphabetic, ignorante, illitterate
cień - umbra
ciepły - affectionate
cierpieć - patir; indurar
cieszyć - allegrar; jubilar, joiar
ciotka - amita
cmentarz - cemeterio
cofać - disdicer
córka - filia
coś - alco, alique
cudowny - admirabile
cugle - brida, redina
cukier - sucro
cukrzyca - diabete
ćwiczenie - exercitio
cylindryczny - cylindric
cynk - zinc
Cypr - Cypro
cyrk - circo
cyrkon - zircon
Cyryl - Cyrillo
cytadela - citadella
cytra - cithera
cytryna - limon
cyzelować - cisellar
czarny - nigre
czasem - aliquando, alquando
czasopismo - periodico, revista
czaszka - cranio
czatować - insidiar; chattar
czcionka - typo
Czech - Checo
Czechosłowacja - Checoslovachia
Czechy - Tchechia
Czeczenia - Chechenia
czekolada - chocolate
czerwiec - junio
czerwony - rubie
cześć - salute
czeski - chec; Checo, tchec
człowiek - homine
czołg - tank
czosnek - allio
czteroletni - quadriennal
czuły - affectionate
czwartek - jovedi
czworonożny - quadrupede, tetrapode
czy - esque
czynność - activitate
czyścić - appurar, expurgar, purificar, depurar, furbir, mundificar, mundar, nettar
czyściec - purgatorio
czystość - puritate; castitate
czysty - munde, nitide; nette; caste
czyszczenie - nettage, mundification, appuramento, depuration
czytać - leger
czytelnia - cabinetto de lectura
daktyl - dactylo, dattilo
dalia - dahlia
dama - dama
Dania - Danmark
daremny - otiose, frustranee
dawca - dator
dążenie - aspiration
defetyzm - defaitismo
definicja - definition
definitywnie - definitivemente
deforestacja - deforestation
defraudacja - defraudation
deista - deista
deizm - deismo
dekada - decade
dekalog - decalogo
deklaracja - declaration
deklinacja - accidentia
dekolonizacja - decolonization
dekoracja - decoration
dekoracyjny - decorative
dekorować - decorar
delegat - delegato
delfin - delphino
deliberować - deliberar
delicja - delicia
delta - delta
demiurg - demiurgo
demokracja - democratia
demokrata - democrate
demokratyzować - democratisar
demolować - demolir
demoniczny - demoniac
demonolatria - demonolatria
demonologia - demonologia
dendrologia - dendrologia
denerwować - perturbar
dentysta - dentista
depilacja - depilation
depilator - depilatorio
deportacja - deportation
deportować - deportar
deprecjonować - depreciar
depresja - abattimento
dermatologia - dermatologia
despota - despota; despota
destrukcja - destruction
deszczowy - pluviose, pluvial
deszcz - pluvia
detonator - detonator
deuter - deuterium
deuteron - deuteron
dewastator - devastator
diagnozować - diagnosticar
dialektyczny - dialectic
dietetyczny - dietetic
digamma - digamma
diorama - diorama; diorama
dla - por
dłuto - cisello
dłużnik - debitor
dno - fundo
dobosz - timbalero
doceniać - appreciar
docent - docente
dochód - rendimento, lucro, ganio, renta
dodatek - accessorio
dodawać - adder, additionar
dojrzały - adulte, matur
dokładny - precise
dolar - dollar
dół - fossa
dolny - infere
dom - casa
dom dziecka - casa de infantes
Dominik - Dominico
dorosły - adulte; adulto
Dorota - Dorothea
dość - assatis
dostarczać - approvisionar, aprovisionar, delivrar, fornir, livrar, munir, provider, subministrar, suppler
dostatecznie - sufficientemente
dostęp - accesso
dotyczyć - concerner
dotykać - affliger
dotyk - tacto
do widzenia - adeo
dowód - prova
drewno - ligno
druid - druida
drwal - abattitor, serrator
drwić - irrider
drzemać - dormettar
drzewce - fuste
drzewo - arbore
duch - apparition
duchowo - spiritualmente
dudek - upupa
duma - orgolio
dumny - orgoliose
Dunaj - Danubio
duński - dan
dupa - culo
durszlak - colatorio, colo
duży - ample, grosse
dwojaki - duple
dwubarwny - bicolor
dwuczęściowy - bipartite
dwudzielny - bifide, dichotomic
dwujęzyczny - bilingue
dwukierunkowy - bidirectional
dwulicowość - duplicitate
dwulicowy - duplice, pharisaic
dwupłat - biplano
dwuramienny - bicipital
dwusieczna - bisectrice
dwutomowy - ditome
dwuwymiarowy - bidimensional
dwuznaczny - ambigue
dykcja - diction
dyktat - dictato, dictamine
dyletancki - dilettante
dyletant - dilettante
dynia - cucurbita
dyplomata - diplomate, diplomatico, diplomato
dysertacja - dissertation
dystrykt - districto
dziadkowie - granparentes
dziad - mendico
działać - ager
działalność - activitate
działanie - activitate
dziąsło - gingiva, alveolo
dzieciobójstwo - infanticidio
dziecko - infante
dziedzic - hereditario
dziedziczyć - hereditar
dziękować - regratiar
dzielić - departir
dzień - jorno
dziennikarstwo - jornalismo
dziennikarz - jornalista
dziesięciolecie - decennio
dziób - becco, rostro
dziwny - peculiar
dżuma - peste
dżungla - jungla
dźwiękowy - sonor
dzwonić - tintinnar
efektywnie - effectivemente
Egipt - Egypto
egiptolog - egyptologo
egiptologia - egyptologia
ego - ego
egoista - egoista
egoistyczny - egoistic
egzaltacja - exaltation
egzamin - examine
egzystencja - existentia
egzystencjalizm - existentialismo
egzystować - exister, subsister
ekologia - ecologia
ekologiczny - ecologic
ekosystem - ecosystema
ekshibicjonizm - exhibitionismo
ekskomunika - anathema
ekskomunikować - excommunicar
ekspedycja - expedition
ekspert - experto
eksperymentator - experimentator
eksploatować - exploitar
eksplozja - explosion
ekspozycja - exposition
ekspresowy - expresse
ekstrapolacja - extrapolation
ekstremalny - extremal
ekstremizm - extremismo
Ekwador - Ecuador
elegancki - elegante
elegijny - elegiac
elektrolit - electrolyto
elektronika - electronica
elektryczność - electricitate
elektryczny - electric
elementarny - elementar
embargo - embargo
emocja - affecto
empiryczny - empiric
emu - emu
encyklopedia - encyclopedia
endokrynologia - endocrinologia
enigmatyczny - enigmatic
ententa - entente; entente
entuzjazm - entusiasmo
enzym - enzyma
epidemia - epidemia
epidemiologia - epidemiologia
eponim - eponymo
epsilon - epsilon, epsylon
eremita - eremita
Eros - Eros
erudycja - erudition
erudyta - erudito
erupcja - eruption
Erytrea - Eritrea
eschatologia - eschatologia
eseista - essayista
eskapada - escappada
esperanto - esperanto
Estonia - Estonia
eta - eta
eteryczny - etheree
Etiopia - Ethiopia
etruski - etrusc
etyczny - ethic
etyka - ethica
etymologia - etymologia
Euklides - Euclide
Eurazja - Eurasia
Europa - Europa
europejski - europee
eutanazja - euthanasia
ewidentnie - apparentemente
Ezop - Esopo
ezoteryczny - esoteric
fagot - basson, fagotto
faks - fax
fałszywy - false; contrafacte, apocryphe; pharisaic; erronee, mendose; posticie, suppositicie
fama - fama
fanatyk - fanatico
fan - devoto
faraon - pharaon
farmaceutyczny - pharmaceutic
faszysta - fascista
faszyzm - fascismo
Fenicja - Phenicia
Fidżi - Fiji
figa - fico
Filadelfia - Philadelphia
Filipiny - Philippinas
Filip - Philippo
film - film
filolog - philologo
filozof - philosopho
finalizować - compler, completar
finansowy - financiari
finezja - finessa
Finlandia - Finlandia
fiołek - violetta
fioletowy - violette
firma - firma
fizyka - physica
flaki - tripa
flet - flauta
flirt - amoretto
flora - flora
fluktuacja - fluctuation
fluor - fluor
folklor - folklore
fortel - stratagema
fortuna - fortuna ; fortuna
fosfor - phosphoro
fotel - sede a bracios, sedia confortabile
fotograficzny - photographic
Franciszek - Francisco
Franciszka - Francisca
Francja - Francia
francuski - francese
frank - franco
frankofilski - francophile
fundament - fundamento, fundation
fura - carrettata
furia - furia
gaduła - confabulator
gaj - arboreto, boschetto
gałąź - branca
galeon - galeon
galera - galera
gałka muszkatołowa - nuce muscate
galon - galon
gambit - gambito
gamma - gamma
Ganges - Gange
gangster - gangster
garaż - garage
gardło - gorga, gurgite, gutture, jugulo
garnirować - guarnir
gaża - gage
gazon - gazon
Gdańsk - Gdansk, Danzig
gdzieś - alicubi
gen - gen
genialność - genialitate
Genua - Genua
geograf - geographo
geografia - geographia
geograficzny - geographic
geologia - geologia
geologiczny - geologic
geometra - agrimensor, geometra
geometria - geometria
gęś - ansere
giętko - flexibilemente
gilotyna - guillotine
ginekolog - gynecologo
gips - gypso
gitara - gitarra
gitarzysta - gitarrista
głębia - fundo, profunditate
głęboko - profundemente
głębokość - profundor, profunditate
gliceryna - glycerina
glina - argilla
głodny - affamate, famelic
glon - alga
głośnik - altoparlator
głosowanie - ballotta, votation; suffragio
głowa - capite
gniazdo - nido
godło - emblema
godny - digne
gołąb - columba
golarka - rasorio
gołębnik - columbiera
gondola - gondola
goniec - alfil
gorąco - ardorosemente
gorący - calorose; ardorose
górka - collinetta
górnik - minator, minero
gorset - corset
górzysty - montaniose
gość - convitato
gotować - cocer, cocinar, bullir; bullir
gotowanie - coction
gramofon - gramophono
granat - granata; granata
graniczny - frontieral, frontier
granit - granito
grecki - grec
grejpfrut - pompelmus
Grenlandia - Groenlandia
grobowiec - cenotaphio, sepulchro, sepulcro
gromadzić - accumular, amassar, colliger, agglomerar, assemblar
gronostaj - armenio
grubiański - aspere
gruby - crasse
grudzień - decembre
grupa - aggrupamento
grymaśny - argutiose
grypa - influenza
grzbiet - dorso
grzechotnik - crotalo
gwiazda - stella
gwiazdozbiór - constellation
Gwinea Równikowa - Guinea Equatorial
habitat - habitat
haftować - brodar
Haiti - Haiti
hak - uncino, croc
hałaśliwy - ruitose, strepitose
halka - subgonnella
hamować - refrenar
hańbić - dishonorar
harfa - harpa
harmonijka ustna - concertina
harmonogram - horario
Hawaje - Hawai
hegemon - hegemono
hegemonia - hegemonia
hektar - hectar
hel - helium
hełm - casco
Helsinki - Helsinki
herbata - theiero, the
herbatnik - biscuit
herb - blason
heretycki - heretic
herold - heraldo
herpetologia - herpetologia
hiacynt - hyacintho
hinduski - indian
historyczny - historic
Hiszpania - Espania
Holandia - Hollanda, Pais Basse, Nederland, Nederlanda
hołota - populaceo
homerycki - homeric
Hongkong - Hong Kong
hormon - hormone
horror - horror
hospitalizacja - hospitalisation
hrabia - conte
huragan - huracan, hurracan
huśtawka - balanciatoria
hymn - hymno
idea - idea; idea
idealista - idealista
identyczny - identic
ideologiczny - ideologic
idiota - idiota
i - e
igła - acicula, agulia
ile - quot
ilość - amonta
iluzoryczny - illusori, prestigiose
imaginacja - imagination
imigracja - immigration
imperator - imperator
implikacja - implication
imponować - imponer
imputowanie - allegation
inaczej - alteremente
Indonezja - Indonesia
indonezyjski - indonesian
infinitezymalny - infinitesime
inflacja - inflation
influenca - influenza
ingerencja - ingerentia
inkunabuł - incunabulo
inny - alie, altere
instytut - instituto
insurekcja - insurrection
integracja - integration
inteligencja - intelligentia
intencja - intention
interlingua - interlingua
interlokutor - interlocutor
interpretacja - interpretation
interwencja - intervention
intymny - intime
inwalida - invalido
inwazja - invasion
inwestycja - investimento
inżynieria - ingenieria
inżynier - ingeniero
Irak - Iraq
Iran - Iran
ironia - ironia
irracjonalny - irrational
islam - islam
islamizować - islamisar
islamski - islamic, islamitic
Islandia - Islanda
islandzki - islandic
Izrael - Israel
jabłko - malo
jabłkowy - pomacee
jadalny - comestibile
jadeit - jada
jagnię - agno
jaguar - jaguar
ja - io
jajko - ovo
jajo - ovo
jałmużna - almosna
Japonia - Japon
jar - canyon
jarzmo - jugo
jaskier - ranunculo
jaszczurka - lacerta
jawny - apparente
jazz - jazz
jednobarwny - monochromatic, monochrome, unicolor
jednokierunkowy - unidirectional
jednomyślność - unanimitate
jednorożec - unicorne
jedynie - solmente
Jerozolima - Jerusalem
Jerycho - Jerico
Jerzy - Georgio
jeść - manducar
jesień - autumno
jesienny - autumnal
jesion - fraxino
Jezus - Jesus
językowy - lingual, liguistic, linguistic
jidysz - yiddish
jogurt - yogurt
Jowisz - Jupiter; Jove
Józef - Joseph
judaizm - judaismo
judeochrześcijański - judeochristian
jutrzenka - alba
kabareciarz - cabaretero
kabaret - cabaret
kaczka - anate
kadm - cadmium
Kair - Cairo
kajakarz - canoero
kajak - kayak, canoa
kaktus - cacto
kalendarz - calendario
kalkulator - calculator
kaloryfer - radiator
kalumnia - calumnia
kalwinizm - calvinismo
Kambodża - Cambodia
Kamerun - Camerun
Kanada - Canada
Kanadyjczyk - canadiano
kanał - canal
kangur - kanguru
kanikuła - canicula
kankan - cancan
kanonizacja - canonisation
kapitalista - capitalista
kapitalistyczny - capitalistic
kaplica - capella
kaptur - cappucio
karabin - carabina
karabin maszynowy - mitraliatrice
karczoch - artichoc
kardynał - cardinal
kariatyda - caryatide
karlica - nana
karmel - caramello
karmin - carmino
karnacja - carnation
karnawał - carneval
karo - diamante
kartografia - cartographia
kartograficzny - cartographic
karygodny - reprehensibile, vituperabile
karykatura - caricatura
karzeł - nano
kasa - cassa
kasjer - cassero
kaskada - cascada
kastrat - castrato
kastrować - castrar, emascular
kaszleć - tussir
katalityczny - catalytic
katalog - catalogo
Katalonia - Catalonia
kataloński - catalano
katarakta - cataracta
Katarzyna - Catharina
katechumen - catechumeno
katedra - cathedral
kation - cation
katolicki - catholic
kąt prosty - angulo recte
kaukaski - caucasian
Kaukaz - Caucaso
kawa - caffe
kawaler - baccalaureo
kawiarnia - cafe, caffe
Kenia - Kenya
kenozoiczny - cenozoic
kiedy indziej - altere vices
kiedyś - aliquando, alquando
kierowca - autoista, automobilista, chauffeur, conductor, guidator
kierunek - senso
kieszonkowiec - pickpocket
kilka - alcun; aliquot, alicun
kilt - kilt
kino - cine
kirasjer - cuirassero
kirys - cuirasse
klaka - claque
kłamać - mentir
klarnet - clarinetto
klarowanie - clarification
klarownica - clarificator
klawesyn - clavicymbalo
klawiatura - tastatura
klawisz - tasta
kleić - glutinar
klej - adhesivo
klękać - genicular
klęska - deroute, disfacta, disastro
kleszcze porodowe - forcipe
klikać - cliccar
klimatyzacja - climatisation
klon - acere; clono
klucz francuski - clave anglese
kminek - cumino, carvi
knot - micca
koalicja - coalition
kobalt - cobalt
kobieta - femina
kochać - amar
kochany - amate
kocia muzyka - charivari
kofeina - caffeina
kokietować - coquettar
koksownik - brasiero
kolarz - bicyclista, cyclista
kołdra - coperilecto
kolega - collega
kolejarz - ferroviero
kolejowy - ferroviari
kolektywnie - collectivemente
kolektywny - collaborative, collective
kolidować - collider
kolokacja - collocation
kolonializm - colonialismo
kolonizator - colonisator
kolumbarium - columbario; columbario
Kolumbia - Colombia
kolumna - colonna; pilastro; columna
kołyska - cuna
komar - mosquito
komentator - commentator; commentator, explicator
komentować - commentar
komercjalizacja - commercialisation
kometa - cometa
komfort - commoditate
komicznie - comicamente
kominek - camino
komisja - commission
komora - camera; ventriculo
komparatywny - comparative
komplementarność - complementaritate
kompozycja - composition
kompromis - compromisso
komputer - computator
komputerowy - computational, computatori, computatorial
komunikacja - communication
komunikat - communicato
komunista - communista
komunizm - communismo
koń - cavallo
koncentrować - concentrar, focalisar
koncentryczny - coaxial, concentric
koncert - concerto
koncesyjny - concessionari, concessive
kończyć - finir, compler, complir, completar, clausurar
kondensator - condensator
kondolencje - condolentia
konfetti - confetti
konfitura - confectura
konfliktowy - conflictive
kongestia - congestion
Kongo - Congo
koniak - cognac, aquardente
koniec - fin
koniugacja - conjugation
konklawe - conclave
konkordat - concordato
konkubinat - concubinato, concubinage
konny - equestre
Konstantynopol - Constantinopole
konstelacja - constellation
konsternacja - consternation
kontakt - continger
kontestacja - contestation
kontinuum - continuo
kontrabanda - contrabando
kontrola - appuramento
kontrwywiad - contraspionage
kontur - contorno
konurbacja - conurbation
konwencjonalny - conventional
kooperacja - cooperation
koparka - excavator
koper - anetho
koperta - inveloppe
kordialny - cordial
Kordowa - Cordova
Korea - Corea
Koreańczyk - coreano
koreański - corean; coreano
kornet - cornetta
korona - corolla, corona; corona; corona; monarchia
koronka - dentella
korpulentny - corpulente, abdominose
Korsyka - Corsica
koryncki - corinthie
korzystać - profitar
kosaciec - iride, iris
kosa - falce
kość - osso; dato
kos - merla
kosmopolita - cosmopolita
koszt - sumpto
kot - catto
kotka - catta
kotlet - cotelette
kotwica - ancora
kotwicowisko - ancorage
kowariancja - covariantia
kozi - caprin
krater - crater
krawiec - sartor
krążownik - cruciator
kreatywny - creative
Kreta - Creta
krewetka - crangon
krew - sanguine
królik - conilio
królowa - regina
król - rege
kropla - globulo, gutta, stilla
krowa - vacca
kruk - corvo
krużganek - claustro
krykiet - cricket, croquet
Krym - Crimea
kryminalista - criminalista
krytyka - animadversion
kryzys - crise
krzem - silice
krzesło - sedia, chaise
krzyczeć - critar
krzyk - clamor, crito
ksenofobia - xenophobia
książę - prince
księgarnia - libreria
ksylofag - xylophage
ksylofon - xylophono
kształt - forma
kto - qui; qui
ktoś - alcuna, alicuna , alicuno
Kuba - Cuba
kubański - cuban
kuchnia - cocina
kukurydza - mais
kulis - coolie
kulminacja - apogeo; culmine; culmination
kulminacyjny - culminante
kultura - cultura
kumulować - cumular
kupować - comprar, emer
kurs - curso
kustosz - custode
kusza - arcoballista
kuter - cutter
kwadrans - quarto
kwartet - quartetto
kwas - acido
kwasić - acetificar
kwaśny - acetose
kwestionować - questionar
kwiatowy - floral
kwiecień - april
kwitnąć - florar, florer, florescer, inflorescer
labirynt - labyrintho
Labrador - Labrador
łacina - latin
łączność - communication
łączyć - conjunger; adjunger, agglutinar; amalgamar
lądowy - terrestrial
łagodnieć - mollir
łąka - prato
laktacja - lactation
łamliwy - fragile
lampart - leopardo
łańcuch - catena
lapoński - lapponese
las - foreste, bosco
lato - estate
latyfundium - latifundio
lawa - lava
lawina - avalanche
Łazarz - Lazaro
łazienka - camera de banio
łechtaczka - clitoride
leczniczy - curative
legenda - legenda
legionista - legionario
lejce - brida, redina
lekceważyć - despicer, disobligar
lekkoatletyka - athletica
leming - lemming
Leningrad - Leningrad
Lenin - Lenin
lepszy - melior
lesisty - silvose, silvatic, silvan
lewarek - levator
leworęczny - sinistromane
lewy - sinistre
leżeć - cubar
Liban - Libano
libido - libido
libretto - libretto
licencja - licentia
liczba pierwsza - numero prime
liczenie - calculation, conto
ligatura - ligatura
likwidacja - liquidation
linczować - lynchar
lingwista - linguista
lingwistyka - linguistica
linoskoczek - funambulo
lipa - tilia
lipiec - julio
lira - lyra
liryczny - liryc
lista dyskusyjna - mailing-list
lista - lista
listonosz - postero, currero
listopad - novembre
lis - vulpe
litera - littera
litr - litro
lizus - adulator
lodowisko - patinatorio
łodyga - pedunculo
logarytm - logarithmo
łokieć - cubito
Londyn - London
łono - utero, sino
lornetka - binoculo
łosoś - salmon
losowy - aleatori
lotniczy - aeronautic
lotnisko - aerodromo, aeroporto
lotniskowiec - portaaeroplanos
lubić - affectionar
łucznik - archero
ludobójstwo - genocidio
łudzić - illusionar, prestigiar
ludzkość - humanitate
lufa - cannon
łuk - arco
Luksemburg - Luxemburg
łupież - furfure
łuska - scalia; flocco
lut - soldatura
luty - februario
łyżwiarz - patinator
Macedonia - Macedonia
macica - utero
macierzyński - maternal
mafia - mafia
mafijny - mafiose
mafioso - mafioso
mag - mago, magico
magnes - magnete
Mahomet - Mahomet, Mohammed
majestatyczny - majestatic, majestose, excelse, auguste, sublime
maj - maio
majstersztyk - obra de maestro
makabryczny - macabre
mąka - farina
makak - macaque
mak - papavere
malajski - malay
malaria - malaria
malarz - pictor
malina - frambese
małżeński - conjugal, connubial, matrimonial, sponsal
mama - mama
mango - mango; mango
maniera - maniera
manipulować - manipular
manko - manco
mansarda - mansarda
mapa - mappa, carta
marchew - carota
margaryna - margarina
markiza - marchesa, marquise
marmur - marmore
Maroko - Marocco, Morocco
marszałek - marechal
martyrologia - martyrologio
marzec - martio
marzenie - desiderio, reverie
marzyć - soniar
maść - unguento
masoneria - masoneria, francmasoneria
mason - mason
maszyna - machina
matczyny - materne, maternal
matematyk - mathematico
matka - matre
mechaniczny - mechanic
mechanizm - mechanismo
mediana - mediana
mędrzec - sagio
medycyna - medicina
megaloman - megalomano
męka - tormento, cruciation, calvario
Meksyk - Mexico
melancholia - melancholia, atrabile
memorandum - memorandum
Merkury - Mercurio ; Mercurio
metafizyczny - metaphysic
metafora - allegoria, metaphora
meteorologia - meteorologia
metoda - methodo
Metody - Methodio
mewa - laro
mężczyzna - homine, viro
Mezopotamia - Mesopotamia
mgła - bruma
miąższ - pulpa
mieć - haber
miecz - gladio
miejski - municipal
mięsień - musculo
mięsożerca - creophago
mięsożerny - creophage, carnivore
mieszkalny - habitabile
mieszkanie - appartamento
mięta - mentha
migrena - migraine
mikroorganizm - animalculo
milicja - militia; militia
milimetr - millimetro
militarny - bellicista
miło - agradabilemente
miłość - amor
miłosny - amorose
miły - amabile; agradabile; affabile, complacente
mimoza - mimosa
minaret - minaret
miód - melle
miotła - scopa
miscellanea - miscellanea
miseczka - bassinetto, scutella
mleć - moler
mleko - lacte
młody - juvene
młyn - molino
mnogość - multitude
modlić się - orar
modlitwa - oration, precaria, prece
Mojżesz - Moses
mokry - humide
monarchia - monarchia
monoteistyczny - monotheistic
monotonia - monotonia
moralista - moralista
moralność - moralitate
moralny - moral
morda - musello
morderca - assassinator, assassino
morderstwo - assassinato, assassination, homicidio, occision
morela - albricochiero, armeniaca
morski - maritime
Morze Bałtyckie - Mar Baltic, Baltico
Morze Karaibskie - Mar Caribe
Morze Kaspijskie - Mar Caspie
morze - mar
Morze Południowochińskie - Mar de China Meridional
Morze Śródziemne - Mediterraneo
moskit - culice, mosquito
moskitiera - mosquitiera
Moskwa - Moscova
motocykl - motocyclo
motyl - papilion
mowa - allocution
mózg - cerebro
możliwy - agibile
mrowisko - formicario
mrówkowy - formic
mrównik - orycteropo
mroźny - frigorifere
mrugać - palpebrar
muł - mulo; fango
mumia - mumia
musieć - deber
musztarda - mustarda
muzułmanin - musulman
mylić - aberrar
myśl - pensata
nacjonalizować - nationalisar
naczynie - alveo, vasculo
naddźwiękowy - hypersonic, supersonic
nadmiar - excesso, redundantia, surplus, profusion
nadzieja - sperantia
nagi - nude
nagle - abruptemente, urgentemente
naiwny - naive, credule
naleganie - insistentia
należeć - appertiner
nałożenie - superposition
namawianie - insistentia, exhortation
namiot - tenta
napalm - napalm
napastnik - assalitor, assaltator
napój - bibitura
narciarz - skiator
naród - nation
narzędnik - ablativo
narzucanie - imposition
nasiono - semine, grana
następowanie - sequentia
nauka - scientia; apprension, apprendimento, apprentissage
naukowiec - scientista
naukowy - scientific
nawigacyjny - navigational
nazista - nazista
nazywać - appellar, nominar
Neapol - Neapole
negacja - negation
nękać - plagar
neolit - neolitho
neolityczny - neolithic
neologizm - neologismo
neon - neon
Nepal - Nepal
nepotyzm - nepotismo
nerwowy - nervose, nerval; irritabile
neutron - neutron
nić Ariadny - filo de Ariadna
Niderlandy - Paises Basse
nieaktywny - inactive
niebieski - blau
niechęć - animositate, antipathia
niedojrzały - immatur, impubere, pueril
niedokrwistość - anemia
niedostępny - inaccessibile
niedziela - dominica
niekompetentny - incompetente
niekonsekwentny - inconsequente, inconsequential
niektóry - alicuno, alicun
Niemcy - Germania
Niemiec - germano
niemowlę - baby
niemożliwy - impossibile
nienawidzić - odiar
nieobecny - absentista
nieodpowiedzialny - irresponsabile, negligente
nieograniczony - illimitabile, illimitate
nieomylny - infallibile
niepewny - dubitabile
niepodległy - independente
niepokoić - disconcertar, molestar, turbar, perturbar
niepokój - agitation, angustia, anxietate
nieskończony - interminabile
nieskromny - immodeste, impudic, inhoneste
nieświadomie - inconsciemente
nieszczęście - afflixtion; disastro; affliction, infortuna
nieuczciwy - dishoneste
niewłaściwy - incorrecte, improprie, inappropriate
niezależny - independente, inattaccabile, substantive
niezapominajka - auricula
nieznany - incognoscite
nigdy - nunca
niob - columbium
niszczyć - annihilar
niszczyciel - destructor, devastator; chassa-torpedineros
niuans - nuance
nominowanie - nomination
nonkonformista - nonconformista
nordycki - nordic
Norwegia - Norvegia, Norvega
Norweg - norvegiano
nostalgia - nostalgia
nostalgiczny - nostalgic
noszenie - porto
Nowa Zelandia - Nove Zelanda
nowoczesny - moderne
Nowy Jork - New York
nowy - nove
Nubia - Nubia
numer - numero
numerować - numerar
numerowanie - numeration
nuncjatura - nunciatura
nuncjusz - nuncio
oaza - oase
obcas - calce
obchodzić - ambir
obejmować - circumferer; accollar
obejmowanie - adition
obelisk - obelisco
obietnica - promissa
obojczyk - clavicula
obojętność - indifferentia
obój - oboe
obowiązek - deber
obraza - insulto, offensa, ultrage
obrażanie - affrontamento
obraz - pictura
obrona - defensa
obrońca - advocato
obrotowy - giratori, rotatori
obrzydliwie - abominabilemente
obrzydliwy - horride, nauseabunde, detestabile
obwiniać - culpar, accusar, criminar, inculpar
obżarstwo - gluttonia
Ocean Atlantycki - Oceano Atlantic
Oceania - Oceania
ocean - oceano
ocet - aceto
ochota - desiderio, inclination
ochrona - salveguarda
ochronka - asylo
octan - acetato
oczyszczać - appurar
oczyszczanie - appuramento, purification, depuration
oczywisty - apparente
oddział - formation; truppa
oddziaływać - affectar
odkupiciel - redemptor
odkurzacz - aspirator
odmiana - flexion
odmienny - altere; conjugabile
odpowiedni - applicabile
odpowiedniość - conformitate, correspondentia
odpowiedzialność - responsabilitate
odpowiedź - replica
odtrutka - contraveneno
odwaga - braveria, corage
odważny - prode
odwieczny - immemorial
odzyskiwać - recuperar
odżywczy - alimentose, alibile
oficjalny - officialmente
oglądać - spectar
ogórek - cucumere, cucumbre
ogród - jardin, horto
ogrodnik - horticulturista
ojciec - patre
ojczym - patre affin
ojczyzna - patria
ok. - ca.
okno - fenestra; fenestra
określać - definir
okrucieństwo - cruelitate, diaboleria, atrocitate, ferocitate
okrutnie - atrocemente
okrutny - cruel
okulary - berillos
okulista - oculista, ophthalmologo
olej - oleo
ołów - blumbo
omnibus - omnibus
ona - illa
ontologiczny - ontologic
opat - abbate
opcja - option
operacyjny - operational, operative; operatori
operator - operator
opierać - accular
opium - opium
opłakiwać - luger
opłata - quota
opona - pneumatico
oponować - opponer, adversar
opozycja - opposition
oprócz - extra
optymizm - optimismo
oranżeria - estufa
orbita - orbita
orchidea - orchidea
organista - organista
organizacja - organisation
organizm - organismo
orgia - saturnales, bacchanalia, orgia
orli - aquilin
orlik - aquilegia
ormiański - armenian
ortografia - orthographia
orzeczenie - adjudication
orzeł - aquila
oscylacja - oscillation
ósemka - octena
ośli - asinin
ośmioraki - octuple
osmotyczny - osmotic
osoba - persona
ostateczny - conclusive, definitive, final, peremptori, probante, terminal, ultimate; ultimate
ostentacja - ostentation, fasto
ostentacyjny - fastose, ostentatiose
ostrosłup - pyramide
ostrożny - avisate, circumspecte, caute
ostry - argute; acuminate
ostryga - ostrea
ostrzeżenie - admonestation, admonition, advertimento
ostrzyć - acuminar, acutiar, affilar
oświadczać - allegar
oszczep - lancea
oszukiwać - captar, deluder, dupar; deciper
oszust - deceptor, dupator, fraudator
otaczać - circumferer, ambir
otwarcie - apertemente
otwarty - aperite, aperte
otwór - apertura, apertura, foramine
otyłość - adiposis, adipositate
ów - aquelle
owies - avena
ozdoba - adornamento
ozdobny - ornamental, decorative
ozon - ozono
pachnący - redolente, fragrante, odorose, odorifere, odorante
pacyfikacja - appaciamento, pacification
padać - faller
paginacja - pagination
paginować - paginar
pagoda - pagoda
pająk - aranea
pakt - pacto
palenie - adustion
paleolit - paleolitho
paleolityczny - paleolithic
Palermo - Palermo
Palestyna - Palestina
palić - adurer
pallad - palladio
pancernik - cuirassato
panda - panda; panda
pandemia - pandemia
panna - senioretta
panorama - panorama
panoramiczny - panoramic
pan - soverano
papieros - cigarretta
papierośnica - cigarriera
papieski - papal
paproć - filice
papuga - papagai, psittaco
parabola - parabola; parabola
Paragwaj - Paraguay
paraplegia - paraplegia
parasol - parapluvia, parasol
parking - autoparco, parcatorio
parkowanie - parcamento, parcage
Parma - Parma
parodia - parodia
parytet - paritate
pasażer - passagero
pasieka - apiario
pasożyt - parasito
pasterz - pastor
pasza - pasha; forrage, pastura
pasztet - pastata, pastisso
patio - patio
pat - pat
patronimiczny - patronymic
Paweł - Paulo
pawian - babuin
paw - pavon
październik - octobre
paznokieć - clavo
pchła - pulice
pedagogika - pedagogia
pedant - pedante
pederasta - pederasta
pederastia - pederastia
pejoratywny - pejorative
Pekin - Peking
pensjonat - pensionato
perfekcyjnie - perfectemente
perforator - perforator
perfumeria - perfumeria
periodyk - periodico
perła - perla
perliczka - pintada
Persja - Persia
perski - perse, persian
Peru - Peruvia
peryskop - periscopio
pętla - ansa
piasek - sablo
piaskowy - arenari
piąta kolumna - quinte columna
piątek - venerdi
pić - potar
pięciokąt - pentagono
Pięcioksiąg - pentateucho
pieczęć - sigillo
pięknie - bellemente
piękno - beltate
pielęgniarka - infirmera
pielgrzymka - peregrinage
pieluszka - panno
piemoncki - pedemontese
pieprzny - piperate
pierdzieć - peder
pierścionek - anulo
pies - can
pięść - pugno
pieśń - canto
pies obronny - can de guarda
pigwa - cydonia
pijak - dipsomano
piła - serra
piłka nożna - football
pingwin - pinguin
pionowo - verticalmente
pióro - penna, pluma
piosenka - canto
Piotr - Petro
piramidalny - pyramidal
pirat - pirata
pistacja - pistacia
piwiarnia - bireria
piwnica - cellario
piwo - bira
pizza - pizza
plądrować - despoliar
płakać - lacrimar, plorar, luger
plakat - placard
planetarium - planetario
planista - planator
planowanie - planification
płatek - petalo
Platon - Platon
płaz - amphibio
plebiscyt - plebiscito
plotka - rumor
pluć - sputar
pług - aratro
pluskwa - cimice
płynny - liquide; fluide
pochodzenie - lineage, ancestria, ascendentia
poczwarka - chrysalide
podatek - imposto
podbój - conquesta
podciśnienie - subpression
poddasze - subtecto
poddźwiękowy - subsonic
podłość - bassessa, ignobilitate; ignominia
podniebienie - palato
podnieta - incentivo
podnosić - altiar
podrabianie - contrafaction, adulteration
podstawa - basamento
podstawowy - basal
podświadomie - subconscientemente
poduszka - cossino
podwójny - duple
podwyższać - altiar
podzielony - dividite, divise
poeta - poeta
poetycki - poetic
pointer - pointer
pojawiać się - apparer
pojedynczy - singule, simplice
pokaz - gala
pokrzywa - urtica
pokutnik - penitente
pole - agro
Polinezja - Polynesia
polio - polio
polityka - politica
półka - planca
polka - polka
półkula - hemisphera, hemispherio
półnagi - seminude
polo - polo
polowanie - chassa
Polska - Polonia
polski - polac
południe - sud
południowoamerykański - sudmerican
południowy - meridional; austral
Półwysep Bałkański - Peninsula Balcanic
półwysep - peninsula
pomagać - adjutar, adjuvar, auxiliar, coadjuvar, juvar
pomarańczowy - orange
pomidor - tomate
pomoc - adjuta, succurso, adjutor
pompa - pompa
poniedziałek - lunedi
ponton - ponton
popielniczka - cineriera
popołudnie - tarde
poprawiać - corriger, adjustar, affinar
poprawny - correcte
poprzedni - anterior, previe
popularność - popularitate
popularyzacja - popularisation
popularyzować - popularisar
porcja - portion
poronienie - abortamento
porównanie - comparation
porównywać - comparar, commensurar
portfel - cartiera, portafolio
portretować - effigiar
portret - portrait
portugalski - portugese
poruszać - actionar
porwanie - abduction
porządkowy - administrative; ordinal
porzucać - abandonar
posiadać - posseder
pośladek - culo, podice
pośpiech - haste, urgentia
pospolity - trivial, indelicate
postanowienie - adjudication
potajemny - clandestin
potas - potassium, kalium
potaż - potassa
potępiać - disapprobar, blasmar, condemnar; reprobar
potwierdzić - reaffirmar, confirmar, sancir
powieka - palpebra
powiększanie - aggrandimento
powietrze - aer, aere
powietrzny - aeree
powiewać - undear
powodować - causar, ingenerar, occasionar
powódź - alluvion
powtarzać - reiterar, repeter
pożądać - appeter
pożądanie - concupiscentia, anxietate
poza - posa
pożar - incendio
pozór - apparentia
praca - obra
pracodawca - empleator
prądnica - dynamo
pradziad - atavo
pragmatycznie - pragmaticamente
pragnąć - appeter, aspirar
pragnienie - aspiration
prałat - prelato
prawdziwy - authentic, genuin
praworęczny - dexteromane, dextromane
precyzja - precision
predylekcja - predilection
preferować - preferer
prekolumbijski - precolumbian
prekursor - precursor, predecessor
prewencja - prevention
prezent - souvenir
probabilistyczny - probabilistic
problematyczny - problematic
programista - programmator
programować - programmar
programowanie - programmation
prolegomena - prolegomeno
proletariusz - proletario
prolog - prologo
promocja - promotion
propedeutyka - propedeutica
proporcja - proportion
prostokątny - rectangular, rectangule
prostytutka - meretrice
protestantyzm - protestantismo
protokół - protocollo, protocolo, acto
proton - proton
proweniencja - provenientia
pryncypał - principe
prysznic - ducha
przecinek - comma
przeciwastmatyczny - antiasthmatic
przeciwciało - anticorpore
przeciwlotniczy - antiaeree
przeciwny - adverse
przede wszystkim - supertoto
przedni - anterior
przedtem - antea
przedwczoraj - anteheri
przejrzysty - limpide
przeklinać - blasphemar, maledicer, damnar, execrar
przekraczać - contravenir; superpassar, exceder, ultrapassar
przelewać - transvasar
przemysł - industria
przemytnik - contrabandero
przeorysza - abbatessa
przepaść - precipitio, casse
przerywać - abscinder
przesadny - exaggerative, exaggerate
przesadzać - exaggerar
prześladowanie - persecution
przestarzały - antiquate, obsolete
przestawienie - transposition
przestępca - delinquente
przestępczy - delictuose, criminose
przestrzegać - obsequer
przeświadczenie - convincimento
przesyłka - depeche, inviage
przeszukiwanie - perquisition
przewinienie - delicto, demerito
przewód - filo; conducto, tubo
przeznaczenie - destino
przy - apud
przychylny - acquiescente, propitie
przydatność - applicabilitate
przygotowywać - apparar, apprestar
przyjaciółka - amica
przyjaźń - amicitate
przyjaźnić się - amicar se
przyjemność - agradamento
przyjmować - adoptar
przykład - instantia
przymiotnik - adjectivo
przynosić - apportar
przypadek - hasardo
przypisywać - tribuer, ascriber, attribuer
przyprawa - condimento
przysłówek - adverbio
przysłowie - proverbio
przywoływać - adducer
przyznawać - conceder; accordar
przyzwoitka - chaperon
pseudonim - pseudonymo
psi - canin
psychiatra - alienista, psychiatro
psychiatria - alienismo, psychiatria
pszczelarz - apiario, apicultor
pszczoła - ape, apicula
ptak - ave
Ptolemeusz - Ptolemeo
pudel - pudel
pułapka - insidia
punktualny - punctual
purysta - purista
pustelnik - eremo, solitario; eremita
pusty - cave, casse, vacue
pustynia - deserto
pyszny - succulente
pytać - questionar
rabin - rabbin
rabować - despoliar, piratar
rączka - manetta; ansa, corregia, manico
radosny - gaudiose, gai, hilare, exhilarante, allegre
radzić - advertir
rak - cambaro; carcinoma
rasizm - racismo
rasowy - de racia
razem - conjunctemente
recesja - recession
referendum - referendum
reformator - reformator
regiment - regimento; regimento
region - region
regresywny - regressive
reinkarnacja - reincarnation
ręka - mano
reklama - annuncio, publicitate, reclamo, propaganda
rekomendować - recommendar
rekwizyt - requisito
renifer - ren
renowacja - renovation
Ren - Rheno
reporter - reporter
reprodukcja - reproduction
reprymenda - reprimenda, reproche
Republika Czeska - Republica Chec
Republika Federalna Niemiec - Republica Federal de Germania
restauracja - restaurante; restauration
rewers - reverso
rewolucja - revolution
rezeda - reseda
rezolucja - resolution
robotnik - laborator
rocznica - anniversario
rodzaj - genere
rodzimy - indigene, nativo
rój - essame
rok - anno
rok przestępny - anno bissextil
rok świetlny - anno de lumine
rolniczy - agrari, agricole, agricultural
rolnik - agricola, agricultor, cultor
romantyczny - romantic
romb - rhombo
ropa naftowa - petroleo
ropucha - bufon
Rosja - Russia
roślina - planta
rosnąć - crescer
rotacja - rotation
rotor - rotor
rower - bicyclo, bicycletta
rowerowy - bicyclic
rowerzysta - cyclista
równie - equalmente
również - alsi, anque
równina - plana, plateau
równolegle - parallelmente
równoległy - collateral, parallel
rozczarowanie - disillusion, anticlimax
rozdzielać - disaggregar, disarticular, disassociar, scinder, separar, secerner; repartir; apportionar, disjunger, disponer
rozgałęzienie - arborisation, arborescentia
rozmowny - garrule, multiloque, multiloquente
rozmyślać - cogitar
różniczkowalny - differentiabile, derivabile
różowy - rosate, rosee
rozpacz - despero
rozrywka - divertimento, amusamento, intertenimento
rozsądny - judiciose, prudente, prudential, avisate, rationabile, consiliabile
rozszerzanie - aggrandimento
rozumieć - apprehender, comprehender
rozwaga - sagacitate, circumspection, prudentia
rubel - rublo
rubid - rubidium
rubin - carbunculo
ruch - movimento
ruchomy - cinesthetic, cinetic, locomotive, locomotor; movibile, rolante, mobile
Rumunia - Romania
rurociąg - conducto
ruten - ruthenium
ryba - pisce
rybny - piscose
rycerski - cavallerose
rycerz - cavaliero
rycina - gravure
rymować - rimar
rywalizacja - rivalitate
rządzić - governar
rzecz - cosa
rzeczny - fluvial, fluviatile
rzemieślnik - artisano, artifice
rzemiosło - artisaneria; mestiero
rzęsa - cilio
rzeź - massacro
rzeźnia - macello
rzeżucha - cresson
Rzym - Roma
sabotaż - sabotage
Sahara - Sahara
salamandra - salamandra
saldo - saldo
Salomon - Salomon
salon - salon
salto - salto
Salwador - El Salvador
samochód - auto, automobile, carro
samolot - avion
samotny - solitari, singule, recluse
satelita - satellite
scenarzysta - inscenator
scenografia - scenographia
schowek - celario
schronienie - albergamento, asylo
schronisko - asylo
ściana - muro, pariete
ścięgno - ligamento, tendine
ściemniać - annoctar
ściskać - accollar
Scylla - Scylla
sękaty - nodose
sekciarski - sectari
sekunda - secunda
seledynowy - aquamarin
selen - selenium
semicki - semitic
Semita - semita
senator - senator
Senegal - Senegal
sen - somno
sęp - vulture
Serbia - Serbia
serum - sero
Seszele - Seychelles
siać - seminar
siatkówka - retina
siedmioraki - septuple
sierpień - augusto
sierść - pilo
się - se
siła - fortitudo; fortitude, robore
Silesia - Silesia
Singapur - Singapur
sinolog - sinologo
siostra - soror
skałoczep - patella
skamieniałość - fossile
skand - scandium
Skandynawia - Scandinavia
skandynawski - scandinave
skąpy - avaritiose; exigue
składnik - ingrediente
sklep - boteca
skłonny - alacre
skomplikowany - complicate; complicate
skończony - finite
skowronek - aloda
skroń - tempora
skrót - abbreviato
skrucha - penitentia
skryba - scriba
skrzynia - coffro
skrzypce - violino
skrzyżowanie - cruciamento
skutecznie - efficacemente
skuteczny - efficiente, efficace, effective, operante
słaby - adyname, adynamic
ślad - vestigio
śląski - silesian
sławny - celebre
ślepy - ceco
ślicznie - bellemente
ślimak - limace
ślina - saliva
słonecznik - heliantho
słoń - elephante
słonina - lardo
słony - salin, salate; salate
Słowacja - Slovachia
słowacki - slovac
słowiański - slave, slavon
słownik - dictionario
słowo - parola &lt;!-- '''1''' vocabulo, '''4''' verbo --&gt;
słuchać - ascoltar
słuchanie - audita, ascoltamento
smaczny - gustabile, delicate
smętny - dolorose
smok - dracon
smolny - piciose
smutny - desolate, elegiac, luctuose, lugubre
śniadanie - jentaculo
śnieg - nive
śnieżyć - nivar
snob - snob
sobota - sabbato
socjalizm - socialismo
socjologia - sociologia
socjologiczny - sociologic
soczysty - succose, succulente
sód - sodium, natrium
sokół - falcon
Sokrates - Socrates
sok - succo
solić - salar
solidarność - solidaritate
somnambulik - somnambulo
sopranistka - sopranista
sosjerka - sauciera
sos - sauce
spać - dormir, addormite
spacer - promenada, ambulatura
spaghetti - spaghetti
Sparta - Sparta
spekulant - agiotator
sperma - sperma
śpiący - somnolente
spichrz - granario
śpiewać - cantar
spisek - complot; conjuration
spodziewać się - expectar
spojówka - conjunctiva
spojrzenie - reguardo
spółdzielnia - cooperativa
sponsor - sponsor
spór - contention, contestation, controversia
sportowy - sportive
sport - sport
sposób - guisa
spotkanie - appunctamento
spowiednik - penitentiero, confessor
sprawiedliwie - justemente
sprawiedliwość - justitia
sprężyna - resorto
sprzeciwiać się - adversar, antagonisar
sprzeczać się - altercar, arguer
sprzyjać - fomentar
sprzymierzeniec - alliato
sputnik - sputnik
srebrny - argentee
srebro - argento
średniowieczny - medieval
Sri Lanka - Sri Lanka
środa - mercuridi
środek - centro
środowiskowy - ambiental
ssak - mammal
stadion - stadio
stagnacja - stagnation
stal - aciero
Stany Zjednoczone Ameryki - Statos Unite de America
Stany Zjednoczone - Statos Unite, Statos Unite de America
starożytność - ancianitate
staw - articulation
stęchlizna - mucor
stereotyp - stereotypo
stolica - capital
stop - alligato
stosować - applicar
stosowny - apte, decorose, expediente, pertinente
stożek - cono
strach - angustia
strajk - exopero
straszny - apprehensive
strateg - stratego
strofować - admoner, admonestar
strój - cotta
struktura - structura
struś - struthio
strychnina - strychnina
strzała - sagitta
studio - studio
studiować - studer
styczeń - januario
subsydium - subsidio
subtelność - subtilitate, finessa
subwencja - subvention
suchy - aride
sufler - sufflator
sułtanat - sultanato
suma - aggregato
sumienie - conscientia
sumować - additionar; aggregar
suponować - supponer
supremacja - suprematia, dominantia
świadomie - consciemente, conscientemente
światło - luce
świątynia - templo
świeca - candela
świecznik - candelabro, candeliero
świnia - porco
świński - porcin
Syberia - Sibiria
sybiliński - sibyllin
Sycylia - Sicilia
syjonizm - sionismo
syn - filio
synonimiczny - synonymic, synonyme
syntetyczny - synthetic
Syria - Syria
syrop - sirop
syryjski - syriac
systematyczny - systematic
szabla - sabla, sabra
szach - chac; chaco
szachista - chachista
szachownica - chachiera
szacunek - estimation, deferentia, respecto, veneration
szakal - chacal
szalej - cicuta
szaleństwo - phrenesia; insanitate
szantaż - chantage
szary - gris
szczegółowy - detaliate, minutiose, minute
szczekać - latrar
szczekanie - latrato
szczepionka - vaccino
szczery - candide
szczotka - brossa
szczur - ratto , ratta
szczyt - summitate
sześcian - cubo
sześcioraki - sextuple
szewc - scarpero
szezlong - chaise longue
szkielet - skeleto
Szkocja - Scotia
szmugiel - contrabando
sznur - linea |linea
szparag - asparago
szron - pruina
sztuczny - affectate
szuflada - tiratorio
szukać - perquirer
Szwajcaria - Suissa, Switza
Szwecja - Svedia
Szwed - svedo
szwedzki - svede
szybko - precipitatemente
szydełko - crochet
szydełkować - crochetar
szyja - collo
szympans - chimpanze
szyszka - cono
tabela - tabella
tabu - tabu
tajemniczy - tenebrose
Tajlandia - Thailandia
tak - si
talizman - talisman
tamten - aquelle
tancerz - dansator
tańczyć - dansar
tangens - tangente
taniec - dansa
tani - vil
tank - tank
Tanzania - Tanzania
tapeta - tapis
tautologia - tautologia
tchórzostwo - coardia
technet - technetium
technik - technico
technokracja - technocratia
technokrata - technocrate
technokratyczny - technocratic
tęczówka - iris
tekst - texto
telegraficzny - telegraphic
telegrafista - telegraphista
teleskop - telescopio, telescopo
temat - thema
temperatura - temperatura
tendencyjny - tendentiose
tenis - tennis
teologia - theologia
teologiczny - theologic
terapia - therapia, curamento
teratologia - teratologia
terier - terrier
terminator - apprentisse
terminologia - terminologia
termometr - thermometro
terytorialny - territorial
teściowa - matre affin
teść - patre affin
tęsknić - aspirar
tęsknota - aspiration
tęskny - appetente
testament - testamento
test - test
tetrarcha - tetrarcha
tezaurus - thesauro
tezauryzować - thesaurisar
Timor Wschodni - Timor Oriental
tkanie - textura
tlen - oxygeno
tłumacz - interprete; traductor
tłusty - adipose
to - aquello, aquesto
toksyczny - venenose, virose
tolerancja - tolerantia, toleration
tonsura - tonsura
topnieć - disgelar
torf - turfa
totalitaryzm - totalitarismo
trąbka - trompetta
tragedia - tragedia
tragiczny - tragic
transcendentalny - transcendental
transmisja - transmission
tratować - calcar, fullar
trawnik - gazon
tren - cauda, traino
trias - trias
trojaki - triplice, triple
Troja - Troia
Trójprzymierze - Triple Alliantia
tron - throno
trud - arduitate
trudny - ardue, difficile; intricate
trumna - feretro
truskawka - fraga; fraga
truteń - bombo
trwałość - durabilitate, constantia
trybula - cerefolio
trzęsienie ziemi - seismo
trzustka - pancreas
tu - hic, iste loco
tulipan - tulipan
tunel - tunnel
turysta - tourista
tybetański - tibetan
tyć - ingrassiar
tydzień - septimana
tyfus - typho
tygrysica - tigressa
tygrys - tigre
typografia - typographia
typ - typo
tytan - titanium
ubezpieczenie - assecurantia
ubogi - impecuniose
uchodźca - refugiato, fugitivo
uciekać - escappar, discampar, fugir; evader
uczciwy - eque, honeste, sincer
uczeń - alumno, apprentisse
uczucie - affecto
uczyć - docer, erudir, inseniar, instruer, professar, regentar; apprender
ugrofiński - finnougrian
ukazywać - apparer
układ - arrangiamento
ul - apiculario
ulica - strata
ultimatum - ultimato
umieszczać - collocar, implaciar, locar, situar
umowa - pacto
umysł - mente
umyślnie - deliberatemente
umysłowy - mental
Unia Europejska - Union Europee
unieważnienie - abolimento
unikatowy - unic
uniwersalny - universal
upadek - fallimento
upał - canicula
uprzejmy - affabile, amabile, amicabile
Uran - Urano
urlop - congedo, commeato
uroczystość - celebration, festino, festivitate, pompa
USA - SUA
uspokajać - appaciar
ustny - buccal, oral, verbal
usuwać - amover
utopia - utopia
utopista - utopista
utrzymywać - allegar
utylitarny - utilitari
uwaga - advertentia, advertimento
uważny - advertente
uwertura - overtura
wagon - wagon, carro
walczyć - battaliar, contender, guerrear, propugnar, pugnar
Walia - Galles
walka - combatto
waluta - valuta
wampir - vampir
wanad - vanadium
warga - labio
wariancja - variantia
warkocz - tressa
wartościowy - valorose, preciose
wątpić - questionar
wątpliwy - dubitabile, dubitative, dubitose, insecur
wątroba - hepate, ficato
Watykan - Vaticano
wąż - angue
wchodzić - ascender
wcześnie - anteriormente
wczoraj - heri
wegetariański - vegetarian
węgiel brunatny - lignite
węgiel - carbon
Węgier - hungaro
Węgierka - hungara
węglan - carbonato
węgorz - anguilla
Węgry - Hungaria
wehikuł - vehiculo
wejście - adito
Wenecja - Venetia
wenecki - venetian, veneteveneto
Wenezuela - Venezuela
Wenus - Venere
Wergiliusz - Vergilio
wersja - version
Westfalia - Westfalia
wesz - pediculo
weterynarz - veterinario
weto - veto
wewnątrzmaciczny - intrauterin
Wezuwiusz - Vesuvio
wiadomość - aviso, depeche
wiadro - situla
wiarygodność - credibilitate
widelec - furca, furchetta
widoczny - apparente
widz - spectator
więc - alora
wieczność - eternitate
wieczny - sempiterne, perenne
wieczorny - vesperal
wieczór - vespere
Wiedeń - Vienna
wiejski - rustic, villan, campestre
wiek - seculo
większość - grosso, majoritate
wielbłąd - camelo
Wielka Brytania - Grande Britannia
Wielka Niedźwiedzica - Ursa Major
Wielkanoc - Pascha
Wielki Piątek - Venerdi Sancte
wielkość - amplitude
wielojęzyczny - multilingual, multilingue, multilinguistic, plurilingual, polyglotte
wielokomórkowy - multicellular
wieloryb - balena
wierzba - salice
wierzchołek - summitate, apice
wieś - campania, village
Wietnam - Vietnam
wieża - turre
więzienie - prision
więzień - prisionero, convicto
wigor - brio
Wikipedia - Wikipedia
Wikisłownik - Wiktionario
wilk - lupo
wilkołak - lycanthropo
winnica - vinia
winny - culpabile; vinari
winogrono - uva
winorośl - vite
wiolonczela - violoncello
wiosło - remo
wiosna - primavera
wirowanie - centrifugation
właściciel - possessor
właściwy - apposite
właśnie - exactemente
własny - proprie
włóczęga - vagabundo
włos - capillo, villo
włoski - italian
wnuk - nepto
wódka - vodka
wodny - aquatic, aquatile, aquee
wodolot - hydrofoil, hydroplano
wodór - hydrogeno
wodospad - cascada
wojna - guerra, bello
wojna religijna - guerra religiose
wojskowy - bellicista
wola - voluntate
wół - bove, bovello
wolfram - wolfram
Wołga - Volga
wolicjonalny - volitive
wolnomularz - mason
wolność - libertate
wóz - cochi, carretta, carro
wózek - carretta
woźnica - cochiero
wpędzać - figer
wpływać - affectar, afficer, influentiar, influer
wrażenie - impression
wrażliwość - affectibilitate
wrażliwy - affectabile, affectibile
wreszcie - finalmente
wrotycz - balsamita
wróżbiarz - divino
wrzesień - septembre
wrzos - erica
wrzosowisko - landa
wschodni - oriental
wschodzić - germinar
wścieklizna - rabie
wskazywać - indicar
wspaniały - admirabile
współczesny - contemporanee
współczuć - commiserar, condoler
współzawodnictwo - competion
wstępny - preliminar, liminar, exordial, initiative
wstyd - vergonia
wstydzić się - vergoniar
wtedy - alora
wtorek - martedi
wtrącać - interloquer; ingerer, intruder, interponer
wujek - oncle
wulkaniczny - volcanic, vulcanic
wulkan - vulcano
Wybrzeże kość Kości Słoniowej - Costa de Ebore
wybrzeże - litore, costa
wychudzony - emaciate
wyciąg - abstrakt
wycieczka - excursion
wydawać - erogar
wygląd - apparentia
wyjaśnianie - clarification, acclaramento
wyjście - exito, sortita
wykałaczka - mundadentes
wykonalny - agibile
wykrywacz kłamstw - detector de mentitas
wykształcony - culte, cultivate, educate, erudite, litterate, scholarisate
wyłącznie - exclusivemente, solmente
wymachiwanie - brandimento
wymiana - excambio
wymieniać - excambiar
wymienny - intercambiabile, permutabile
wymowa - pronunciation
wynagrodzenie - gage; remuneration
wynosić - amontar
wyobrażać sobie - imaginar se
wypalać - cauterisar
wyposażenie - equipamento
wyprzedzać - anticipar
wypukły - convexe
wysiłek - arduitate, effortio, fatiga
wyśmienicie - excellentemente
wysokość - altessa, altor, altura
wyspa - insula
Wyspa Świętego Wyspy Świętego Tomasza i Wyspa Książęca - São Tomé e Príncipe
Wyspy Kanaryjskie - Canarias, Insulas Canarias, Insulas Canari
wystarczać - sufficer, bastar
wystawa - exhibition
wytrwałość - perseverantia, tenacitate
wywiad - abuccamento
wywijanie - brandimento
wyznaczenie - nomination
wyższość - superioritate, predomination
wzniesienie - altura
wzrost - augmento; accrescimento
żaba - rana
zabawa - distraction, intertenimento
ząbek - denticulo
zabójca - assassinator
zabór - annexion
zachodni - occidental
zachowanie - comportamento
zaczynać - inciper
żądło - aculeo
zadowolony - contente, complacente, satisfacite
zagłada - extermination
zagraniczny - extere, estranier
zainteresowania - incursion, interesse
zainteresowanie - incursion, interesse
zając - lepore
zajadły - rancorose
zakaz - interdicto, interdiction
zakochany - inamorate
zakonnik - cenobita, monacho
zakrystia - sacristia
załącznik - annexo, appendice, attaccamento
zalesiać - forestar
zależność - dependentia
żałobny - obituari, elegiac; funebre, funerari; lugubre, luctuose, elegiac
zamknąć - clauder
żandarm - gendarme
zapalenie - inflammation
zapałka - flammifero
zapamiętywać - memorisar
zapisywać - inscriber; legar
zapominać - oblidar, disapprender; oblidar, disapprender
zapora - dica, barrage
zapowiadać - annunciar
zarabiać - lucrar
Zaratusztra - Zoroastre
zaratusztrianizm - zoroastrismo
żargon - jargon
zarozumialstwo - vangloria
żartować - burlar, scherzar
zasada - alcalino; alcali
zasłużony - emerite, meritose, condigne
zasnąć - addormir se
zatoka - baia, golfo
zawartość - contento
zawiadomienie - advertimento
zawieszać - appender
zawieszenie broni - tregua, armistitio
zawód - anticlimax
zawrotny - vertiginose
zazdrosny - invidiose, invide, zelose, jelose
zazwyczaj - solitemente
zbędny - dispensabile
zbierać - assemblar
zbiór - conjuncto
zbliżać - approchar, approximar
zbroić - artillar
zdolny - capabile, capace
zdrowieć - refacer, se resanar
zdrowotny - curative
żebrak - mendicante, mendico
zebra - zebra
zebu - zebu
żeglarz - nauta
żelatyna - gelatina
zelota - zelote; zelote
zelotyzm - zelotismo
zemsta - vengiantia
zenit - zenit
że - que
zeszyt - fasciculo, quaderno
zgadzać - accordar, acquiescer
zginąć - cader
zgniły - putride, infecte; corrupte
zgodny - accordante
z góry - anticipatemente
zielony - verde
ziemniak - patata
zima - hiberno
zimorodek - martin piscator
zimowy - hibernal
złodziej - fur
złoty - zloty
zmartwienie - enoio, affliction
zmęczony - lasse, fatigate, fatigabile
zmiana - alteration
zmieniać - alternar
zmierzch - crepusculo
zmysłowy - sensori; voluptuose, voluptuari
znieważanie - affrontamento
zniszczenie - annihilation, annulation
znosić - annullar
znowu - altere vice
Zofia - Sophia
żołądek - stomacho
żołnierz - combattente
żółty - jalne
zoologia - zoologia
zoo - zoo
źródło - fonte
źródłosłów - etymo, radicula
zrozumienie - apprehensibilitate, apprehension; comprehension
żuć - masticar
żuraw - cabestan
żurawina - oxycocco
zwiastować - portender
związek - affinitate
Związek Radziecki - Union Sovietic
zwierzę - animal, bestia
zwłoki - cadavere
zwolennik - adherente, partisano, partitario
zwoływać - advocar
zwrotnik - tropico
zwycięstwo - victoria, vincimento
zwycięzca - victor
zwyczajny - consuete, consuetudinari
żydowski - judee
żyła - venna
żyletka - rasorio
żyroskop - gyroscopio
żyto - secale
żywokost - consolida
