AA - AA
Aaron - Аарон
abaja - абайя
abakus - абак
abalienacja - отчуждение
abazja - абазия
abażurek - абажурчик
abażur - абажур|абажу́р
abchaski - абхазский; абхазский
Abchazja - Абхазия
Abchazka - абхазка
Abchaz - абхаз , абхазец
abdest - вуду
abdominoplastyka - абдоминопластика
abduktor - абдуктор
abdykacja - отречение , абдикация
abdykować - отрекаться, отказываться, абдиковать
abecadło - абецадло; азбука
Abel - Авель
aberracja - аберрация
aberracyjny - аберрационный
abidżański - абиджанский
Abidżan - Абиджан
abiogeneza - абиогенез
abiogenny - абиогенный
abiturient - абитуриент , выпускник
ablaktacja - аблактировка
ablatyw - аблатив , исходный падеж , отложительный падеж
ablutofobia - аблютофобия
abonamentowy - абонементный
abonament - абонемент
abonent - абонент
aborcja - аборт
abordaż - абордаж
aborygen - абориген
Abraham - Абрам
abrazja - абразия
abrewiatura - аббревиатура , абревиатура
Abruzja - Абруццо
abruzyjski - абруццкий
absces - абсцесс
absolucja - абсолюция
absolutny - абсолютный, совершенный, полный
absolutyzm - абсолютизм
absolut - абсолют
absolwent - выпускник
absorbat - абсорбат , абсорбтив
absorbent - абсорбент
absorber - абсорбер
absorpcja - абсорбция , поглощение , впитывание ; абсорбция
abstrahować - абстрагировать; абстрагировать, опускать
abstrakcjonizm - абстракционизм
abstrakcyjny - абстрактный
abstynencja - абстиненция
abstynent - абстинент , непьющий , трезвенник ; абстинент
absurd - абсурд
abszytować - абшитовать
abszyt - абшид
ABS - АБС
Abudża - Абуджа
Abu Zabi - Абу-Даби
Abwehra - Абвер
acefalia - ацефалия
acetamid - ацетамид
acetofenon - ацетофенон , метилфенилкетон
aceton - ацетон
acetylen - ацетилен
achondryt - ахондрит
ach - ах
aczkolwiek - хотя, хоть
adadżio - адажио
adamaszek - дамаск
adamsyt - адамсит , DM
Adam - Адам
adapter - звукосниматель ; проигрыватель , проигрыватель пластинок ; адаптер
adaptować - приспособлять; адаптироваться; адаптировать
Addis Abeba - Аддис-Абеба
adekwatność - адекватность
Adelajda - Адэлайда; Аделаида
Adelina - Аделина
adiabata - адиабата
adipocyt - адипоцит
administrator - администратор
admin - админ
admirał - адмирал ; адмирал
Adolf - Адольф
Adonis - Адонис
adrenalina - адреналин
adresat - адресат ; адресат
adres - адрес
Adriatyk - Адриатика
adwent - адвент
adwokat diabła - адвокат дьявола
adwokat - адвокат
aerodrom - аэродром
aerodynamika - аэродинамика
aerofagia - аэрофагия
aerofobia - аэрофобия
aeroplan - аэроплан
afazja - афазия
afera - афера , афёра
afereza - аферез ; афереза
aferzysta - аферист
Afgańczyk - афганец
Afganistan - Афганистан
Afganka - афганка
afiks - аффикс
afisz - афиша|афи́ша
Afrodyta - Афродита
afrodyzjak - афродизиак
afrykanerski - африкаанс
Afryka - Африка
agawa - агава
agenda - отделение , филиал
agent - агент
agitator - агитатор; мешалка
agnostycyzm - агностицизм
agonia - агония
agorafobia - агорафобия
agrafka - булавка
agregat - агрегат
agresor - агрессор ; агрессор
agrest - крыжовник
agronomia - агрономия
agronom - агроном
Agrypina - Агриппина
AIDS - СПИД
aikido - айкидо
ailurofobia - айлурофобия
akacja - акация
akademia - академия
akalkulia - акалькулия
akanie - аканье
akcent - ударение|ударе́ние
akceptować - одобрять
akcja - акция
akompaniament - аккомпанемент
akordeonista - аккордеонист , баянист
akordeon - аккордеон, гармонь
akord - аккорд
Akra - Аккра
akrofobia - акрофобия
aksamit - бархат
aksjomat - аксиома
aktorka - актриса
aktor - актёр
aktyn - актиний
aktywować - активизировать
akt - акт ; ню
akumulatorek - аккумуляторный|аккумуляторная батарейка
akumulator samochodowy - автоаккумулятор
akumulator - аккумулятор
akupresura - акупрессура
akupunktura - акупунктура
akuszerka - акушерка
akwarela - акварель
akwarium - аквариум
akwatinta - акватинта
akwedukt - акведук
Akwizgran - Ахен
AK - Автомат Калашникова
alarm - сигнал бедствия; тревога
Alaska - Аляска
Albańczyk - албанец
Albania - Албания
albański - албанский
Alberta - Альберта
albinizm - альбинизм
albit - альбит
albo - или
albuminuria - альбуминурия
album - альбом , магнитальбом
alegoria - аллегория
aleja - проспект , аллея
alembik - перегонный куб , алембик
alergen - аллерген
alergia - аллергия
alergik - аллергик
alergologia - аллергология
ale - но , однако
alfabet - алфавит , азбука , ''alfabet łaciński:'' латиница
alfa - альфа
algierczyk - алжирец
Algierczyk - алжирец
Algieria - Алжир
algierka - алжирка
Algierka - алжирка
algierski - алжирский
Algier - Алжир
algofobia - алгофобия
algolagnia - алголагния
algorytm - алгоритм
alibi - алиби
Alicja - Алиса
aligator - аллигатор
alimenty - алименты
aliteracja - аллитерация
alkan - алкан
alken - алкен
alkin - алкин
alkoholiczka - алкоголичка
alkoholik - алкоголик
alkoholizm - алкоголизм
alkoholowy - алкогольный, спиртной
alkohol - алкоголь , спирт
alkowa - альков
Allah - Аллах
allopurinol - аллопуринол
Alojzy - Алоиз
alpaka - альпака ; альпака
alpinista - альпинист
Alpy - Альпы
altana - беседка
alternator - альтернатор
altówka - альт
altruista - альтруист
altruizm - альтруизм
alt - альт
aluzja - намёк , аллюзия
Alwernia - Альверня
amator - любитель ; любитель
Amazonka - Амазонка
ambasada - посольство
ambasador - посол
ambiwalentny - амбивалентный
ambona - амвон|амво́н ; лабаз|лаба́з , полати|пола́ти
ambulans - амбуланс
ambulatoryjny - амбулаторный
ameba - амёба
Ameryka Łacińska - Латинская Америка
Amerykanin - американец
amerykanizacja - американизация
Amerykanka - американка
amerykański - американский; американский
Ameryka Północna - Северная Америка
Ameryka Południowa - Южная Америка
Ameryka Środkowa - Центральная Америка
Ameryka - Америка ; Америка
ameryk - америций
amfetamina - амфетамин
amfibia - амфибия
amfora - амфора
Amman - Амман
amnestia - амнистия
amnezja - амнезия
amoniak - аммиак
amonit - аммонит
amperomierz - амметр , амперметр
ampułka - ампула
amputacja - ампутация
amputować - ампутировать, отнять
Amu-daria - Амударья
amulet - амулет
amunicja - боеприпасы
anafilaksja - анафилаксия
anagogiczny - анагогический
analfabeta - безграмонтный , неграмотный
analityczny - аналитический
analiza - анализ
analogiczny - аналогичный, подобный
anamneza - анамнез
ananas - ананас ; ананас
anarchista - анархист
anarchistyczny - анархистский
anarchizm - анархизм
Anastazja - Анастасия
anatomia - анатомия
anatomiczny - анатомический
anatom - анатом
Andora - Андорра
Andromeda - Андромеда; Андромеда
Andrychów - Андрыхув
Andrzej - Андрей
Andy - Анды
anegdota - анекдот
aneksja - аннексия
anestezjolog - наркотизатор , анестезиолог
anewryzm - аневризма
Angielka - англичанка
angielski - английский; английский
angina - ангина
angiografia - ангиография
angiologia - ангиология
Anglia - Англия
Anglik - англичанин
Angola - Ангола
angstrem - ангстрем
anhedonia - ангедония
anilina - анилин
anioł stróż - Ангел-Хранитель
anioł - ангел
ani - ни
Ankara - Анкара
ankieta - анкета
annabergit - анабергит
Annopol - Аннополь
anoda - анод
anodowanie - анодирование
anodyzacja - анодирование
anoreksja - анорексия
antagonizm - антагонизм
Antananarywa - Антананариву
Antares - Антарес
Antarktyda - Антарктида|Антаркти́да
antena - антенна
Antigua i Barbuda - Антигуа и Барбуда
antonim - антоним
Antonina - Антонина
Antoni - Антон
antrakt - антракт
antropofobia - антропофобия
antropologia - антропология
antropologiczny - антропологический
antropolog - антрополог
antropo- - антропо-
Antwerpia - Антверпен
antybiogram - антибиотикограмма
antybiotyk - антибиотик
antybohater - Антигерой
antygen - антиген
antyklerykalny - антиклерикальный
antykwa - антиква
Antyle Holenderskie - Нидерландские Антильские острова
antymateria - антивещество|антивещество́
antymilitarystyczny - антимилитаристский
antymon - сурьма
antypatia - антипатия
antyperspirant - антиперспирант
antysemita - антисемит
antysemityzm - антисемитизм
antyseptyczny - антисептический
anyż - анис
aorta - аорта
aparat fotograficzny - фотоаппарат
apartament - апартамент
apaszka - косынка
apatia - апатия
apatryda - апатрид
Apeniny - Апеннинские горы, Апеннины
apertura - апертура
apetyt rośnie w miarę jedzenia - аппетит приходит во время еды
apetyt - аппетит
Apia - Апиа
aplikacja - прикладное программное обеспечение , программное обеспечение , прикладное ПО ; стажировка , практика
aplikator - аппликатор
Apollo - Аполлон; Аполлон
apologeta - апологет
apoptoza - апоптоз
appendektomia - аппэндэктомия
apsyda - апсида
aptekarz - аптекарь
apteka - аптека
Arabia Saudyjska - Саудовская Аравия|Сау́довская Ара́вия
arabski - арабский
Arab - араб
arachnofobia - арахнофобия
aramejski - арамейский арамейский
arbuz - арбуз ; арбуз
archaiczny - архаичный
archanioł - архангел
archeologia - археология
archeo- - архео-
Archimedes - Архимед
architektoniczny - архитектурный
architektura - архитектура
architekt - архитектор
arcybiskup - архиепископ
arcydzieło - шедевр
arena - арена
areszt - арест
Argentyna - Аргентина
argon - аргон
argument - аргумент
aria - ария
Arizona - Аризона
Arkadiusz - Аркадий
Arkady - Аркадий
Arka Noego - Ноев ковчег
Arkansas - Арканзас
arka - ковчег
Arktyka - Арктика
armata - пушка|пу́шка
Armenia - Армения
armia - армия , войско
arsenian - арсенат
arsen - мышьяк
artefakt - артефакт ; артефакт
Artemida - Артемида
arteria - артерия
artykuły gospodarstwa domowego - бытовая техника
artykuł - статья , передовая , передовица ; товар , продукт , изделие ; статья , параграф ; догмат
artyleria - артиллерия
artyleryjski - артиллерийский
artysta - артист , художник
artystyczny - артистический, художественный
Aruba - Аруба
arystokratyczny - аристократический
arytmetyczny - арифметический
arytmetyka - арифметика
asfalt - асфальт
asortyment - ассортимент
aspiryna - аспирин
astat - астатин
asteroida - астероид
astmatyk - астматик
astma - астма
astronauta - астронавт
astronautyka - астронавтика
astronomia - астрономия
astronomiczny - астрономический
asymetryczny - асимметрический
asymptota - асимптота
Asyria - Ассирия
as - туз ; туз
atak serca - инфаркт миокарда
atak - атака , нападение ; припадок , приступ ; нападение
atawistyczny - атавистический
atawizm - атавизм
ateista - атеист , безбожник
ateizm - атеизм
atest - сертификат
atlas - атлас
atmosfera - атмосфера
atmosferyczny - атмосферический
atomowy - атомный
atom - атом
atrakcyjność - привлекательность сексуальность
atrium - атриум
atrybut - свойство, атрибут
atto- - атто-
atut - козырь
audycja - передача , радиопередача
audytorium - аудитория
Augustów - Августов
August - Август
aukcja - аукцион
aura - погода ; аура
Aurora - Аврора
Australia - Австралия ; Австралия
Australijczyk - австралиец
Austriaczka - австриячка
Austriak - австриец ; австрияк
Austria - Австрия
autarkia - автаркия
autobiografia - автобиография
autobusowy - автобусный
autobus - автобус
autocenzura - автоцензура
autograf - автограф
autohipnotyczny - автогипнотический
autohipnoza - автогипноз , аутогипноз , самогипноз
autokar - туристический автобус , автокар
autoklaw - автоклав
autokracja - автократия
autokratyzm - автократизм
automat - автомат ; автоматический|автоматическая коробка передач ; стиральная машина-автомат
autonomia - автономия
autonomiczny - автономный
autopsja - аутопсия
autorytatywny - авторитетный
autor - автор
autostrada - автострада , автомагистраль
auto- - авто-
auto - машина , автомашина , автомобиль
autyzm - аутизм
aut - аут
awanport - аванпорт
awantura - авантюра
awanturnik - авантюрист
awanturować się - выступать
awanturyn - авантюрин
awaria - авария
awaryjny - аварийный
awizo - авиз, авизо; авизо
awokado - авокадо|авока́до , аллигаторова груша
Azerbejdżan - Азербайджан
azjatycki - азиатский
Azja - Азия
Azory - Азорские острова
azotan - азотнокислая соль , нитрат
azot - азот
aż - до, даже, прямо-таки; пока, пока не
a - а; а; а
Baba Jaga - Баба-Яга
baba - баба ''f ''
babcia - бабушка
babie lato - лететь|летящие паутина|паутинки , тенёта ; бабье лето
bać się jak ognia - бояться как огня
bać się własnego cienia - бояться собственной тени
bać się - бояться; бояться, беспокоиться
Badenia-Wirtembergia - Баден-Вюртемберг
bagaż - багаж
bagietka - французский багет
bagnet - штык
Bahamy - Багамы
Bahrajn - Бахрейн
bajerować - лапшу на уши вешать, мозги пудрить, втирать очки
Bajkał - Байкал
bajka - сказка
bajkopisarz - баснописец
bajt - байт
bakcyl - бацилла
baklawa - баклава , пахлава
bakłażan - баклажан , синенький
bakteria - бактерия
bakteriobójczy - бактерицидный
bakteriolog - бактериолог
bałagan - беспорядок
bałałajka - балалайка
bałamucić - баламутить
balet - балет ; балет
balkon - балкон
balon - шар
balsamiczny - бальзамический
balsam - бальзам
balustrada - балюстрада
bałwan - снеговик , снежная баба ; идол , истукан ; волна , вал ; болван , чурбан
bal - бал ; брус
bambus - бамбук
banan - банан
bandaż - бинт , повязка , бандаж
banda - малина
bandera - флаг
Bangladesz - Бангладеш
bańka mydlana - мыльный пузырь
bańka - жестянка , бидон , банка ; пузырь ; баллон ; банка
banknot - купюра ; банкнота
bankructwo - банкротство
bankrut - банкрот
bank - банк ; банк
barak - барак
baranina - баранина
barani - бараний
baran - баран ; баран
Baran - Овен ''Ovien''; Овен ''Ovien''
Barbados - Барбадос
barbeta - барбет
bardzo - очень; более, наиболее, больше весь|всего
barka - баржа
barkentyna - баркентина
bark - плечо
barman - бармен
baron - барон
barszcz - борщ
barter - бартер , меновая торговля , товарообмен
barykada - баррикада
bar - бар ; бар ; барий ; бар
basen - бассейн
baśń - сказка
bastion - бастион
baszłyk - башлык
bas - бас
Batman - Бэтмен
batuta - дирижёрская палочка
batyst - батист
bawełna - хлопчатник ; хлопок ; хлопчатобумажный|хлопчатобумажная ткань
bawełniany - хлопчатобумажный
bawić się ptaszkiem - играть с Дунькой Кулаковой
bawić - занимать, забавлять; забавлять
bażanciarnia - фазанья|фаза́нья ферма|фе́рма
bażantarnia - фазанья|фаза́нья ферма|фе́рма
bażant - фазан
bazar - базар , рынок
Bazylea - Базель
beatyfikacja - беатификация
bęben - барабан
becik - конверт
bęcwał - остолоп
beczka - бочка ; бочка
bednarnia - бондарня
bednarski - бондарный
bednarstwo - бондарство
bednarz - бондарь
befsztyk - бифштекс
Belgia - Бельгия
Belize - Белиз
bemol - бемоль
Benin - Бенин , Республика Бенин
benzol - бензол
berdysz - бердыш
beret - берет
Berlin Zachodni - Западный Берлин ''Zapadnyj Berlin''
Berlin - Берлин
Bermudy - Бермуды
beryl - бериллий
beton - бетон|бето́н
bezbożnik - атеист, безбожник
bezbożność - безбожие
bezbożny - безбожный
bezczelny - бессовестный
bezdomny - бездомный; бездомный , бомж , БОМЖ, бродяга
bezinteresowny - бескорыстный
bezlitosny - безжалостный, беспощадный
bezmyślność - легкомыслие , безрассудство , сумасбродство, необдуманность
bezokolicznik - инфинитив
beżowo - бежевый|бежевым цвет|цветом
beżowy - бежевый
bezpieczeństwo - безопасность
bezpiecznik - предохранитель , пробка
bezpieczny - безопасный
bezpośredni - прямой
bez pracy nie ma kołaczy - не попотеешь, не заработаешь
bezrobocie - безработица
bezrobotny - безработный
bezsilny - немощный; бессильный, бессилен
bezwodnik octowy - уксусный ангидрид
bezwonny - без запаха
bez- - без
bez - бузина; сирень ; без
Bhutan - Бутан
biała herbata - белый чай
białko - белок
białoruski - белорусский; белорусский
Białoruś - Беларусь , Белоруссия
biały kruk - уникум ; белая ворона
Białystok - Белосток
biały - белый; белый
Biblia - Библия
bibliotekarz - библиотекарь|библиоте́карь
biblioteka - библиотека
bić - бить; тикать; крыть
Biecz - Беч
biedak - бедняк ; бедняга
bieda z dziećmi, bieda i bez dzieci - дом с детьми - базар, без детей - могила
biedny - бедный
biedronka - божья коровка
biegacz - бегун
biegać - бегать
bieg - бег
Bielsko-Biała - Белско-Бела
Bielsko - Белско
biernik - винительный падеж
bierzmowanie - миропомазание
bigamia - бигамия
bigos - бигос
bikini - бикини
bilet - билет
Biłgoraj - Билгорай
biografia - биография
biograf - биограф
biologia - биология
bioniczny - бионический
biopsja - биопсия
biotechnologia - биотехнология
Birma - Бирма
biskup - епископ
bistro - бистро
bita śmietana - взбитые сливки|взби́тые сли́вки
bitwa - сражение , бой , битва
biurko - письменный стол
biuro podróży - турагентство , туристическое агенство , турбюро
biuro - офис|о́фис
biurwa - блядь на служба|службе
biustonosz - бюстгальтер , лифчик
bizmut - висмут
biznesmen - бизнесмен
blacha - жесть ; противень ; медь
błąd ortograficzny - орфографический|орфографическая ошибка
błąd - ошибка ; ошибка
błagać - умолять|умоля́ть
błahy - ничтожный
blamaż - компрометация
blankiet - бланк
blat - столешница
błazen - шут ; шут , паяц
błędne koło - порочный круг
błękitny - голубой
Bliski Wschód - Ближний Восток
bliski - близкий; сродни; близкий
blisko - близко
blizna - рубец , шрам
Bliźnięta - Близнецы ''Bliznecy''
bloger - блогер
błogosławieństwo - благословение
blog - блог
blondynka - блондинка
błota - болото
błoto - грязь , слякоть
bluszcz - плющ
błyskawica - молния|мо́лния
błysk - мормышка
bóbr - бобр
bobslej - бобслей
bób - боб ; боб
bocian czarny - чёрный аист
bocian - аист
bodajże - будто
bogacz - богач
bogaty - богатый; богатый
bogini - богиня
Bóg pomaga tym, co sami sobie pomagają - на Бога надейся, а сам не плошай
bóg - бог
bohaterstwo - героизм
bohater - герой
bohr - борий
bojaźliwy - боязливый, пугливый
bojaźń - боязнь
boja - буёк
bójka - драка
bojownik - борец
boks - бокс
boleć - болеть
boleściwy - скорбный
Boliwia - Боливия
ból - боль ; боль
bomba lotnicza - авиабомба, авиационная бомба
bombarda - бомбарда
bomba - бомба
bombka - шарик , небольшой|небольшая бомба
bombowiec - бомбардировщик
bom - гик
boraks - бура
bordo - бордо
borowik - боровик , белый гриб
borówka brusznica - брусника
borsuk - барсук
borykać się - бороться
Borys - Борис
bor - бор
bosak - багор
Bośniaczka - боснийка
Bośnia i Hercegowina - Босния и Герцеговина ''Bosnija i Gierciegovina''
Bośniak - босниец
bóstwo - божество
botaniczny - ботанический
botanika - ботаника
botanik - ботаник
Botswana - Республика Ботсвана , Ботсвана
Boże Narodzenie - Рождество
brać - брать; брать; брать; брать; давай
brakować - недоставать
brak - отсутствие , недостаток ; недостаток
bramka - ворота; ворота
bratanek - племянник
bratanica - племянница
bratowa - невестка
Bratysława - Братислава
brat - брат
brązowy - коричневый
Brazylia - Бразилия
Brazylijczyk - бразилец
Brazylijka - бразильянка
brazylijski - бразильский
breja - каша
brew - бровь
brezent - брезент
brnąć - брести
brodacz - бородач
broda - подбородок ; борода
bromowodór - бромоводород
brona - борона
broń biała - холодное оружие
bronić - защищать; защищаться
broń - оружие
broszura - брошюра
brudnopis - черновик
brudny - грязный, запачканый; грязный, пошлый
brud - грязь
brukiew - брюква
Bruksela - Брюссель
brukselka - брюссельская капуста
bruk - булыжник
Brunei - Бруней
brunet - брюнет
brutto - брутто
brydż - бридж
bryg - бриг
Brytyjskie Wyspy Dziewicze - Британские Виргинские острова
brzeg - берег ; край , ребро
Brzeszcze - Бжеще
brzezina - березняк
brzmienie - звук
brzoskwinia - персик
brzoza - берёза
brzuch - живот , брюхо
brzuszek - животик , брюшко
brzydki - некрасивый, уродливый, скверный; плохой, скверный
brzytwa - бритва
Budapeszt - Будапешт
buda - будка|бу́дка; конура|конура́
buddyzm - буддизм
budować zamki na lodzie - строить замки на песке
budować - строить; составлять, быть построенным из +
budowa - стройка ; строительный|строительная площадка , стройка ; строение
budynek - здание
budzić - будить
budzik - будильник
Budziszyn - Баутцен
Bug - Западный Буг
bujać w obłokach - строить воздушные замки , витать в облаках
bujać - болтать; качаться
bujda na resorach - чепуха на постном масле
bukiet - букет
buk - бук
Bułgaria - Болгария
bułgarski - болгарский
bułka - булка
bulwar - бульвар
bunraku - бунраку
bunt - восстание , мятеж ; бунт
burak - свёкла
burdel - публичный дом
Burkina Faso - Буркина Фасо
burmistrz - мэр
bursa - общежитие
bursztyn - янтарь
Burundi - Бурунди
burza w szklance wody - буря в стакане воды
burza - буря
busola - буссоль
bustrofedon - бустрофедон
butan - бутан
butelka - бутылка
butik - бутик
but - сапог , ботинок
być w siódmym niebie - быть на верху блаженства
być - быть
bydło - скот ; скот
byk - бык
Byk - Телец; Телец
Była Jugosłowiańska Republika Macedonii - Бывшая Югославская Республика Македония, ''Byvšaja Jugoslavskaja Riespublika Makiedonija''
bylejakość - небрежность , безответственность , разгильдяйство
bywać - бывать
-by - бы
by - чтобы
bzdura - чушь , глупость
bzyczeć - жужжать
całka - интеграл
całkiem - совсем, вполне, вовсе, совершенно, окончательно; весьма
całkowicie - целиком, совершенно, совсем, вполне, вовсе, окончательно
całodobowo - круглосуточно
całować - целовать; целоваться
cały - целый, весь; весь; целый
capstrzyk - вечерний|вечерняя заря
carat - царизм , самодержавие , царский режим
carski - царский
car - царь
cdn. - продолжение следует
cebula - лук , луковица
cecha - черта , признак , свойство
cechować - характеризовать; характеризоваться
cedr - кедр
ceglastoczerwony - краснокирпичный
ceglasty - кирпичный
cegła - кирпич
cekaem - станковый пулемёт
cekhauz - цейхгауз
cela - камера
cellulitis - целлюлит
cellulit - целлюлит
celnik - таможенник
celny - меткий; таможенный
celofan - целлофан
celownik - прицел ; визир , видоискатель ; дательный падеж
cel uświęca środki - цель оправдывает средства
cel - цель
cement - цемент
cena - цена , стоимость
cennik - прайс-лист ; такса
cenny - ценный
cenotaf - кенотаф
centralny - центральный
centrum - центр , середина
centymetr - сантиметр
cer - церий
cesarskie cięcie - кесарево сечение
cesarski - императорский
cesarzowa - императрица ; императрица
cesarz - император
cewnik - катетер
cez - цезий
chałka - хала , плетёнка
cham - хам
chaotyczny - хаотичный
charakter - характер , природа ; характер
Charków - Харьков
charytatywny - благотворительный
chata - изба ; хата ''''
chcieć - хотеть
chciwość - корыстолюбие|корыстолю́бие , жадность|жа́дность , алчность|а́лчность
chciwy - жадный, ненасытный
chęć - желание , охота , жажда , зуд , аппетит
chemia organiczna - органическая химия
chemia - химия
chemiczny - химический
chemioterapia - химиотерапия
chętnie - охотно, с желанием
Chile - Чили
Chińska Republika Ludowa - Китайская Народная Республика
chiński - китайский
Chiny - Китай
chirurg - хирург
chleb - хлеб
chłodny - прохладный
chłód - холод
chłopiec - мальчик
chłop się nie przeżegna, dopóki piorunu nie usłyszy - гром не грянет – мужик не перекрестится
chlorek sodu - хлорид натрия
chlorek - хлорид
chlorosarin - хлорзарин
chloro- - хлор-
chlor - хлор
chmura - туча , облако
chochla - поварёшка , черпак , половник
chociaż - хотя|хотя́
chodnik - тротуар
chodzić - ходить
chodzi o - дело в
choinka - ёлка , новогодняя ёлка
cholera - холера ; хрен
cholesterol - холестерин
chomik - хомяк
choroba Alzheimera - болезнь Альцгеймера
choroba morska - морская болезнь
choroba Parkinsona - болезнь Паркинсона
choroba von Willebranda - болезнь фон Виллебранда
choroba - болезнь , нездоровье
chorobotwórczość - патогенность
Chorwacja - Хорватия
chorwacki - хорватский
chory - больной; больной
chować - прятать; хоронить; расти
chrapać - храпеть
ChRL - КНР ''KNR''
chrom - хром
chruścik - ручейник, шыцик
chrząstka - хрящ
chrześcijaństwo - христианство
chuj - хуй
chwast - сорняк
chwila - мгновение ; момент
chwytny - хватательный
chytry - хитрый; жадный
ciąć - резать
ciągle - постоянно
ciało - тело
ciamajda - растяпа /, разиня /, лопух , шляпа
ciasteczko - печенье
ciastko - печенье , пирожное
ciasto - тесто ; пирог
ciąża - беременность
cicha woda brzegi rwie - тихая вода берега подмывает
cicho - тихо
cichy - тихий
ciecz - жидкость
cięgno - тяж
ciekawy - я|мне интересно, любопытный; интересный
ciemność - темнота
ciemny - тёмный, чёрный; смуглый
cienki - тонкий
cień - тень ; тень
ciepły - тёплый
cierpieć - страдать; терпеть
ciężarówka - грузовой автомобиль , грузовик
ciężki - тяжёлый , тяжелая , тяжелое , тяжелые
ciężko - тяжело, трудно, с трудом
ciocia - тётка , тётя
cios - удар ; тёсаный камень ; удар ; удар ; бивень|бивни
cipa - пизда
ciśnienie - давление ; артериальное давление
cisza - тишина
ciżba - толпа
cło - пошлина
ćma - ночная бабочка ; тьма
cmentarny - кладбищенский
cmentarzysko - кладбище
cmentarz - кладбище
COBOL - кобол
co dwie głowy, to nie jedna - одна голова - хорошо, а две - лучше
codzienność - повседневность|повседне́вность
cokolwiek - что-нибудь
co nagle, to po diable - делано на спех – сделано на смех; поспешишь – людей насмешишь
córka - дочь
coroczny - ежегодный
cos - cos
coś - что-то
cotygodniowy - еженедельный
co z oczu, to z serca - с глаз долой — из сердца вон
ctg - ctg
cudzoziemiec - иностранец
cudzysłów - кавычки
cudzy - чужой, посторонний
cud - чудо
cukierek - конфета , конфетка
cukiernia - кондитерская
cukiernica - сахарница
cukier puder - сахарная пудра
cukier - углевод; сахар
cukrzyca - диабет
ćwiczenie - упражнение
ćwierćnuta - четвертная нота , четверть
cyberprzestrzeń - киберпространство
cyferblat - циферблат
cyfra - цифра
cyklaminian - цикламат
cyklofosfamid - циклофосфамид
cynamon - корица
cyna - олово
cynk - цинк
cypel - стрелка
cyprofloksacyna - ципрофлоксацин
Cypr - Кипр ''Kipr''
cyranka - чирок-трескунок , чирок , трескунок
cyrkiel - циркуль
Cyrkiel - Циркуль
cyrkon - цирконий
cyrylica - кириллица
cytrusowy - цитрусовый
cytryna - лимон
czador - чадра
Czad - Чад
czajka - чибис
czajnik - чайник
czaj - чифирь
czapka - шапка
czapla - цапля
czarna dziura - чёрная дыра
czarna jagoda - черника
czarna porzeczka - чёрная смородина
czarne złoto - чёрное золото
czarno-biały - чёрно-белый
Czarnogóra - Черногория
czarny bez - бузина|бузина́ , чёрная бузина|чёрная бузина́
czarny rynek - чёрный рынок
czarny - чёрный
czarownica - колдунья , ведьма
czary - волшебство , магия
czasem - иногда
czasopismo - журнал
czasownik zwrotny - возвратный глагол
czasownik - глагол
czas przeszły - прошедшее время
czas przyszły - будущее время
cząsteczka - частица
czas teraźniejszy - настоящее время
czas to pieniądz - время — деньги
czaszka - череп
czas - время
czatować - стеречь
czciciel - поклонник
czcić - чтить
Czechosłowacja - Чехословакия, ''Čechoslovakija''
Czechy - Чехия ; Богемия
Czech - чех
czekać - ждать; ждать
czekan - ледоруб
czekolada - шоколад
czekoladka - шоколадка
czekoladowy - шоколадный
czeladź - челядь
czeremcha - черемуха
czereśnia - черешня
Czerniowce - Черновцы
czerń - чёрный цвет
czerstwy - чёрствый
czerwiec - июнь
czerwień - красный цвет
czerwona kartka - красная карточка
czerwona porzeczka - красная смородина
czerwony olbrzym - красный гигант
czerwony - красный
czesać - расчёсывать, чесать
częściowo - частично
część mowy - часть речи
cześć - привет , здравствуйте, пока
część - часть ; часть
czeski - чешский; чешский
Częstochowa - Ченстохова
często - часто, зачастую
częsty - частый , частая , частое , частые ''pl''
Czeszka - чешка
członek - член ; член , конечность ; член
człowiek - человек
czołgista - танкист
czołg - танк
czoło - лоб
czopek - колбочка
czosnek - чеснок
czucie - ощущение
czuć - чувствовать
czwartek - четверг
czwartorzęd - Четвертичный период
czworokąt - четырёхугольник
czynić - делать|де́латъ
czynnik - фактор
czynność - занятие , дело , действие , деятельность ; функция , деятельность
czyn - действие
czyścić - чистить; делать уборка|уборку, прибираться, наводить порядок
czystość - чистота
czysty - чистый; чистый; чистый; чистый
czytać - читать; прочитать, прочесть
czytelnia - итальня
czyżyk - чижик
dąb - дуб
dach nad głową - крыша над головой
dach - крыша
dać - дать
Dagestan - Дагестан
Dakota Północna - Северная Дакота
Dakota Południowa - Южная Дакота
daktyl - финик
daleki - далёкий
daleko - далеко
daleko- - далеко-
Dalmacja - Далмация
dama - дама
Dania - Дания
Daniel - Даниил
danie - блюдо
dany - данный
daremny - напрасный
darmo - даром; напрасно, тщетно, зря
darmsztadt - дармштадтий
darowanemu koniowi w zęby się nie zagląda - дарёному коню в зубы не смотрят
dart - дартс ; дротик , стрела
data - дата, число
dawać - давать, гнать
dawno - давно
dążenie - стремление
dążyć - стремиться
dbać - ухаживать
decydent - руководитель
decydować - решать
decyzja - решение
defekt - дефект
deficyt - дефицит
defraudacja - растрата
Deimos - Деймос|Де́ймос
deizm - деизм
dekabrysta - декабрист
dekabrystka - декабристка
dekabrystowski - декабристский
dekada - декада ; декада
dekalog - декалог
Dekan - Декан
deklinacja - изменение|измене́ние , склонение|склоне́ние
delektować się - наслаждаться
delfin - дельфин ; баттерфляй , дельфин
delikatny - лёгкий; щепетильный|щепети́льный
demagogia - демагогия
Demokratyczna Republika Wyspy Świętego Tomasza i Wysp Świętego Tomasza i Książęcej - Демократическая Республика Сан-Томе и Принсипи
demokratyzacja - демократизация
demonologia - демонология
demon - демон
dentysta - зубной врач , стоматолог
deportować - депортировать
deptak - пешеходная зона
dereń - кизил
dermatologia - дерматология
deser - десерт
deska - доска
deskorolka - роликовая доска
destabilizacja - дестабилизация
destylacja - дистилляция
deszczowy - дождливый
deszcz - дождь
detal - деталь
detektyw - детектив
dętka - камера
detonator - детонатор
diabelski młyn - колесо обозрения , чёртово колесо
diabeł - дьявол , чёрт , сатана
diagnostyka - диагностика; техническая диагностика
dialekt - диалект
diament - алмаз
didaskalia - ремарка
dielektryk - диэлектрик
dieta - диета ; суточные , командировочные
dinozaur - динозавр
diplodok - диплодок|диплодо́к
dlaczego - почему, зачем
dlatego - поэтому
dla - для
dłoń - ладонь
długi - длинный; долгий
długopis - ручка , авторучка , шарик
długość - длина ; длина ; продолжительность
długo - долго
dmuchać - дуть
dmuchawiec - одуванчик
DNA - днк
doba - сутки
do Boga, gdy trwoga - гром не грянет – мужик не перекрестится
dobranoc - спокойной ночи
dobrowolnie - добровольно
dobro - добро
dobry wieczór - добрый вечер
dobry - хороший
dobrze - хорошо; ладно
dobytek - имущество
dochód - доход
dodawać - добавлять
do grobowej deski - до гробовой доски
doić - доить; выдаивать
dokąd - куда
dokładnie - тщательно, подробно, детально, досконально
dokładny - точный
dokonany - совершенный
dokuczać - досаждать, донимать
dokumentacja - документация
dokument - документ , документ|документы
dolar - доллар
dolina - долина
dolmen - дольмен
dolnołużycki - нижнелужицкий
dół - яма ; низ
domalowywać - дописывать
Dominika - Доминика
domowy - домашний
domra - домра
dom - дом
doniczka - цветочный горшок
donosiciel - доноситель , доносчик , стукач , ябедник
donośny - зычный
Don - Дон
dopełniacz - родительный падеж
dopełnienie - дополнение, обьект; дополнение
dopiero - лишь, только; только что
dorosły - взрослый; взрослый
dorsz - треска
dość - довольно, весьма, достаточно; довольно, хватит
doskonały - совершенный
dosłownie - буквально, в прямом смысле слова
dosłowny - дословный
dostać - получить
dostarczać - доставлять
dostawać - получать
dostojnik - сановник
doświadczenie - опыт
dotacja - дотация
dotyczyć - касаться
dotykać - прикасаться; задевать
dotyk - осязание
do widzenia - до свидания, пока
dowódca - командир
dowód osobisty - удостоверение личности
dowód - докозательство ; докозательство ; внутренний паспорт
drabina - лестница
dragon - драгун|драгу́н
dramat - драма
draństwo - низость , свинство , подлость
drapacz chmur - небоскрёб
drapieżnik - хищник
dręczycielka - мучительница , истязательница
dreptać - семенить
dreszcz - дрожь
drewniany - деревянный
drewno - древесина ; древесина , дерево , лес ; дерево , древесина ; полено , бревно
drobiazg - мелочь ; тонкость
drobny - мелкий
drób - птица, домашняя птица, птицы, живность
droga ekspresowa - дорога экспрэссия
Droga Mleczna - Млечный Путь
droga - дорога
drogi - дорогой; дорогой, родной
Drohobycz - Дрогобыч
drozd - дрозд
drukarka - принтер
drukarz - печатник
druk - печать
drumla - варган
drzazga - заноза
drzemać - дремать
drzewce - древко
drzewo genealogiczne - генеалогическое древо
drzewo - дерево
drzwi - дверь
dr - д-р
dubn - дубний
duch - фантом, привидение, призрак; душа; дух
dudek - удод
dulka - уключина
duma - гордость
Dunaj - Дунай
dupa - жопа
dupek - дурак , мудак , чмо , жопа
dureń - дурак
dusza - душа
duszno - душно
dużo - много
duży pokój - гостиная
duży - большой
dwoinka zapalenia płuc - пневмококк
dworzec - вокзал
dwugodzinny - двухчасовой
dwuizbowy - двухкомнатный, двухпалатный
dwukilogramowy - двухкилограммовый
dwukołowy - двухколесный
dwukropek - двоеточие
dwukrotny - двукратный
dwuletni - двухгодичный, двухлетний
dwulicowy - лицемерный
dwupłat - биплан
dwusieczna - биссектриса
dwutomowy - двужтомнуй
dwutygodniowy - двухнедельный
dwuwarstwowy - двухслойный
dwuzmianowy - двухсменный
dyletant - дилетант
dymisja - отставка
dym - дым
dynia - тыква
dynks - штуковина , штука , фиговина , фигня , хреновина , хрень , хренотень , хуёвина
dyplomatyczny - дипломатический
dyrektor - директор ; директор , директриса , директорша
dyrygent - дирижёр
dyrygować - дирижировать
dysertacja - диссертация
dyskoteka - дискотека
dysk twardy - жёсткий диск , винт
dyskusja - дискуссия , обсуждение ; обсуждение
dysk - диск ; диск ; диск ; диск ; диск
dysleksja - дислексия
dysonans - диссонанс
dysponować - располагать
dyspozytornia - диспетчерская
dysproz - диспрозий
dysydent - диссидент
dysza - сопло
dywan - ковёр
dżamahirijja - джамахирия
dżem - джем
dzeta - дзета
dżezwa - джезва
dziadek do orzechów - щипцы для орех|орехов , щелкунчик
Dziadek Mróz - Дед Мороз
dziadek - дедушка
działacz - деятель
działać - действовать; работать
działalność - деятельность
działanie - действие
działka - участок
Dżibuti - Джибути
dziecięcy - детский
dzieciństwo - детство
dzięcioł - дятел
dziecko - ребёнок
dziedziczyć - наследовать
dziedzina - область определения
dziegieć - дёготь
dzięki - благодарность ; '''' благодарить; спасибо!; благодаря
dziękować - благодарить
dziękuję bardzo - спасибо большое
dziękuję - спасибо
dzieło - произведение
dzień dobry - доброе утро , добрый день
dziennikarz - журналист
dzień - день
dziesiąta woda po kisielu - седьмая вода на киселе
dziesięciolecie - десятилетие
dziewczyna - девушка
dziewczynka - девочка
dzika róża - шиповник|шипо́вник
dziki - дикий
dzik - кабан|каба́н
dziobak - утконос
dziób - клюв , оспина
dzisiaj - сегодня
dzisiejszy - сегодняшний
dziura - дыра ; глубинка , захолустье
dziwka - блядь
dziwny - странный
dżuma - чума
dźwięk - звук
dźwig - лебёдка , кран
dzwonić - звенеть; звонить
dzwon - колокол
EAWG - ЕврАзЭС
EBOiR - ЕБРР
EBOR - ЕБРР
edytor tekstu - текстовый процессор
efemeryczny - эфемерный
Efialtes - Эфиальт
egiptologia - египтология
egiptolog - египтолог
Egipt - Египет
egoista - эгоист
egzaltacja - экзальтированность , восторженность
egzamin - экзамен
egzekwować - приводить в исполнение, взыскание
einstein - эйнштейний
ekologia - экология
ekologiczny - экологический
ekran - экран ; экран
ekshibicjonista - эксгибиционист
ekshibicjonistka - эксгибиционист
ekskomunika - отлучение от церковь|церкви
ekspedycja - экспедиция
ekspert - эксперт
eksperyment - эксперимент
eksportowanie - экспорт
ekspozycja - экспозиция , выставка ; экспозиция
ekspresja - экспрессия
ekstensywny - экстенсивный
ekstremofil - экстремофил
Ekwador - Эквадор
ekwilibrystyka - эквилибристика
-ek - ик
elektronika - электроника
elektrownia wodna - гидроэлектростанция
elektrownia - электростанция
elektro- - электро-
elektryka prąd nie tyka - танки грязи не боятся
elektryk - электрик
elektryzować - электризовать; электризовать, возбуждать; электризоваться; электризоваться; электризоваться
element - деталь , элемент ; элемент
elf - эльф
elipsa - эллипс ; эллипсис
eloksalacja - анодирование
eloksalowanie - анодирование
Elżbieta - Елизавета
embargo - эмбарго
emerytura - пенсия
emeryt - пенсионер
emigrant - эмигрант
Emilia - Эмилия
emir - эмир
emocja - эмоция
empiryczny - эмпирический
endokrynolog - эндокринолог
entalpia swobodna - энергия Гиббса
entalpia - энтальпия
entropia - энтропия
enzym - фермент, энзим
Eos - Эос
epatować - эпатировать
epidemiologia - эпидемиология
epikureizm - эпикуреизм
eponim - эпоним
era - эра
erb - эрбий
Eris - Эрида; Эрида|Эри́да
erupcja - извержение
Erytrea - Эритрия
erytrozyna - эритрозин
Erywań - Ереван
ESBC - ЕСЦБ
esperanto - эсперанто
estetyczny - эстетический
estetyka - эстетика
Estonia - Эстония
etalon - Эталон
etan - этан
eten - этен , этилен
Etiopia - Эфиопия
etniczny - этнический
etopozyd - этопозид
etymologia ludowa - народная этимология
etymologia - этимология
etyn - етин
euforia - эйфория
Eufrat - Евфрат
Euklides - Евклид , Эвклид
Europa - Европа
europejski - европейский
Europol - Европол
europ - европий
euro - евро
eutanazja - эвтаназия
Ewa - Ева
EWG - ЕЭС; ЕврАзЭС
Ezdrasz - Ездра
Ezop - Эзоп
fabryka - фабрика
facet - дядя , дядька , мужик
fajans - фаянс
faks - факс
fakt - факт
fala - волна
falcownik - фальцаппарат
Falklandy - Фолклендские острова
fałszywy przyjaciel - ложный друг
fantastyczny - фантастический
fanzin - фэнзин
fan - любитель, почитатель, фанат, болельщик
faraon - фараон
farmaceuta - фармацевт
farmaceutyk - лекарство
farmacja - фармация
fasola - фасоль
fasolka szparagowa - спаржевая фасоль
faszystowski - фашистский
Federacja Rosyjska - Российская Федерация
felczer - фельдшер
feminizm - феминизм
Fenicja - Финикия
fermentacja - ферментация
fermentator - ферментатор
ferm - фермий
Fidżi - Фиджи
figa - фига
figowiec - фига ; фикус
filar - столб; целик
filia - филиал
-filia - -филия
filigran - скань , филигрань
Filipiny - Филиппины
Filip - Филипп
filiżanka - чашка|ча́шка
film - фильм , кинокартина ; киноплёнка , фотоплёнка , плёнка
filozofia - философский
filozof - философ
Finlandia - Финляндия|Финля́ндия
Fin - финн
fiołek - фиолка
fioletowy - фиолетовый|фиоле́товый
firma - фирма
fiskus - фиск
fitohormon - фитогормоны
flaga - флаг , знамя
flamaster - фломастер
flaming - фламинго
flanela - фланель
flet - флейта
Florencja - Флоренция
flota - флот
fluor - фтор
Focjusz - Фотий
foka - тюлень , нерпа
folwark - фольварк|фольва́рк
fontanna - фонтан
forma - форма
fortepian - рояль
fort - крепость
fosa - ров
fosfor - фосфор
fosgen - фосген, оксид-дихлорид углерода, карбонилхлорид, хлорокись углерода
fotografia - фотография , снимок ; фотография
fotograficzny - фотографический
fotograf - фотограф
foton - фотон|фото́н
fototropizm - фототропизм
fragment - фрагмент , отрывок
frajer - пиздюк
Francja - Франция
Francuz - француз
frans - франций
frazes - фраза
fregata - фрегата ; фрегата
frezarka - фрезерный станок , фрезеровальный станок
fryzjer - парикмахер|парикма́хер
fryzura - причёска
fugas - фугас , СВУ
fundament - фундамент
funkcja - функция
furosemid - фуросемид
futro - шуба
gabardyna - габардин
gąbka - губка
gablota - витрина
Gabon - Габон
gadatliwy - разговорчивый, болтливый
gadolin - гадолиний
gaduła - болтун
Gad - Гад
gad - рептилия , гад
gajowy - лесник , лесной сторож
galaktyka - галактика
galareta - желе
galaretka - желе
gałąź - ветка , ветвь , сук ; отрасль ; ответвление
gałka muszkatołowa - мускатный орех
gałka - шарик , ''u laski'' набалдашник , ''rączka'' ручка; шарик ; регулятор ; баллотировочный шар
gal - галлий
Gambia - Гамби я|Гамбия
gameta - гамета
gamma - гамма
ganek - крыльцо
gapa - разиня ''m f'', рассеянный ; заяц
garb - горб
garderoba - гардероб ; уборная
gardło - горло
garnek - кастрюля
garnirunek - гарнир
garnitur - костюм
gąsienica - гусеница
gaśnica - огнетушитель
gatunek - сорт , род , вид , тип ; вид
gawron - грач
gaża - жалование , оклад
gaz do dechy - на полном газе; давать|давай!, жать|жми!
gazeta - газета
gaz musztardowy - горчичный газ
gazociąg - газопровод
gazon - газон
gaz - газ ; педаль газ|газа , акселератор
gdakać - кудахтать
Gdańsk - Гданьск
gdańszczanin - житель Гданьск|Гданьска
gdy kota nie ma, myszy harcują - без кота мышам раздолье
gdy spieszyć się człowiek spieszyć spieszy, to cieszyć się diabeł cieszyć cieszy - поспешишь - людей насмешишь
gdy - когда, если
gdzieniegdzie - изредка, тут и там
gdzieś - где–то
gdzie - где; где; куда
gęgać - гоготать
generator - электрический генератор
gentamycyna - гентамицин
gen - ген
geografia - география
geologia - геология
geometria - геометрия
gepard - гепард
german - германий
gęsiego - гуськом
gest - жест
gęś - гусь
getto - гетто
Ghana - Гана
giaur - гяур
Gibraltar - Гибралтар
giełda - биржа
giez - овод
gigant - гигант ; гигант
gilotyna - гильотина|гильоти́на
gil - снеги́ръ ; сопля
ginąć - потеряться; гибнуть; исчезать, растворяться
gips - гипс
gitara - гитара
gitarzysta - гитарист
Giżycko - Гижицко
gladiator - гладиатор
gleba - почва , земля
głębia - глубина ; глубина ; глубина
głęboki - глубокий
glina - глина
gliniarz - мент
glin - алюминий
globalne ocieplenie - глобальное потепление
globalnie - всемирно
globtroter - глобтроттер
głodny - голодный
głód - голод
głośnik - громкоговоритель
głośno - громко
głos - голос
głowa - голова ; глава ; кочан
główny - главный
głuchoniemy - глухонемой
głuchy - глухой
głupek - дурак
głupiec - глупец , дурак
głupi - глупый
głupota - глупость
głuszec - глухарь
gmina - муниципалитет
gnejs - гнейс
gniady - гнедой
gniazdo - гнездо
gnieść - комкать, сминать
gniew - злоба , ярость , гнев
gnuśny - ленивый
gnu - гну
godło - герб
godność - достоинство
godzić - соглашаться, мириться
godzina policyjna - комендантский час
godzina - час ; час
godz. - ч
gołąb - голубь
Gołdap - Голдап ; Озеро Красное
gołębnik - голубятня
gołoledź - гололедица|гололе́дица
gondola - гондола ; гондола
gonić - гнаться, бежать, догонять, преследовать
goniec - слон
gorąco - жара ; жарко
gorący - горячий
gorączka złota - золотая лихорадка
gorączka - повышенная температура
góra lodowa - айсберг
góra - гора
gorczyca - горчица
górnik - шахтёр
górnołużycki - верхнелужицкий
Górski Karabach - Нагорный Карабах
goryl - горилла
Góry Skaliste - Скалистые горы
gorzała - горилка
gorzej - хуже
gość - гость , гостья
gospodarstwo - двор
gospodarz - хозяин
gospodyni - хозяйка , домохозяйка
gotować - кипеть
gotowy - готовый; готовый; готовый
gówno - говно
goździk - гвоздика ; гвоздика
grabarz - могильщик
grabie - грабли
grać pierwsze skrzypce - играть первую скрипку
gracz - игрок
grać - играть; сочетаться; играть
gradient - градиент
grad - град
grafik - график ; график
gramatyka - грамматика
gramofon - граммофон
granatowy - тёмносиний|тёмноси́ний
granat - граната ; гранат ; гранат ; тёмно-синий; гранат
granica - граница , черта
graniczyć - граничить, примыкать; граничить, доходить
granit - гранит
gratyfikacja - денежный|денежное вознаграждение , наградные
grawitacja - гравитация
gra - игра
grdyka - адамово яблоко , кадык
Grecja - Греция
grecki - греческий
gregoriański - григорианский
grejpfrut - грейпфрут
Grenada - Гренада ; Гранада
Grenlandia - Гренландия
grobowiec - склеп
grobowy - могильный; гробовой, похоронный
grób - могила
groch - горох|горо́х
gromadzić - накапливать; собирать; собираться
grom - гром
gronostaj - горностай
grosz do grosza, a będzie kokosza - копейка рубль бережёт
grosz - грош ; копейка|копейки
gros - гросс
grota - грот
groźny - грозный
gruba berta - Большая Берта , Толстушка Берта
gruba ryba - важная птица , туз , ВИП
gruby - толстый; толстый
gruczolak - аденома
grudzień - декабрь
grupa - группа
gruszka - груша
Gruzja - Грузия
gryf - грифон , гриф
gryka - греча , гречиха|гречи́ха
gryźć - кусать, грызть
gryzoń - грызун ; грызун|грызуны
grządka - грядка
grzbiet - спина , хребет ; конёк
grzebać - рыть, копать; хоронить
grzebień - расчёска , гребень
grzechotka - трещотка
grzech - грех
Grzegorz - Григорий
grzesznik - грешник
grzeszny - грешнуй
grzyb - гриб ; грибок ; гриб
Guam - Гуам
Gujana - Гайана
guma - резина; жевачка/жевательная резинка
gust - вкус
guzik - пуговица; кнопка
gwałciciel - насильник
gwałt - насилие , произвол , беззаконие ; изнасилование ; суматоха , кутерьма
Gwatemala - Гватемала
gwiazda - звезда
gwiazdeczka - звёздочка
gwiazdozbiór - созвездие
Gwinea Bissau - Гвинея-Бисау
Gwinea Równikowa - Экваториальная Гвинея
Gwinea - Гвинея
gwóźdź - гвоздь
habit nie czyni mnicha - по одёжке встречают, по уму провожают
hafn - гафний
Haga - Гаага
haiku - хайку
Haiti - Гаити
hak - крюк
hałas - шум
halibut - палтус
halo - алло
handel - торговля
handlowy - торговый|торго́вый
harmonogram - график
hasać - резвиться, бегать; танцевать, плясать
hasło - лозунг ; знак ; пароль ; статья , заглавный|заглавное слово
haszysz - гашиш
has - хассий
haubica - гаубица
hazard - азарт
hebrajski - еврейский; иврит
Hefajstos - Гефест
heksan - гексан
hektar - гектар
helikopter - вертолёт , вертушка
hel - гелий
hentai - хентай
heparyna - гепарин
heptan - гептан
herbata - чай
herb - герб
Hestia - Гестия
hetman - гетман ; ферзь , королева
hiacynt - гиацинт
Hiady - Гиады
hidżab - хиджаб
hieroglif - иероглиф
hindi - хинди
Hindustan - Индостан
hiperbola - гипербола ; гипербола
hiperestezja - гиперестезия
hipertermia - гипертермия
hipopotam - бегемот|бегемо́т , гиппопотам|гиппопота́м
hipoteka - ипотека|ипоте́ка
hipoteza - гипотеза
historia - история
historyk - историк
Hiszpania - Испания
hiszpanka - испанка
Hiszpan - испанец|испа́нец
Hiuma - Хийумаа
hobby - хобби
hokej - хоккей
Holandia - Голландия|Голла́ндия , Нидерланды|Нидерла́нды
Holenderka - голландка
holenderski - голландский
holm - гольмий
homeopatia - гомеопатия
Honduras - Гондурас
Hongkong - Гонконг
honor - честь ; почёт
hormon - гормон
Horus - Хор
hospitalizacja - госпитализация
hotel - гостиница|гости́ница , отель|оте́ль
Hucuł - Гуцул
humanistyka - гуманитарные науки
humor - юмор ; настроение
huragan - ураган
Hurghada - Хургада
huśtać - качать, болтать
huśtawka - качели
hycel - собачник , живодёр
hydrant - гидрант
hydraulik - водопроводчик , сантехник
hydroksy- - гидрокси-
hydrostatyka - гидростатика
ibis - ибис
idarubicyna - идарубицин
idealny - идеальный
idea - идея ; идея
idiota - идиот , дурак ; идиот
igła - игла , иголка
igliwie - хвоя ; игольник
ignorancja - игноранция
ignorować - пренебрегать
igrać z ogniem - играть с огнём
igrzyska olimpijskie - Олимпийские игры
ikona - икона
ile - сколько
ilość - количество
imbir - имбирь
imieniny - именины , день ангела
imiennik - тёзка
imiesłów - причастие
imię - имя
imigracja - иммиграция
immatrykulacja - имматрикуляция
imponderabilia - неуловимый|неуловимые фактор|факторы
impotencja - импотенция
impuls - импульс
inaczej - иначе
Indie - Индия
indolencja - инертность , вялость , беспомощность
Indonezja - Индонезия
indygokarmin - индигокармин
indyk - индюк
ind - индий
inercja - инерция
inflacja - инфляция
inflacja - инфляция|инфля́ция
informacja - информация
informatyczny - информатический
informatyka - информатика
inicjalizować - инициализировать
inkaso - инкассо
inkryminować - инкриминировать
innowierca - иноверец
innymi słowy - другими словами
inny - другой
inspirator - вдохновитель
instalować - устанавливать, проводить ; инсталлировать, устанавливать; располагаться, устраиваться
instrukcja - инструкция
instytucja - учреждение ; институт
instytut - институт
intarsja - интарсия
integracja - интеграция
interaktywny - интерактивный|интеракти́вный
intercyza - брачный контракт
interesujący - интересный, привлекательный, занимательный
interes - дело
interlingua - интерлингва
interlokutor - собеседник
internetowy - интернет-
internet - Интернет
Internet - Интернет
internować - интернировать
interpretować - интерпретировать, воспринимать
interseksualizm - интерсексуальность
interwencja - интервенция , вмешательство
interwencjonizm - интервенционистский|интервенционистская политика
interweniować - вмешиваться
intonacja - интонация
intratny - прибыльный, доходный
intryga - интрига , происки , козни ; интрига
inwalida - инвалид
inwencja - находчивость , изобретательность ; инвенция
inwentaryzacja - инвентаризация
inwentarz - инвентарь
inwokacja - апострофа
inżynier - инженер
inż. - инж.
iperyt azotowy - азотистый иприт , азотный иприт
iperyt siarkowy - иприт , горчичный газ , 2,2'-ди-|дихлор-|хлорди-|диэтиловый тиоэфир , 2,2'-ди-|дихлор-|хлорди-|диэтил-|этилсульфид , 1-хлор-|хлор-2--этан
ipsylon - ипсилон
Irak - Ирак
Iran - Иран
Irlandia Północna - Северная Ирландия
Irlandia - Ирландия
ironia - ирония
ironicznie - иронически, иронично
iryd - иридий
irytować - раздражать; раздражаться
iść - идти; идти
islam - ислам , мусульманство
Islandia - Исландия
Islandka - исландка
islandzki - исландский; исландский
istnieć - существовать
istota - существо ; суть , сущность
Itaka - Итака
itd. - и т. д.
iterb - иттербий
itp. - и т. п.
itr - иттрий
Iwan - Иван
izokoszta - изокоста
Izrael - Израиль
i - и
jabłko - яблоко
jabłoń - яблоня
jacht - яхта
Jaćwież - Судавия , Судовия
jadalnia - столовая ; столовый гарнитур
jadalny - съедобный
jądro - яичко ; ядро
jad - яд, отрава
jagnię - ягнёнок
jagoda - ягода
jaguar - ягуар
jajeczkowanie - овуляция
jajecznica - яичница
jajko - яйцо
jajnik - яичник
jajowaty - яйцевидный
jajowód - фаллопиевы трубы , яйцевод
jajo - яйцо
jaka matka, taka córka - какова мать, такова и дочь
jakby - словно
jakikolwiek - какой-нибудь
jaki ojciec, taki syn - каков отец, таков и сын
jakiś - какой-то
jakość - качество
jak ty komu, tak on tobie - как акунется, так и откликнется
Jakub - Яков; Яша
jak - будто
jałmużna - милостыня , подаяние
jałowiec - можжевельник
jałówka - яловка
Jamajka - Ямайка ; Ямайка
jama ustna - рот , ротовой|ротовая полость
jama - яма
Jamusukro - Ямусукро
Jan - Ян
Japończyk - японец
Japonia - Япония
japonka - вьетнамка
japoński - японский; японский
jarzębina - рябина
jarzmo - бремя , иго
jar - яр, овраг
jaskier - лютик
jaskinia - пещера ; притон , логово
jaskółka - ласточка
jasny - светлый
jaspis - яшма
jastrząb - ястреб
jaszczurka - ящерица
jawny - явный, открытый
Jaworzno - Явожно
jaz - яз
ja - я
jechać - ехать
jeden - один
jednakowo - одинаково
jednak - но, однако
jednorożec - единорог
jedność - объединение ; единство
jednostka - личность , индивидуум , индивид , единица ; единица , часть ; ; единица ; денежный|денежная единица
jedwab - шёлк
jedynka - единица
jedyny - единственный
jedzenie - еда , пища ; еда
jemeński - йеменский
Jemen - Йемен
jemioła - омела
jemiołuszka - обыкновенный свиристель , свиристель
jeniec - пленный, военнопленный
Jerycho - Иерихон
Jerzy - Георгий , Юрий , Егор
jer - ерь '''', ер ''''
jeść śniadanie - завтракать
jeść - есть
jesienny - осенний
jesień - осень
jesion - ясень
jesiotr - осётр
jeszcze - ещё; ещё; ещё; ещё
jeździć - ездить; ездить
jeżeli - если , ежели
jezioro - озеро
Jezus - Иисус
język i do Krakowa dopyta - язык до Киева доведёт
język ojczysty - родной язык
językowy - языковой
językoznawca - языковед
język - язык ; язык
jeżyna - ежевика
jeż - ёж
jidysz - идиш
jodła - пихта
jod - йод , иод
jogurt - йогурт
jol - иол / йол
Jordania - Иордания
jotta- - йотта-
Jowisz - Юпитер; Юпитер
Józef - Иосиф
jubiler - ювелир
Jugosławia - Югославия
juliański - Юлианский
Julian - Юлиан
Juliusz - Юлий
juta - джут
jutro - завтра
jutrzejszy - завтрашний
już - уже; уже
kabaczek - кабачок
kabanos - ожотничья колбаска
kabel - кабель
kaczka dziennikarska - газетная утка
kaczka - утка ; утка
Kaczor Donald - Дональд Дак
kaczor - селезень
kadaweryna - кадаверин
kadłub - остов , корпус ; корпус , фюзеляж ; туловище
kadm - кадмий
kadzidło - фимиам
Kair - Каир
kajakarka - байдарочница
kajakarz - байдарочник
Kajmany - Каймановы острова
kakadu - какаду
kakao - какао
kaktus - кактус
kalafior - цветная капуста
kałamarz - чернильница
kalejdoskop - калейдоскоп
kalendarz - календарь
kalenica - конёк
kalesony - кальсоны
kaliforn - калифорний
kaligrafia - каллиграфия
kalina - калина
kalkulator - калькулятор
kalmar - кальмар|кальма́р
kalosz - калоша , галоша
kałuża - лужа
kalwinista - кальвинист
kałym - калым
Kambodża - Камбоджа
kamera - камера , видеокамера
Kamerun - Камерун
kamienny - каменный
kamień - камень
kamizelka - жилет , жилетка
Kanada - Канада
kanadyjski - канадский
kanał - канал ; телеканал ; оркестровая яма
kanapa - диван
kanapka - бутерброд
kanarek - канарейка , кенар , кенарь , кенарка
kangur - кенгуру
kantor - обмен валюта|валюты ; кантор
kapeć - тапка
kapelusz - шляпа
kąpielówki - плавки
kapitalizm - капитализм
kapitan - капитан ; капитан ; капитан
kapłan - священнослужитель, священник
kaptur - капюшон
kapusta - капуста|капу́ста
karabinek - карабин
karabin maszynowy - пулемёт
karabin - винтовка
kara cielesna - телесное наказание
karać - карать, наказывать
karafka - графин
karaibski - карибский
Karakorum - Каракорум
karakuły - каракуль
karakuł - каракуль
karapaks - карапакс
karawela - каравелла
kara - наказание
karbon - карбон , каменноугольный период
karczoch - артишок
karczować - корчевать
karcz - пень
kardynał - кардинал
kariatyda - кариатида
karmaniola - Карманьола
karmnik - кормушка
Karol - Карл
karp - карп
karta - карта ; меню
kartofelek - баядерка, картошка
karykatura - карикатура
kasjer - кассир|касси́р
kasyno - казино
kasza - каша
kaszel - кашель
kaszleć - кашлять
kasztanowy - каштановый
kasztan - каштан
katalog - каталог ; проспект ; папка , директория , фолдер
kataloński - каталонский
katana - катана
Katar - Катар
katar - катар ; насморк
katastrofa - катастрофа
katoda - катод
kąt prosty - прямой угол
Katyń - Катынь
kat - палач
kąt - угол
kawałek - часть
kawaler - холостяк; кавалер; молодой человек; жених
kawał z brodą - анекдот с бородой
kawał - анекдот
kawa - кофе
kawiarka - Мока, Мока Экспресс
kawiarnia - кафе
kawka - галка
Kazachstan - Казахстан
Kazaszka - казашка
kciuk - большой палец
keczup - кетчуп
kefija - куфия
kefir - кефир
kelnerka - официантка
kelner - официант
Kenia - Кения
khaki - хаки
kibic - болельщик
kibitka - кибитка
kichać - чихать
kiedy - когда; когда
kiełbasa - колбаса
kiepski - плохой, худой
kierowca - водитель
kierownictwo - руководство
kierownik - начальник , руководитель
kierunek - направление ; направление ; течение
kieszeń - карман
kieszonkowiec - карманник
kijanka - головастик
Kijów - Киев
kilka - несколько
kilowolt - киловольт
kilwater - кильватер
kino - кино , кинотеатр ; кино
Kinszasa - Киншаса
kiosk - киоск
Kirgistan - Киргизстан , Киргизия
Kirgizka - киргизка
kisiel - кисель
kit - замазка
kiur - кюрий
kiwi - киви ; киви
klacz - кобыла
kląć - ругаться, материться
kłamać - врать, лгать
kłamca - лгун , врун , лжец , брехун
klamerka - прищепка
klamka - дверная ручка
kłamstwo - ложь , враньё , вздор , неправда , обман , враки
klasa - класс
klawiatura - клавиатура ; клавиатура
klawisz - клавиша
kłębek - клубок
klej - клей
klęska - поражение
klient - клиент ; клиент
klikać - кликать
klimatyzacja - кондиционирование воздуха , климатизация
klimat - климат ; климат
klips - клипс
klon - клён ; клон
kloszard - клошар , бомж
kłos - колос
kłótnia - спор
klub - клуб
klucz - ключ ; авиазвено ; ключ
kłusownik - браконьер
knować - затевать
koalicja - коалиция
kobalt - кобальт
kobiecy - женский
kobieta lekkich obyczajów - женщина лёгкого поведения
kobieta - женщина
kobyła - кобыла
kochać - любить
kochanek - любовник
kochany - милый
kociara - кошатница
kocioł parowy - паровой котёл
kocioł - котел
kocur - кот
koc - одеяло
koguci - петушиный, петуший
kogut - петух
kojotołak - койот-оборотень
kokietować - кокетничать
kokos - кокос ; кокос
kok - кок
kolacja - ужин
kołacz - калач
kolano - колено
kolchicyna - колхицин
kołchoz - колхоз
kolczuga - кольчуга
kolęda - колядка
kolega - друг , коллега , приятель
kolejka - очередь ; электричка ; игрушечный поезд
kolejny - следующий, очередной
kolejowy - железнодорожный
kolej - железная дорога , железнодорожный транспорт ; очередь
koliber - колибри
kółko - кружок ; хоровод
kołnierz - воротник
kołodziej - колесник
Kolonia - Кёльн
kolorowy - цветной
kolor - цвет , краска ; масть ; румянец , краска
kolos na glinianych nogach - колосс на глиняных ногах
koło zębate - зубчатое колесо
Kolumbia Brytyjska - Британская Колумбия
Kolumbia - Колумбия
kolumna - колонна|коло́нна ; колонка ; колонна , колонка , столбец ; колонна
kołysanka - колыбельная
komar - москит
koma - кома
komedogenny - комедогенный
komentator - комментатор ; комментатор
komercyjny - коммерческий
kometa - комета
komfortowo - комфортно
komfort - комфорт
komiczny - комический
komiks - комикс
kominiarka - шапка-маска
kominiarz - трубочист
komin - дымоход , труба
komisja - комиссия
komoda - комод
komora gazowa - газовая камера
komórka - чуланчик , каморка ; клетка ; мобильник
Komory - Коморские острова
kompas - компас
kompletny - круглый
kompost - компост
kompres - компресс
komputerowiec - компьютерщик
komputerowy - компьютерный
komputer - компьютер
komunikacja - коммуникация
komunikat - сообщение
komunistyczny - коммунистический
komunizm - коммунизм
koncert - концерт
kończyć - кончать, заканчивать; бросать
konduktor - проводник|проводни́к
kondygnacja - этаж
konewka - лейка
konferencja naukowa - научная конференция
konferencja - конференция
konfitura - варенье|варе́нье
Kongo - Конго
koniak - коньяк
koniec - конец
konik - конёк
koniuszek - кончик
konopie - конопля
konował - коновал|конова́л
konsekwencja - результат , следствие ; последовательность
konspekt - проспект
konstelacja - созвездие|созве́здие
konstrukcja - конструкция|констру́кция
kontakt - контакт , także: электрический контакт , розетка
kontener - контейнер
konto - счёт ; аккаунт
kontrahent - контрагент
kontrola - контроль
kontur - абрис
kontynentalny - континентальный
kontynent - материк , континент
kontynuować - продолжать
konwalia - ландыш
koń - лошадь , конь
kopać - пинать, лягать, лягаться, толкать нога|ногой; копать, добывать
kopalnia - шахта ; неиссякаемый источник
Kopenhaga - Копенгаген
koperta - конверт
koper - укроп
kopiować - копировать
kopnąć w kalendarz - отбросить копыта, откинуть копыта
kopyto - копыто
kora - кора|кора́
kordonek - кручённуй шёлк
Koreańczyk - кореец
Koreanka - кореянка
Koreańska Republika Demokratyczna - Корейская Народно-Демократическая Республика
koreański - корейский
Korea Północna - Северная Корея
Korea Południowa - Южная Корея
Korea - Корея
korelacja - корреляция
korkociąg - штопор
kornik - короед
korona - корона ; корона ; корона ; корона ; корона
korpus - корпус , туловище ; корпус
korrida - коррида
korytarz - коридор
korzeń - корень
korzystanie - использование|испо́льзование, применение|примене́ние
korzystny - полезный, способствующий; положительный, благодатный, доброжелательный; выгодный
kosaciec - касатик
kosa - коса
Kościerzyna - Косцежина, Берент
kość słoniowa - слоновая кость
kość - кость ; кость
kosiarka - косилка
kosić - косить
kosmos - космос
Kostaryka - Коста-Рика
kostium - костюм
kostka rosołowa - бульонный кубик
kostka Rubika - кубик Рубика
kostka - косточка ; щиколотка , лодыжка ; плектр ; стоппер
kosztować - стоить
koszt - расходы
koszula - рубашка
koszyczek - корзиночка ; корзинка
koszykarz - баскетболист ; корзинщик
koszykówka - баскетбол
kosz - корзина ; корзина
kos - чёрный дрозд
kotka - кошка
kotwica - якорь
kot - кошка, кот
kowadło - наковальня
kowal - кузнец
kowariancja - ковариация
kowboj - ковбой
Kozak - казак
kozak - казачок ; сапог
koza - коза
kozik - перочиннуй ножик
kozioł ofiarny - козёл отпущения
Koziorożec - Козерог ''Kozierog''
kozi - козьи
koźlątko - козлёнок , козлик
kożuch - дубленка , дублёнка , тулуп , кожух
kożusznik - меховщик, скорняк
kradzież - кража
Kraina - Крайна
kraj - край , страна ; страна , государство ; край
krakać - каркать
krakowianin - краковянин
Kraków - Краков
kranik - краник
kran - кран
kraść - красть
krawat - галстук
krawiec - портной
kra - льдина ; кря
kredens - буфет , сервант
kręgosłup - позвоночник
krem - крем
kretyn - кретин
kręty - извилистый
kret - крот
krewetka - креветка
krew - кровь
KRLD - КНДР
kroczyć - шагать
kroić - резать
krokodylek - крокодил
krokodyle łzy - крокодиловы слёзы /
krokodyl - крокодил
krokus - крокус|кро́кус
krok - шаг
królik - кролик
królowa - королева
król - король
kropka w kropkę - тютелька в тютельку
kropka - точка ; пятнышко
kropla w morzu - капля в море
kropla - капля
krótki - короткий
krowa - корова
krtań - гортань
krucjata - крестовые походы
kruk krukowi oka nie wykole - ворон ворону глаз не выклюет
kruk - ворон
krykiet - крикет
Krym - Крым
krypta - склеп , крипта
krypton - криптон
krytyka - критика
krzak - куст ; крокозябры
krzem - кремний
krzesło - стул
Krzeszów - Кжешув
krztusiec - коклюшь
krzyczeć - кричать, орать
krzyk - крик
Krzyżak - крестоносец
krzyżówka - кроссворд ; кряква
krzyżyk - -диез
krzyż - крест ; крестец
ksenon - ксенон
ksiądz - ксёндз
książeczka - книжечка|кни́жечка
książę - князь ; герцог ; принц
książka kucharska - кулинарная книга
książka - книга
książkowy - книжный|кни́жный
księgarnia - книжный магазин
księga - книга
księżniczka - принцесса
Księżyc - Луна
księżyc - луна ; спутник, луна
ksylen - ксилол , диметилбензол
kształt - форма ; фигура
kto nie ma w głowie, ten ma w nogach - дурная голова ногам покоя не даёт
kto pyta, nie błądzi - язык до Киева доведёт
kto rano wstaje, temu Pan Bóg daje - кто рано встаёт, тому Бог подаёт
który - который
ktoś - кто-то, кто-нибудь
kto - кто; кто
kubański - кубинский; кубанский
Kuba - Куба
kubeczek - чашечка|ча́шечка
kubek - кружка
kuchenka - плита
kuchnia - кухня
kuć żelazo, póki gorące - ковать железо пока горячо
kudłacz - космач, лохмач
kufel - пивная кружка , кружка для пиво|пива
kukułka - кукушка ; кукушка
kukurydza - кукуруза ; маис ''''
kula - шар; шар; пуля; костыль
kulturalny - культурный
kultura - культура ; культура
kumkwat - кумкват
kuna - куница
kunsztowny - искусный, тонкий, мастерской, артистический
kupować kota w worku - купить кота в мешке
kupować - ''ndk'' покупать, ''dk'' купить
kura - курица , кура
kurier - курьер
kuriozalny - курьёзный
Kurówka - Куровка
kurtka - куртка
kurwa - блядь
kurz - пыль
kusić - соблазнять
kuskus - кус-кус, кускус
kusza - арбалет
kuter - катер
Kuwejt - Кувейт
kuzyn - двоюродный брат , кузен
kwadrans - четверть
kwadratowy - квадратный; квадратный
kwadrat - квадрат ; квадратная степень
kwantowy - квантовый
kwartał - квартал
kwas abietynowy - абиетиновая кислота
kwas akrylowy - акриловая кислота
kwas arsenowy - мышьяковая кислота
kwas askorbinowy - аскорбиновая кислота
kwas gentyzynowy - гентизиновая кислота , 2,5-ди-|дигидрокси-|гидроксибензойная кислота
kwas mrówkowy - муравьиная кислота
kwas octowy - уксусная кислота , метанкарбоновая кислота , этановая кислота
kwas węglowy - угольная кислота
kwas - кислота
kwiat - цветок
kwiecień - апрель
kwitnąć - цвести; цвести, процветать, преуспевать
kwoka - наседка ; брюзга , ворчунья
kwota - сумма , количество
Łaba - Эльба
łabędzi śpiew - лебединая песня
łabędź - лебедь
labilny - лабильный
labirynt - лабиринт
laborantka - лаборантка
laborant - лаборант
laboratorium - лаборатория
labrys - лабрис
łachudra - мерзавец , негодяй , дрянь
łach - тряпьё , рваньё , лохмотья
łacina - латынь , латинский язык ; брань , ругань
łaciński - латинский
łączka - лужок , лужайка
łączność - коммуникация
łączyć - соединять, связывать, объединять; соединять, связывать, объединять; сочетать, совмещать; соединять, связывать
lać - лить
ładny - красивый
ładowanie - зарядка
ładowarka - погрузчик ; заряжающее устройство
ląd - суша|су́ша , земля|земля́ , материк|матери́к
łagodny - тихий, мягкий, спокойный, нераздражительный, кроткий; неострый, некрепкий
łąka - луг , лужайка
lakier do paznokci - лак для ногтей|лак для ногте́й
lakoniczność - лаконичность
lakrymator - лакриматор , слезоточивый газ
laktaza - лактаза
lalka - кукла
łamać - ломать; нарушать
lama - лама|ла́ма
lambrekin - ламбрекен
lampa - лампа
lampka - рюмка ; лампочка
łańcuch pokarmowy - пищевая цепь , трофическая цепь
łańcuch - цепь
landrynka - леденец
łania - лань
lantan - лантан
Laos - Лаос
laparoskopia - лапароскопия
laparotomia - лапаротомия
łapówka - взятка
laseczka - бацилла
laser - лазер
laska - трость, палка; краля, тёлка
lasso - лассо
las - лес ; лес
latać - летать; бегать, суетиться
latawiec - воздушный змей , летающий змей
łata - пятно ; заплата , заплатка ; патч; планка , решетина ; рейка
lato - лето
łatwizna - пустяк , лёгкий/простой путь
lawa - лава
lawina - лавина
ławka - скамейка , скамья , лавка
łazić - бродить
łazienka - ванная|ва́нная , ванная комната|ва́нная ко́мната
łaźnia - баня
Lazurowe Wybrzeże - Лазурный Берег
lazuryt - лазурит|лазури́т
Łeba - Леба
lebioda - лебеда , марь , марь белая
łechtaczka - клитор
lecieć - лететь
leczniczy - лечебный, целебный, целительный, врачебный, лекарственный
leczyć - лечить
legalny - легальный
lejce - вожжи
lękać się - бояться, опасаться
lekarstwo - лекарство
lekarz - врач , доктор
lekcja - урок
lekki - лёгкий
lekkoatleta - легкоатлет
lekkoatletyka - лёгкая атлетика
lękliwy - робкий, боязливый, пугливый
leksem - лексема
lektyka - паланкин
lęk - тревога
leming - лемминг
lemoniada - лимонад
lenistwo - лень
leniuch - лентяй , лодурь
leniwiec - ленивец
Leńsk - Ленск
len - лён
lepiej późno niż wcale - лучше поздно, чем никогда
lepiej - лучше
lepszy wróbel w garści niż gołąb na dachu - лучше синица в руках, чем журавль в небе; не сули журавля в небе, а дай синицу в руки
leśniczy - лесник , лесничий ; лесничий
leśny - лесной
Lesotho - Лесото , Королевство Лесото
letni - летний; комнатный|комнатной температура|температуры
leukocytoza - лейкоцитоз
lewarek - лебёдка
leworęczny - левша
lewy - левый
lew - лев
Lew - Лев ''Liev''
leżak - шезлонг
leżeć - лежать; сидеть
Liban - Ливан
Liberia - Либерия
Libia - Ливия
libretto - либретто
lichy - худой
licytacja - аукцион
liczba mnoga - множественное число
liczba podwójna - двойственное число
liczba pojedyncza - единственное число
liczba - число
liczebnik - числительное
liczenie - счёт
liczny - многочисленный; много, многий
liczydło - счёты ; счётчик
ligatura - лигатура
likier - ликёр
lilak - сирень
lilia - лилия
limo - синяк под глаз|глазом
lingwistyka - лингвистика , языкознание , языковедение
linia - линия|ли́ния ; маршрут|маршру́т
linijka - линейка
liniowiec - лайнер
lipa - липа
lipiec - июль
Lipnik - Лёбенихт
liść laurowy - лавровый лист
liść - лист
lista - список
listonosz - почтальон
listopad - ноябрь
list - письмо
lis - лиса
literacki - литературный
literatura - литература
literaturoznawstwo - литературоведение
litera - буква
literówka - описка , опечатка
litr - литр
Litwa - Литва
lit - литий
lizać - лизать
liza - лизис
Lizbona - Лиссабон
lizus - подхалим , подлиза
łobuz - озорник|озорни́к, шалун|шалу́н
łochynia - голубика|голуби́ка , болиголов , гонобоб , гонобобель , дурника|дурни́ка , дурниха|дурни́ха , дурница|дурни́ца , пьяная ягода , пьяника|пья́ника , пьяница|пья́ница
łódeczka - лодочка
lodołamacz - ледокол
lodowiec - ледник
lodowisko - каток
lodówka - холодильник ; дубак , холодрыга , холодина
Łódź - Лодзь
łódź - лодка
lód - лёд ; лёд ; мороженое
lokalny - местный, локальный
łokieć - локоть
lokomotywa - локомотив
Lombardia - Ломбардия
Londyn - Лондон
lont - шнур
łopata - лопата
łopatka - лопатка
lorens - лоуренсий
łosoś - лосось
losowy - случайный
łoś - лось , сохатый
los - судьба
lotka - элерон ; маховое перо ; волан
lotnictwo - авиация , авиатика
lotniczy - авиационный
lotnik - авиатор ; лётчик
lotniskowiec - авиаматка , авианосец
lotnisko - аэродром , аэропорт
Łotwa - Латвия
lot - полёт ; полёт
łóżeczko - кроватка|крова́тка
łóżko - кровать
lubić - нравиться, любить
Lubliniec - Люблинец
lub - или
łucznik - лучник
łuczywo - факел
ludność - население
łudzić - обманувать, манить; ошибаться
ludzki - человеческий
ludzkość - человечество
lufa - ствол
Luksemburg - Люксембург ; Люксембург
łuk - лук ; арка ; дуга ; дуга ; электрический|электрическая дуга
lulać - баюкать, убаюкивать
lupinina - люпинин
lura - бурда
łuska - чешуя; стакан
lustro - зеркало
lutet - лютеций
lutować - паять, спаивать, пропаять
luty - февраль
łut - лот
Łużyce - Лужица
lwia część - львиная доля
lwołak - лев-оборотень
Lwów - Львов
łyk - глоток
łysy - лысый
łyżka do butów - рожок
łyżka - ложка
łyżwa - конёк
łyżwiarstwo - конькобежный спорт
łza - слеза
maca - маца
Macedonia - Македония
machać - махать гнать
Maciej - Матвей
macierz - матрица
macocha - мачеха
Madagaskar - Мадагаскар
Madera - Мадейра
mądrość - мудрость
mądry - умный, мудрый
MAEA - МАГАТЭ
mafia - мафия
magenta - маджента
Maghreb - Магриб
magia - магия
magiczny - магический
magnes - магнит
magnez - магний
majonez - майонез
Majotta - Майотта
majtki - трусы
maj - май
makabryczny - чудовищный, ужасный
makaron - макароны , вермишель , лапша
mąka - мука|мука́
makówka - маковка
malajski - малайский
malarstwo - живопись
malarz - маляр ; художник
Malawi - Малави
Malediwy - Мальдивы
maleńki - маленький
Malezja - Малайзия
Małgorzata - Маргарита
malina - малина
Mali - Мали
malować - красить
mało - мало
małpa - обезьяна ; собака
Malta - Мальта‎
Malwiny - Мальвинские острова
mały - маленький
małżeński - супружеский
małżeństwo - брак ; брак , супруг|супруги
małżonek - супруг
małżonka - супруга
mama - мама
mamut - мамонт
mandarynka - мандарин ; мандаринка
manetka - манетка , шифтер
mangan - марганец
manga - манга|ма́нга
mango - манго ; манго
mansarda - мансарда
mapa - карта
marchew - морковь
marcowy - мартовский
margaryna - маргарин
margiel - мергель
Marian - Мариан
marihuana - план
marionetka - марионетка
marmolada - мармелад|мармела́д
marmurek - мраморный кекс
marokański - марокканский
Maroko - Марокко
marsjański - марсианский
marszałek - маршал
marsz - марш
Mars - Марс
martwy - умерший, мёртвый, покойный; неодушевлённый, неживой; мёртвый
marynarka - пиджак ; флот
marynarz - моряк , матрос
marzec - март
marzenie - мечта
marznąć - мёрзнуть; леденеть
marzyć - мечтать
masa krytyczna - критическая масса|крити́ческая ма́сса
masaż - массаж|масса́ж
masa - масса ; заземление
maść - масть|ма́сть
maskowy - масочный
masło - масло
mastektomia - мастэктомия
maszyna - машина
maszynista - машинист
matematyczny - математический
matematyka - математика
matematyk - математик
materac - матрас
materiał wybuchowy - взрывчатка , взрывчатый|взрывчатое вещество
materiał - материал ; ткань
matka - мать ; настоятельница , игуменья
matnia - западня , ловушка
matrioszka - матрёшка
maturzystka - выпускница|выпускни́ца
Mauretania - Мавритания
Mauritius - Маврикий
mąż zaufania - доверенное лицо , '''' профуполномоченный
mąż - муж
meblowy - мебельный
mecenas - меценат
mecz - матч
mediana - медиана
mediewista - медиевист
mediolańczyk - миланец
Mediolan - Милан
mędrzec - мудрец
meduza - медуза
medycyna - медицина
mefedron - мефедрон
meitner - мейтнерий
męka - му́ка|мука , мучение, пытка, страсти Господни
Meksyk - Мексика ; Мехико
melancholia - меланхолия
melisa - мелисса
melodia - мелодия
melon - дыня
Melpomena - Мельпомена
mendelew - менделевий
Merkury - Меркурий ; Меркурий
męski - мужской; мужественный
metafora - метафора
metal - металл
metan - метан
meta - финиш
meteorytyka - метеоритика , метеорная астрономия
meteoryt - метеорит
meteor - метеор
mętny - облачный
metrampaż - верстальщик
metr kwadratowy - квадратный метр
metronom - метроном
metro - метро
mewa - чайка
mężczyzna - мужчина
mgła - туман, мгла
mianownik - именительный падеж ; знаменатель
miasto - город
miauczeć - мяукать
miau - мяу
miażdżyca - атеросклероз
Michał - Михаил
mięczak - моллюск
miecz - меч
mieć - иметь ; иметь; иметь; иметь
Międzynarodowy Dzień Kobiet - Международный женский день , восьмое марта
międzynarodowy - международный
Międzyrzec Podlaski - Мендзыжец-Подляски
między - между; среди
miejsce - место
miejscownik - предложный падеж
miejski - городской
miękkie serce - мягкое сердце
mienie - достояние , имущество
mierzyć - мерить; мерить; мерить
miesiąc - месяц
miesięcznik - ежемесячник
mięsień - мышца
mięso - мясо
mieszkać - жить
mieszkaniec - житель
mieszkanie - квартира ; проживание
mięta - мята
miętus - налим|нали́м
mifepriston - мифепристон
migawka - затвор
migiem - вмиг
migrena - мигрень
mikrocefalia - микроцефалия
mikrofon - микрофон
Mikronezja - Микронезия
mikroorganizm - микроорганизм
milczeć - молчать, безмолвствовать
mile - мило
miliarder - миллиардер
milicja - милиция
milioner - миллионер
mili- - милли-
milord - милорд
miłość - любовь
minerał towarzyszący - сопровождающий минерал , сопутствующий минерал
ministerstwo - министерство
minister - министр
mintaj - минтай
minuta - минута|мину́та
miodowy miesiąc - медовый месяц
miód - мёд ; медовуха
miotła - метла , веник
misa - таз
miseczka - чашка|ча́шка
misja - миссия
miska - миска|ми́ска , таз
Mistra - Мистра
Mistrzostwa Świata - Чемпионат мира
mitenka - митенка
mitologia - мифология
mityczny - мифический
mit - миф ; миф
mizantropia - мизантропия
mlecz - осот , одуванчик , одуванчик лекарственный
mleć - молоть
mleko - молоко|молоко́
młode - детёныш
młodość - юность, молодость
młody - молодой , юный
młodzieniec - парень
młotek - молоток
młynarz - мельник
młyn - мельница
mnemotechnika - мнемотехника
mniejszość - меньшинство
mniej więcej - более-менее
mnogość - i множество
mocny - крепкий
moczowy - мочевой
mocz - моча , ссаки
móc - мочь
modelka - модель|моде́ль
model - модель ; модель
modlić się - молиться
modliszka - богомол
modlitewny - молитвенный
modlitwa - молитва
modny - модный
modrzew - лиственница
moher - мохер
Mojżesz - Моисей
mój - мой
mokry - мокрый, сырой
Mołdawia - Молдавия
molibden - молибден
molo - мол
mol - моль
mól - моль
moment - момент
Monachium - Мюнхен
Monako - Монако
monarchia - монархия
moneta - монета
Mongolia - Монголия
Mongołka - монголка
Mongoł - монгол
monitor - монитор , компьютерный экран ; монитор
monoteistyczny - монотеистический
monoteizm - монотеизм
mops - мопс
morda - морда
morderca - убийца
morderstwo - убийство
morela - абрикос
morelowy - абрикосовый, абрикосный
moroszka - морошка|моро́шка
morski - морской; цвет морской волны
Morze Azowskie - Азовское море
Morze Bałtyckie - Балтийское море
Morze Barentsa - Баренцево море
Morze Ochockie - Охотское море
Morze Śródziemne - Средиземное море
morze - море
mosiężny - латунный
Moskwa - Москва
mostek - грудина , грудная кость
most - мост
motek - моток
motocykl - мотоцикл
motorówka - мотолодка , моторный|моторная лодка
motyl - бабочка
mowa - речь
mówić - говорить
mózg - мозг ; ум , головастик
możliwość - возможность
możliwy - возможный, возможно
można - можно
mrok - мрак
mrowisko - муравейник
mrówka - муравей
mrównik - трубкозуб
mroźno - морозно
mroźny - морозный
mróz - мороз
mrugać - моргать
msza - обедня
mszyca - тля
mucha - муха , бабочка
muezin - муэззин
muł - мул ; ил
mundur - униформа, форма
murarz - каменщик
mur - стена
musieć - нужно, должен
musnąć - коснуться, погладить; поласкать
muszka - мушка; бабочка
muszkiet - мушкет
muszla - раковина , ракушка
musztarda - горчица
muzeum - музей
muzułmanin - мусульманин
muzułmanka - мусульманка
muzyczny - музыкальный
muzykalny - музыкальный
muzyka - музыка
myć - мыть
mydlić komuś oczy - втирать очки
mydlnica lekarska - мыльнянка лекарственная
mydło - мыло
mylny - ошибочный
myśleć - думать
myśliwiec - истребитель
myśliwy - охотник
myśl - мысль ; идея
Myszka Miki - Микки Маус
myszka - мышка
mysz - мышь; мышь
my - мы
na bezrybiu i rak ryba - на безрыбье и рак рыба, на безптичье и жопа соловей
nacjonalista - националист
nacjonalizm - национализм
naczyniak krwionośny - гемангиома
naczynie - посуда
naczyniowy - сосудистый
Naddniestrze - Приднестровье
nadepnąć - наступить
nadnercze - надпочечник
na dwoje babka wróżyła - бабушка надвое сказала
nadzieja - надежда
Nadzieja - Надежда
nadzorować - надзирать, надсматривать, наблюдать
nad - над; у; к, под
nagi - нагой; голый
nagle - вдруг, неожиданно, внезапно
nagły - внезапный, неожиданный
nagminny - частый, распространенный
nagroda - награда , приз , премия
nagrywarka - накопитель
Nairobi - Найроби
naiwny - наивный
naładowanie - зарядка
naleśnik - налистник , блин
na lewą stronę - наизнанку, шиворот-навыворот
należeć - принадлежать; нужно, следует
namawiać - уговаривать
namiastka - заменитель , эрзац , суррогат
namiot - палатка
napar - навар
napastnik - агрессор
napędzać - нагонять
napędzić - нагнать
na pewno - конечно
napięcie - напряжение
napisać - написать
napój - напиток
naprawdę - действительно, всерьёз, серьёзно; неужели, действительно, разве
naprzód - вперд
na przykład - например
narciarstwo - лужнуй спорт
narciarz - лыжник
narkoman - наркоман
narodowość - национальность
narodowy - народный
naród - народ , нация
narząd - орган|о́рган
narzecze - наречие
narzeczona - невеста
narzędnik - творительный падеж
narzędzie - орудие|ору́дие
narzekać - роптать
nasiono - семя
naskórek - эпидермис
następca - преемник , наследник
następnie - потом, после, затем
następny - следующий
następować - наступать
naszyjnik - ожерелье
nasz - наш
natomiast - в то время как, зато
NATO - НАТО
naturalny - естественный
natychmiast - немедленно, сейчас же, тотчас же, сразу же, тут же, сию минуту, сию секунду
nauczycielka - учительница
nauczyciel - учитель
nauka - учёба , учение
naukowiec - учёный
naukowy - научный
nawałnica - гроза|гроза́
nawet - даже
nawiasem mówiąc - к слову сказать; кстати
nawierzchnia - мостовая
na wszelki wypadek - на всякий случай
nazad - назад|наза́д
na zdrowie - будь здоров!; за здоровье!
nazwa - название , имя
nazwisko - фамилия
nazywać - называть, звать
na - на
neandertalczyk - неандерталец
negacja - отрицание
negować - отрицать
nękać - беспокоить, преследовать, не давать покой|покоя
neodym - неодим
neologizm - неологизм
neon - неон
Nepal - Непал
neptun - нептуний
Neptun - Нептун; Нептун
newralgia - невралгия
Nicea - Ницца
niczyj - ничей
nić - нитка , нить
nic - ничто
Niderlandy - Нидерланды
niebezpieczeństwo - угроза , опасность
niebieski - синий, голубой, лазурный; небесный
nieboszczyk - мертвец , покойник
niebo - небо
niechcący - невзначай
niech - пусть
niecierpliwy - нетерпеливый
niedaleko pada jabłko od jabłoni - яблоко от яблони недалеко падает
niedawno - недавно
niedobrze - нехорошо, плохо
niedojrzały - зелёный
niedokonany - несовершенный
niedopałek - окурок
niedostatek - дефицит
niedożywienie - недоедание
niedziela - воскресенье
niedźwiedzica - медведица
niedźwiedź - медведь|медве́дь
niegodziwiec - негодяй, подлец
niegodziwość - бесчестность, подлость, низость
niekiedy - иногда
niektóry - некоторый
nielegalny - незаконный, нелегальный
nie ma róży bez kolców - не бывает розы без шипов
nie ma - нет
Niemcy Wschodnie - Восточная Германия
Niemcy Zachodnie - Западная Германия
Niemcy - Германия
Niemiecka Republika Demokratyczna - Германская Демократическая Республика ''Giermanskaja Diemokratičieskaja Riespublika''
Niemiec - немец
nienawidzić - ненавидеть
nieobecny - отсутствующий
nieoczekiwanie - неожиданно
nieoczekiwany - неожиданный
nie od razu Kraków zbudowano - Москва не сразу строилась
niepełnoletni - несовершеннолетний, малолетний, юношеский, юный, мальчишеский, детский; несовершеннолетний, малолетний, юношеский, юный, мальчишеский, детский
niepodległość - независимость
niepotrzebny - ненужный
niepowodzenie - неудача
nieprzyjemnie - неприятно
nierozłączka - неразлучник
nieść - нести
nieśmiało - застенчиво
nieśmiertelność - бессмертие
niesprawiedliwość - несправедливость
niestety - к сожалению
nieszczęście - трагедия ; беда
nietoperz - летучая мышь
niewątpliwie - несомненно, непременно
niewiele - немного
niewielki - небольшой
niewola - неволя , зависимость , подчинённость , рабство , кабала ; плен
niewolnik - раб
nie wszystko złoto, co się świeci - не всё то золото, что блестит
niewydolność - недостаточность, неработоспособность
niezależny - независимый
niezapominajka - незабудка
niezbędny - необходимый
nie zmrużyć oka - не сомкнуть глаз
nieznany - неизвестный
nie- - не-
nie - нет; нет; не
nigdy - никогда, вовек, вовеки, сроду
nigdzie - нигде
nigeryjski - нигерийский
nijaki - никакой
Nikaraguańczyk - никарагуанец
Nikaragua - Никарагуа
nikczemny - подлый
nikiel - никель
nikt - никто
niob - ниобий
niski - низкий
niszczyć - уничтожать, портить, разрушать
niuans - тонкость
Nix - Никта, Никс
niż - чем
ni - ню
nobel - нобелий
nocny - ночной
noc - ночь
noga - нога
Norwegia - Норвегия
norweski - норвежский; норвежский
nosorożec - носорог
nostalgia - ностальгия
nos - нос
notatka - записка
notes - блокнот
Nowa Zelandia - Новая Зеландия
nowoczesny - современный
noworoczny - новогодний
noworodek - новорождённый , младенец
Nowosybirsk - Новосибирск|Новосиби́рск
nowotwór - новообразование
Nowozelandczyk - новозеландец
Nowy Jork - Нью-Йорк
Nowy Rok - Новый год
nowy - новый
nóż do masła - нож для масла
nożyczki - ножницы
nóż - нож
np. - напр.
nr - №
NRD - ГДР
nuda - скука , тоска
nudny - скучный
nudysta - нудист
numer - номер
nurkować - нырять
nuta - нота|но́та
nyktofobia - никтофобия
oaza - оазис
obalać - ''ndk'' свергать, ''dk'' свергнуть; ''ndk'' опровергать, ''dk'' опровергнуть
obawa - опасение
obcas - каблук|каблу́к
obchodzić - обходить; праздновать
obcy - чужой , посторонний ; чужой, посторонний
obecność - присутствие
obecny - присутствующий
obejmować - обнимать
obelisk - обелиск
obiad - обед
obiecać - обещать
obiekt - объект
obietnica - обещание
objawiać - проявлять, показывать; проявляться
obojczyk - клю́чица
obok - возле
obora - коровник
obowiązek - обязанность
obóz - лагерь
obrabować - ограбить
obraz - картина , ''święty obraz'' образ , икона ; картина ; представление ; картина , вид ; картина
obrona - защита; оборона
obrotnica - поворотный круг , ''povorotnyj krug''
obrus - скатерть
obrzęd - обряд , ритуал
obrzyn - обрез
obserwować - наблюдать
obszar - территория ; район ; площадь ; пространство ; зона
obwodnica - кольцо , окружной|окружная дорога
obywatelka - гражданка
obywatelstwo - гражданство
obywatel - гражданин
Ocean Atlantycki - Атлантический океан
Ocean Indyjski - Индийский океан
oceanografia - океанография
Ocean Spokojny - Тихий океан
ocean - океан
ocelot - оцелот
ocena - отметка
ocet - уксус
ochota - желание , охота , аппетит , жажда
ochrona - охрана , защита ; охрана
octan - уксуснокислая соль , ацетат
o czasie - вовремя
oczekiwanie - ожидание
oczko - очко
oczywiście - конечно, несомненно, естественно; конечно, естественно
oczywisty - очевидный
odbierać - забирать; отбирать, отнимать; воспринимать
odcinek - серия ; отрезок , сегмент ; отрезок , квитанция , талон
odcisk palca - отпечаток пальца
odczuwać - ощущать; воспринимать
odczytywać - разбирать, читать, прочитывать истолковывать
oddanie - сдача ; преданность
oddawać - отдавать, возвращать
od deski do deski - от доски до доски
oddziaływać - воздействовать
oddział - отделение ; часть
odkrycie - открытие
odkurzacz - пылесос
odległość - расстояние|расстоя́ние
odległy - отдалённый, далёкий
odmiana - перемена , изменение , разновидность , для разнообразия; склонение , спряжение ; сорт , вид , вариант , подвид , разновидность
odpowiadać - отвечать; подходить
odpowiedni - соответствующий
odpowiedzialność - ответственность , ответ
odpowiedź - ответ
odpukać w malowane drewno - постучать по дереву
odśnieżarka - снегоочиститель|снегоочисти́тель
odwrotnie - наоборот
odzież - одежда
od - от
ofiara - жертва|же́ртва
oficjalny - официальный
ogień - огонь
ogier - жеребец
oglądać - осматривать, смотреть, видеть
ogłoszenie - объявление
ognisko - костёр
ogólnie - вообще, в целом; в основном
ogólnonarodowy - общенародный
ogonek - хвостик ; огонэк ; очередь
ogon - хвост
ogórek - огурец
ogród - сад , огород
ogromny - огромный
ogryzek - огрызок
ojciec - отец , родоначальник
ojczym - отчим
ojczyzna - отечество , родина , отчизна
okaryna - окарина
okazja - случай ; оказия
okienko - окошко
okno - окно
okolicznik - обстоятельство
okoń - окунь
okop - окоп , траншея
okostna - надкостница
oko za oko, ząb za ząb - око за око, зуб за зуб
oko - глаз ; ячейка
okrągły - круглый
określać - определять
określenie - определение
okres - период
okręt - корабль
oktan - октан
okulary przeciwsłoneczne - солнечный очки , солнцезащитные очки
okulary - очки
okupacja - оккупация
okupant - оккупант
okup - выкуп
oładka - оладья
olcha - ольха
olej - масло|ма́сло
Olek - Саша
oliwa - оливковое масло
ołówek - карандаш
ołtarz - алтарь
Oman - Оман
omlet - омлет
omnibus - омнибус|о́мнибус
omułek - мидия
om - ом
ona - она
oni - они
ono - оно
ontologiczny - онтологический
ONZ - ООН
on - он
opactwo - аббатство
opalać - загорать
opalenizna - загар
opat - аббат
operacja - операция
opera - опера ; опера
opiekować się - следить, присматривать, приглядывать
opierać - основываться
opiłek - опилки
opinia publiczna - общественное мнение
opinia - мнение ; репутация
opium - опиум
opłata - оплата
opornik - резистор|рези́стор
opór - сопротивление
opowiadać - рассказывать
opowiedzieć - рассказать
opozycja - оппозиция
oprócz - кроме
oprogramowanie - программное обеспечение
orać - вспахивать
ordalia - ордалии
organiczny - органический
Organizacja Narodów Zjednoczonych - Организация Объединённых Наций
Organizacja Traktatu Północnoatlantyckiego - Организация Североатлантического договора
organizacja - организация
organizator - организатор
organizm - организм
organy - орган|орга́н
organza - органза|органза́
organ - орган|о́рган ; орган|о́рган
orientalistyka - востоковедение , ориенталистика
orka - косатка
Ormianin - армянин
oryginał - оригинал , подлинник
orzech - орех
orzeczenie - сказуемое ; мнение , суждение ; решение / приговор
orzeł - орёл
osa - оса
ósemka - восьмёрка ; восьмёрка , номер восемь ; восьмая
Osetia Południowa - Южная Осетия , ЮО
osetyjski - осетинский
osierdzie - перикард
osika - осина
osioł - осёл ; ишак
oskarżony - обвиняемый|обвиня́емый, подсудимый|подсуди́мый
osm - осмий
osnowa - основа
osoba - человек ; лицо ; лицо ; герой
ośrodek - центр
ostateczny - последний, конечный, окончательный
Ostatnia Wieczerza - Тайная вечеря
ostatni - последний
ostrożnie - осторожно, внимательно
ostryga - устрица
ostry - острый
ostrzegać - предупреждать
oświadczać - заявлять, объявлять
Oświęcim - Освенцим
oszukiwać - обманывать, надувать
oszust - мошенник , жулик , плут , пройдоха , обманщик
oś - ось
otaczać - окружать
otrzymać - получить
otucha - бодрость
otwarcie - открыто, откровенно, прямо, искренне; открытие ; дебют
otwarty - открытый
otwierać - открывать/открыть , отворять/отворить ''tylko drzwi''
owad - насекомое
owca - овца
ówdzie - там, в другой|другом место|месте
Owernia - Овернь
owies - овёс
owijać w bawełnę - говорить обиняками
o wilku mowa - лёгок на помине
owoc - фрукт; плод
ozdabiać - украшать
pacha - подмышка
pachnieć - пахнуть
pachołek - кнехт
pączek - пончик
paczka - посылка
padać - падать, сваливаться; потерпеть поражение; издыхать, околевать идти|идёт, лить|льёт, дождить
padlina - падаль
Pad - По
pager - пейджер
pagórek - холм
pajac - паяц , шут , скоморох , клоун ; марионетка , кукла
pająk - паук
pajęczyna - паутина
pakamera - паккамера
Pakistańczyk - пакистанец
pakistański - пакистанский
Pakistan - Пакистан
pakować - влезать
pakt - пакт
palacz - курильщик, курящий ; кочегар
pałac - дворец|дворе́ц
palec - палец , , ''górnolotnie'' перст , штифт
paleoproterozoik - палеопротерозой
Palestyna - Палестина
Palestyńczyk - палестинец
palić - жечь; курить; жечь
palimpsest - палимпсест
palindrom - палиндром
paliwo - горючее , топливо
pallad - палладий
palma - пальма
palnąć - ляпнуть
pamięć - память
pamiętać - помнить; помнить; помнить
panamczyk - панамец
Panamczyk - панамец
Pan Bóg nierychliwy, ale sprawiedliwy - Бог долго ждёт, да больно бьёт
pancerz - панцирь
pandeizm - пандеизм
pani - вы; хозяйка
Panna - Дева ''Dieva''
panna - незамужняя
panorama - панорама
państwowy - государственный
państwo - государство , страна ; вы
pantałyk - панталык
pantoflarz - подкаблучник
pantograf - пантограф ; пантограф , токоприёмник
pan - вы, господин ; господин ; господин ; господин ; господин ; господин
Pan - Господ
papa - толь
papierośnica - портсигар , сигаретница
papieros - сигарета ; ''bez filtra'' папироса
papier ścierny - наждачная бумага, шлифовальная бумага
papier wartościowy - ценные бумаги
papier - бумага ; бумага|бумаги
papież - папа римский
paproć - папоротник
papryka - перец|пе́рец ; сладкий|сла́дкий перец|пе́рец ; горький|го́рький/острый|о́стрый перец|пе́рец
papuga - попугай
paracetamol - парацетамол
paradygmat - парадигма
parafia - церковный приход
Paragwaj - Парагвай
parapetówka - новоселье|новосе́лье
parasol - зонт, зонтик
para- - пара-
para - пара , чета ; пара , чета ; пара , чета ; пара , чета ; пара , чета ; пар
parcie - усилие
park narodowy - заповедник
park - парк
parlament - парламент
parostatek - пароход
parówka - сосиска|соси́ска
parowóz - паровоз
parter - первый этаж
partia polityczna - политическая партия
partia - партия
partykuła - частица
Paryż - Париж
parzyć - жечь
pasieka - пасека
pasikonik - кузнечик
pasjans - пасьянс
pasja - увлечение , страсть
pasożyt - паразит
pasta do zębów - зубная паста
pasta - паста , крем ''''
pasteryzacja - пастеризация
pasterz - пастух ; пастырь
paszport - паспорт
pasztet - паштет
pas - пояс, ремень; ремень; полоса; талия, пояс
patelnia - сковорода , сковородка
patison - патиссон
patriotyzm - патриотизм
patrzeć - смотреть, глядеть, посмотреть, усмотреть, осмотреть, присмотреть
Paweł - Павел
pawian - павиан
paw - павлин
październik - октябрь
paznokieć - ноготь
pazur - коготь
pchła - блоха|блоха́
pchli targ - блошиный рынок
pchnięcie kulą - толкание ядра
pefloksacyna - пефлоксацин
pejoratywny - уничижительный
pejzaż - пейзаж
pelargonia - герань
Pełczyce - Пелчице
pelikan - пеликан
pełny - полный
peloid - грязевые ванны
pentan - пентан
pępek - пуп , пупок
perła - жемчуг
peron - перрон
Persja - Персия
personifikacja - персонификация
persymona - хурма /χurmá/
Peru - Перу
peryskop - перископ
pesymistyczny - пессимистичный
pesymizm - пессимизм
pętla - петля
petrografia - петрография
petycja - петиция
pewien - некоторый, некий; уверенный
piać - кукарекать
piana - пена
pianista - пианист
pianistka - пианистка
piasek - песок
piaskowy - песчаный
piąta kolumna - пятая колонна
piątek - пятница
pić - пить
piechota - пехота
Pięcioksiąg - Пятикнижие
pięciopalczasty - пятипалый
pieczarka - шампиньон
pieczęć - печать
pieczeń - жаркое
pieczone gołąbki nie lecą same do gąbki - не хочешь есть колачи, сиди на печи
piec - печь ; печь; гореть, печь; жечь
pieg - веснушка
piekarnia - пекарня ; булочная
piekarz - пекарь
piekło - ад
piękno - красота
piękny - красивый
pielęgniarka - медсестра
pieluszka - пелёнка
pieniądz - деньги
pień - ствол
pieprz - перец
pierdel - тюряга , тюрьма
pierdolić - ебать
pieriestrojka - перестройка
piernik - пряник , коврижка
pierogownica - пелъменница
pieróg - пирог
pierś - грудь ; филе
pierwiastek - химический элемент ; корень
pierwsza pomoc - первая помощь
pięść - кулак
piesek - собачка , пёсик
pies ogrodnika - собака на сене
pieszo - пешком
pies - собака , пёс
pięta Achillesa - ахиллесова пята
piętro - этаж
pietruszka - петрушка
pigwa - айва
pijak - пьяница ; пьяный
pijany jak bela - пьян как сапожник
pijany - пьяный; пьяный
piła - пила
piłka nożna - футбол
piłka ręczna - гандбол
piłkarz - футболист
piłka - мяч
pilnować - караулить; присматривать
pilot - пилот ; пульт
pingwin - пингвин
pionek - пешка
piórnik - пенал
pióro - перо ; перо , лопасть
piorun - молния
piosenkarz - певец , вокалист
piosenka - песенка , песня
Piotr - Пётр
piramida - пирамида|пирами́да
pisać - писать
pisanka - писанка
pisarz - писатель
pismo - письмо ; журнал
pistacja - фисташка
pistolet maszynowy - пистолет-пулемёт
pistolet samopowtarzalny - самозарядный пистолет
pistolet - пистолет
pisuar - писсуар
piszczeć - пищать; пищать
Pitagoras - Пифагор
piwiarnia - пивная|пивна́я
piwnica - подвал , погреб ; погреб
piwo - пиво
piżama - пижама|пижа́ма
pizda - пизда
Pizydia - Писидия
pizza - пицца
płacić - платить
płacz - плач
plac - площадь
plafon - плафон; плафон
płakać jak bóbr - лить слёзы в три ручья
płakać - плакать
plakat - плакат|плака́т
planetarium - планетарий
planeta - планета
plan miasta - план города
plan - план
płaski - плоский|пло́ский
plastik - пластмасса ; пластиковая взрывчатка
płaszczyzna - равнина ; плоскость
płaszcz - плащ ; мантия
płatek śniegu - снежинка
płatek - лепесток; снежинка
platyna - платина
plaża - пляж
plażowy - пляжный
płaz - земноводные
płciowy - сексуальный, половой
plebiscyt - плебисцит
plecak - рюкзак , ранец
plecy - спина
płeć - пол
pleść - плести; молоть
plon - урожай , жатва , сжать|сжатые хлеб|хлеба ; плод|плоды , результат|результаты
plotka - сплетня
plotkować - сплетничать, чесать язык
płótno - полотно|полотно́
płuco - лёгкое
pług - плуг
pluskwiak - клоп
pluszowy miś - тэдди-бер
pluton - плутоний ; взвод
Pluton - Плутон; Плутон
płynny - жидкий, жидкость; плавный
płyn - жидкость
płyta - плита ; диск
płytki - мелкий, неглубокий
pływać - плавать; плавать
pływak - поплавок ; пловец
pocałunek - поцелуй
pochodna - производная ; производное соединение
pochodzenie - происхождение
pochodzić - ''ndk'' происходить, ''dk'' произойти; походить
pochwa - влагалище, ножны
pociąg - поезд
pocić się - потеть
pociecha - утешение
początek - начало
początkowy - начальный
poczta pantoflowa - сарафанное радио
poczta - почта
pocztówka - открытка
pocztowy - почтовый
podanie - заявление ; предание ; подача
podatek - налог
podbródek - борода
podczas - во время
poddasze - чердак|черда́к
podeszwa - подошва
podkoszulek - майка
podkowa - подкова
podle - подло
podłoga - пол
podłość - подлость|по́длость
podmiejski - загородный
podmiot - подлежащее
podobać się - нравиться
podobno - якобы
podobny - похожий; подобный
podpalenie - поджог
podpisać - подписать
podpis - подпись
podpowiedź - подсказка
podpułkownik - подполковник
podręcznik - учебник
podróżnik - путешественник
podróżować - путешествовать
podróż - путешествие , поездка
po drugie - во-вторых
podskok - подскок , прыжок
podsłuch - баггинг ; баггинг
podstawa prawna - правовая основа
podstawa - основание , база ; основа , база , основание ; основа
poduszka powietrzna - подушка безопасности , аварийная предохранительная подушка
poduszka - подушка
podwójny - двойной
podziewać - подевать; подеваться
podziwiać - восхищаться
pod - под; у; к
poezja - поэзия
poganin - язычник
pogański - языческий
pogarda - презрение
pogląd - мнение
pogoda - погода
pogrzeb - похороны
pojawiać się - появляться, возникать
pojawić się - появиться|появи́ться
pojechać - поехать, пойти
pojęcie - понимание; понятие
pojedynczy - одиночный, единичный, отдельный, частный
pojemnik - контейнер
pójść do Canossy - идти в Каноссу
pójść - пойти
pojutrze - послезавтра
pokal - бокал|бока́л
pokazywać - показывать; показывать; показывать; показывать; показывать
pokaz - показ
pokój gościnny - гостиная
pokój - мир ; мир ; мир ; комната
pokrótce - вкратце
pokrywać - покрывать
pokrzywa - крапива
pokrzywka - крапивница
pokuta - покаяние
pokwitowanie - квитанция
połączenie - соединение
Polak - поляк
polana - поляна
Polanów - Полянув
polędwica - филей
polerować - полировать; шлифовать
półgłosem - вполголоса
policja - полиция
policzek - щека ; пощёчина
politechnika - политехникум , политехника , политехнический институт
polityczny - политический
polityka - политика
politykier - политикан
polityk - политик
półka - полка , стеллаж ; уступ скала|скалы
półnagi - полуголый
północny - северный, северно-
północ - полночь ; север
Północ - Север ; север
polon - полоний
polowanie - охота
połowa - половина
połówka - половинка
położenie - местоположение
położyć - положить|положи́ть
półsamogłoska - сонорный
Polska - Польша
półsłodki - полусладкий
południe - полдень ; юг
Południe - Юг ; юг
południk - меридиан
południowy wschód - юго-восток
południowy - южный
półwysep - полуостров
pół - пол, половина
pomagać - помогать
pomarańcza - апельсин
pomarańczowy - оранжевый; апельсиновый, апельсинный
pomidorówka - томатный суп
pomidor - помидор
pomieszczenie - помещение
pomnik - памятник|па́мятник
pomocnik - помощник ; ассистент
pomóc - помочь
pomoc - помощь
po moim trupie - через мой труп
pomorski - поморской
Pomorzanin - Поморян
pomysł - идея|иде́я
ponad - выше, свыше
pończocha - чулок
poniedziałek - понедельник
ponieważ - потому что , так как , поскольку , ведь , ибо
poniewczasie - слишком поздно
ponton - понтон
ponury - пасмурный
popielniczka - пепельница
popierać - поддерживать
po pierwsze - во-первых
popiół - зола , пепел
poprawny - правильный
poprzedni - прошлый
popularny - популярный
populizm - популизм
pop - поп ; поп , попса
pora roku - время года , сезон
pora - время ; пора
porcja - порция
poronienie - аборт
portfel - кошелёк , бумажник
portier - вахтёр
portret - портрет ; портрет
Portugalia - Португалия
port - порт ; аэропорт , аэродром
porucznik - старший лейтенант
porządek - порядок , чистота ; наводить порядок
porządkowy - относиться|относящийся к поддержание|поддержанию порядок|порядка ; порядковый; распорядитель
porzeczka - смородина
por - лук-порей, порей
posada - должность посад
posag - приданое|прида́ное
Posejdon - Посейдон
poseł - депутат
posiadać - иметь, быть
posiłek - еда ; еда
pośladek - ягодица|я́годица
poślubić - жениться
pośpiech - торопливость
postać - форма , состояние ; фигура , стать ; персонаж , образ ; постоять
postępować - действовать
postępowanie - процесс , производство , судопроизводство судебный|судебная процедура ; поведение , действие ; обращение
poświęcać - жертвовать; уделять
poszlaka - улика
poszukiwacz - искатель
potas - калий
potem - потом, после, затем
potomek - потомок , наследник
potomstwo - потомство
potop - потоп
potrawa - кушанье , блюдо
potrzeba - нужда ; нужда ; надо, нужно
potrzebny - нужный
potrzebować - нуждаться ''в чём'', ''что'' нужно ''кому''
potwierdzać - подтверждать
potwierdzić - подтвердить
potwór - урод ; зверь, изверг, изувер, монстр
potyczka - столкновение
poważanie - уважение
powiat - повят
powiedzieć - сказать
powieka - веко
powierzchnia - поверхность ; площадь ; плоскость
powieść - роман
powietrze - воздух
powietrzny - воздушный
powinien - должен
powinność - обязательство , долг
powodować - возбуждать, создавать
powodziowy - паводковый
powódź - наводнение ; наплыв
powód - повод
powoli - медленно
powstaniec - повстанец
powstanie - восстание
pożar - пожар
poza - поза ; вне
pozbawiać - лишать
poziomica - уровень , ватерпас
Poznań - Познань
późno - поздно
pozostawać - оставаться
pozwalać - разрешать, позволять; разрешать, позволять
pożyczać - одалживать, брать в долг
pożyczyć - одолжить, взять в долг
pozytywny - позитивен, позитивный; положителен, положительный
po - после
prababcia - прабабушка
praca - работа , труд ; работа ; работа ; механический|механическая работа ; работа
prącie - половой член ; пенис
pracochłonny - трудоёмкий
pracodawca - работодатель
pracować - работать
pracowity - трудолюбивый
pracownica - работница , служашая , сотрудница , труженица
pracownik - работник|рабо́тник , трудящийся|трудя́щийся
pradziadek - прадед , прадедушка
prąd - ток ; направление , тенденция
pragnienie - жажда ; желание
pralka - стиральная машина
pranie - стирка
prawa człowieka - права человека
prawa zwierząt - права животных
prawda - правда , истина
prawdziwych przyjaciół poznaje się w biedzie - друг познаётся в беде
prawdziwy - правдивый, истинный, настоящий; настоящий
prawica - правые
prawie - почти
prawnik - юрист|юри́ст
prawnuczka - правнучка
prawnuk - правнук
Prawo i Sprawiedliwość - Право и справедливость, Закон и справедливость
prawo jazdy - водительское удостоверение
prawo jest po to, aby je omijać - нет закона без обхода
prawo - право , закон ; право ; право ; право ; право
prawy - правый; лицевой
prazeodym - празеодим
precyzja - точность
precz - прочь
prędkościomierz - спидометр
prędkość - скорость
prehistoria - протоистория
premiera - премьера
premier - премьер , премьер-министр
prenumerata - подписка
pretekst - предлог
pręt - прут, стержень
prezent - подарок
prezydent - президент; мэр
prima aprilis - Первое апреля , День смеха , День дурака
primogenitura - первородство
próba - репетиция ; проба , испытание , проверка ; попытка ; проба
problem - проблема
próbować - пробовать; репетировать
procent - процент
procesor - процессор
proces - процесс
prochowiec - плащ|пла́щ
proch - тлен
produkować - производить, выпускать
programista - программист
programować - программировать
programowanie - программирование
program - программа ; программа ; программа ; программа ; программа
projekt - проект ; проект , план
promet - прометий
promień - луч ; радиус
prom - паром
propan - пропан
propen - пропен
propozycja - предложение
propylen - пропилен
propyn - пропин , метилацетилен
proroctwo - пророчество
prorok - пророк
prosić - просить; звать
prosta - прямая
prostokąt - прямоугольник
prosto spod igły - с иголочки
prostytutka - проститутка
prosty - прямой; ровный; простой, просто
proszek - порошок
proszę - пожалуйста
protaktyn - протактиний
protekcjonizm - протекционизм
protestować - протестовать, возражать
protokół - протокол , акт
proton - протон
prowadzić - вести
prowansalski - окситанский
prowokować - провоцировать
próżnia - вакуум
pruć - пороть, распарывать, распускать; шпарить, жарить, строчить
Prusy - Пруссия
prymatologia - приматология
prymatolog - приматолог
pryncypał - принципал
prysznic - душ
przebieg - течение
przebieraniec - ряженный
przechowywać - хранить, беречь; прятать, укрывать
przeciąg - сквозняк
przecinek - запятая
przeciwalergiczny - противоаллергический
przeciwciało - антитело
przeciwlotniczy - противовоздушный
przeciwnik - противник ; противник
przeciwpancerny - противотанковый; бронебойный
przeć - переть
przeddzień - канун
przede wszystkim - главный, особенно, особо, прежде всего, предимно
przedmieście - предместье
przedmiesiączkowy - предменструальный
przedmiot - предмет
przedpokój - коридор
przedsiębiorstwo - предприятие
przedstawiciel - представитель
przedstawienie - спектакль
przedwczoraj - позавчера
przed - спереди
przegapić - пропустить, прозевать
przejęzyczenie - оговорка
przejście - переход|перехо́д; переход|перехо́д
przekątna - диагональ
przekaźnik - реле
przekleństwo - проклятие
przełęcz - перевал
przelew - перевод
przełom - грань
przemoc - насилие
przemysłowy - промышленный
przemysł - промышленность|промы́шленность
przenosić - переносить, перемещать
przenośnie - переносно
przeorysza - аббатиса
przepaść jak kamień w wodę - как в воду кануть
przepaść - пропасть|про́пасть ; пропасть|пропа́сть
przepierka - постирушка
przepijać - пропивать
przepiórka - обыкновенный перепел|обыкнове́нный пе́репел , перепёлка
przepraszać - просйть прощения|проще́ния, извинения|извине́ния, извиняться|извиня́ться
przepraszam - извините, простите
przepuścić - пропустить
przepuszczać - пропустить
przerwa - перерыв , пауза ; перерыв
prześcieradło - простыня
przestarzały - устаревший, старый
przestępca - преступник , уголовный преступник
przestępstwo - преступление
przestrzegać - соблюдать
przestrzeń kosmiczna - космическое пространство
przestrzeń - пространство
przeszkadzać - мешать, препятствовать
przeszkoda - помеха
przeszłość - прошлое
przeszły - прошлый; прошедший, минувший; прошлый
przewlekły - хронический, затяжной
przewodnik - гид , экскурсовод ; проводник ; вожак , гуру ; путеводитель ; проводник
przewód opadowy - опускная труба
przewód wznośny - подъемная труба
przewód - провод|про́вод
przeznaczony - предназначенный
przez - через
przodek - предок
przychodzić - ''ndk'' приходить, ''dk'' прийти; наступить; даваться
przychylny - доброжелательный
przyczyna - причина
przydawka - определение
przygoda - приключение
przyimek - предлог
przyjaciel - друг , приятель
przyjaźń - дружба
przyjemność - удовольствие
przyjmować - принимать
przyjść - прийти
przykład - пример
przykrość - неприятность
przymiotnik - прилагательное
przypadek - случай ; случайно; падеж
przypisywać - определять
przypominać - вспоминать ''''; напоминать
przyprawa - приправа
przyroda - природа
przyrostek - суффикс
przysięgać - клясться; присягать
przysięga - присяга
przysłaniać - вуалировать
przysłówek - наречие
przysłowie - пословица
przystanek - остановка|остано́вка
przyszłość - будущее
przyszły - будущий
przytulić - обнять
przyzębie - десна
przyznawać - признаваться
pseudonauka - лженаука
psiara - собачница
Psków - Псков
psychiatra - психиатр
psychiatria - психиатрия
psychologia - психология
psycholog - психолог
pszczelarz - пчеловод , пасечник
pszczeli - пчелиный
pszczoła - пчела
pszenica - пшеница
Ptah - Птах
ptak - птица
ptasia grypa - птичий грипп
ptaszek - пичуга; пташка; птичка
publiczność - публика
puchacz - филин
pucować - надраивать, начищать, тщательно чистить
pudel - пудель
puder - пудра
pudło - коробка
puma - пума , кугуар
pumeks - пемза
punkt - точка
purga - пурга
purpurowy - пурпуровый|пурпу́ровый, пурпурный|пурпу́рный
pustynia - пустыня
pusty - пустой
puszka - жестянка
putrescyna - путресцин
pycha - высокомерие
Pyrzyce - Пыжице
pyszny - вкусный ; гордый
pytać - спрашивать
pytanie retoryczne - реторический вопрос
pytanie - вопрос ; вопрос ; спрашивание
rabarbar - ревень
rabat - скидка
rabować - грабить
rabuś - грабитель
rachatłukum - лукум
Rachela - Рахиль
rachunek - счёт
racja - правота , правда , истина ; паёк , рацион , порция
rączka - ручка
raczyć - соизволить; угощать, потчевать; угощаться, лакомиться
radar - радар
rada - совет|сове́т
radiator - радиатор
radio - радио ; радио , радиоприёмник , приёмник ; радио|радио-
radon - радон '' ''
radość - радость
radzić - советовать
rad - радий
rajstopy - колготки
raj - рай , эдем
rak - рак
Rak - Рак
ramię - плечо
ramka - рамка
randka - свидание, свиданка
ranny ptaszek - ранняя пташка
ranny - раненый; ранний
rano - утром; утро
raróg - балабан , балобан
rasizm - расизм
ratownik - спаситель, спасатель ; спасатель
ratunek - помощь , подмога , спасение ; спасение
razem - вместе, вкупе
rdza - ржавчина
rdzeń - корень
reakcja - реакция|реа́кция
reaktor - реактор
realistycznie - реалистично
realizować - выполнять
recenzja - рецензия
recesja - рецессия
ręcznik - полотенце
Recz - Реч
reformator - реформатор
regularny - регулярный
reguła - правило ; правило
rejon - район
rękawica - перчатка , варежка
rękaw - рукав
ręka - рука
rekin - акула
reklama - объявление , реклама , анонс , заявление , извещение
rekomendacja - рекомендация
rekonwalescent - выздоравливающий
rękopis - рукопись
rekuperator - рекуператор
rekwizytor - бутафор
religia - религия
religijny - религиозный; набожный
renifer - северный олень
ren - рений
reporter - репортёр , корреспондент
Republika Czeska - Чешская Республика
Republika Federalna Niemiec - Федеративная Республика Германия
Republika Gambii - Республика Гамбия
Republika Korei - Республика Корея
Republika Słowacka - Словацкая Республика
republika - республика
Resko - Реско
restauracja - ресторан ; реставрация
reszta - остальной|остальная часть , остаток ; сдача ; остаток
retro - ретро, стиль ретро
rewolucja - революция
rewolwer - револьвер
RFN - ФРГ
risotto - ризотто
robić z igły widły - делать из мухи слона
robić - делать
robota - работа
robotnik - рабочий
robot - робот
rock - рок
rodzajnik - артикль
rodzaj - род
rodzic - родитель
rodzimy - родной
rodzinny - ceméйный; родно́й
rodzynek - изюмина , изюм
rod - родий
roentgen - рентгений
rogal - рогалик
rój - рой
rokitnik - облепиха|облепи́ха
rok - год
rolniczy - сельский, аграрный
rolnik - земледелец|земледе́лец , аграрник|агра́рник
Roman - Роман
Rom - ромал
ropień - абсцесс
roponośny - нефтеносный
ropucha - жаба
rosa - роса
Rosjanin - русский|ру́сский
Rosja - Россия
roślina - растение
rosnąć - расти; всходить
rosół - куриный, бульон
rosomak - росомаха
rosyjski - русский
rowerek - велосипедик
rower - велосипед
równanie stanu - уравнение состояния
równanie - уравнение
również - тоже, также
równikowy - экваториальный
równik - экватор
równoległy - параллельный
równość - равенство ; тождественность , идентичность , одинаковость ; ровность , гладкость
równoważnik zdania - номинативное предложение
rów - ров
róża - роза
rozczarowanie - разочарование
rozdrażnienie - раздражение
różdżka - волшебная палочка
rozeta - роза; розетка
rozkład jazdy - расписание
rozkoszować się - наслаждаться
rozmawiać - разговаривать, беседовать
rozmowa - разговор
rozmówki - разговорник
rozmowny - разговорчивый
różnica - разность ; разница , различие
różny - иной, разный; разный, другой
różowy - розовый|ро́зовый
rozpacz - отчаяние
rozpadlina - разлом
rozrywka - развлечение
rozsądny - разумный
roztargniony - рассеянный
roztwór - раствор
rozumieć - понимать
rozumny - разумный
rozum - ум
rozwlekły - растянутуй
rozwód - развод
rozwój - развитие
ro - ро
rtęć - ртуть
rubel - рубль
rubid - рубидий
rubież - рубеж
rubin - рубин
ruch - движение ; ход
rufa - корма
Rumunia - Румыния
rum - ром
rura - труба
ruten - рутений
rutherford - резерфордий
rwanda - руанда
Rwanda - Руанда
rybak - рыбак , рыболов
ryba - рыба
Ryby - Рыбы ''Ryby''
rycerz - рыцарь
rycina - гравюра
ryć - рыть, копать
rydz - рыжик
ryż - рис
rzadko - редко
rządzić - управлять; управлять; руководиться
rząd - правительство ; ряд ; порядок
rzeczownik - имя существительное
rzeczywistość - действительность , реальность
rzecz - вещь
rzec - сказать
rzeka - река
rzemieślniczy - ремесленный
rzemieślnik - ремесленник
rzemiosło - ремесло
rzęsa - ресница
Rzeszów - Жешув
rzeżączka - гонорея
rzeźbiarz - скульптор
rzeźnik - мясник
rzeżucha - кресс-салат , огородный перечник , сердечник
rzodkiewka - редиска
rzucać perły przed wieprze - метать бисер перед свиньями
rzucać - кидать, бросать
rzucić - бросить
rzut karny - пенальти /
rzut - бросок
sabotaż - саботаж
sadzić - садить|сади́ть
sądzić - судить
sąd - суд; суждение
sad - фруктовый сад
Saipan - Сайпан
saksofonista - саксофонист
saksofon - саксофон
salami - салями
sałata - салат
sala - зал
salceson - сальтисон, сальцесон
Saloniki - Салоники, Фессалоники
Salwadorczyk - сальвадорец
Salwador - Сальвадор
samar - Самарий
samica - самка
samobójca - самоубийца
samobójstwo - самоубийство , суицид
samochodowy - автомобильный
samochód - автомобиль , машина
samodzielny - самостоятельный
samolot - самолёт
saneczkarstwo - бобслей
sangwina - сангина
sanie - сани
sankarz - санник
sanki - санки
sanktuarium - святилище
San Marino - Сан Марино
sardela - анчоус
Sarepta - Сарепта ; Сарепта
sarkofag - саркофаг
sarkopenia - саркопения
sarna - косуля
sąsiadka - соседка
sąsiad - сосед
sąsiedztwo - соседство
satelita - спутник
Saturn - Сатурн; Сатурн
SA - АО
scenarzysta - сценарист
scena - сцена ; явление
scenografia - обстановка
sceptyk - скептик
schować - спрятать
schowek - бардачок ''''
schronienie - укрытие
ściana - стена ; грань
ścięgno - сухожилие|сухожи́лие
ścieki - источные воды
ścierać - стирать, вытирать; тереть, стирать, растирать; стирать; стирать, натирать
ścierwo - стерво
ścieżka - тропа , тропинка , дорожка ; имя файла ; дорожка
seaborg - сиборгий
sedno - суть , соль , существо , суть
sędzia - судья
Sejm - Сейм
sekciarski - сектантский
seksturystyka - секс-туризм
seksualny - половой сексуальный
seks - секс
sekunda - секунда
Sekwana - Сена
selen - селен
seler - сельдерей
semicki - семитский
sen - сон ; сон; мечта
sepulka - сепулька&lt;ref&gt;Stanisław Lem ''Звездные дневники Ийона Тихого'', ACT, 2005&lt;/ref&gt; ; сепулька
sepulkowate - сепульковые
Serbia i Czarnogóra - Сербия и Черногория
Serbia - Сербия
Serbka - сербка
Serb - серб
serce - сердце ; язык
serdeczność - сердечность, радушие
serdeczny - сердечный
serpentyna - серпантин|серпанти́н ; серпантин|серпанти́н
serwer - сервер
ser - сыр , творог
sezon - сезон ; сезон ; сезон
sfrustrowany - раздражённый
siać - сеять
siadać - садиться
sianokosy - покос
Sianów - Сянув
siano - сено
siarczyn - сульфит
siarka - сера
siarkowodór - сероводород, сульфид водорода
siąść - сесть
siebie - себя
Siedlce - Седлец
siedzieć - сидеть
siedzieć - сидеть
siekiera - топор
sierpień - август
sierpniowy - августовский
sierść - шерсть
się - -ся/-сь
sikać - писать
sikorka - синица
siła - сила
silikonowy - силиконовый
silnik - мотор , двигатель
silny - сильный
siłownia - тренажёрный зал
Singapur - Сингапур
sinolog - китаевед , синолог
sin - sin
sinus - синус
siodło - седло
siostra - сестра
siostrzeniec - племянник
siusiak - сюсяк
siwy - седой|седо́й
skąd - откуда; откуда
skakać - скакать, прыгать; плясать, подпрыгивать
skała - горная порода ; скала , утёс
skandal - скандал ; скандал
Skandynawia - Скандинавия
skand - Скандий
skaningowy mikroskop tunelowy - сканирующий туннельный микроскоп
skąpy - скупой, скудный
skarpeta - носок
skarpetka - носок , носочек
sklep - магазин|магази́н
skłonny - склонный
skoczek - конь
skomplikowany - сложный; сложный
skończony - законченный, конечный
skóra - кожа ; шкурка , кожица , кожура
Skorpion - Скорпион ''Skorpion''
skowronek - жаворонок
skromny - скромный
skroń - висок
skrótowiec - аббревиатура
skrzele - жабры
skrzydłówka - флюгельгорн
skrzydło - крыло ; крыло ; крыло ; крыло ; створка
skrzynka - ящик|я́щик ; почтовый ящик|почто́вый я́щик
skrzypaczka - скрипачка
skrzypce - скрипка
skrzypek - скрипач
skrzyżowanie - скрещение ; перекрёсток
skuteczny - эффективный
skutek - результат , следствие , последствие
słaby - слабый
ślad - след
Śląsk Cieszyński - Тешинская Силезия
sława - слава
sławny - славный, прославленный, знаменитый
śledzić - следить
śledziona - селезёнка
śledź - сельдь , селёдка
ślepy - слепой
ślimak - улитка , слизняк , слизень ; брюхоногие , гастроподы ; улитка , спиральный/извилистый подъём ; волюта , завиток , спираль ; улитка , завиток ; червячная передача , червяк , бесконечный винт
śliwa - слива
śliwka - слива
ślizgać się - скользить; скользить
słodki - сладкий
słońce - солнце
Słońce - Солнце
słonecznik - подсолнух
słoneczny - солнечный
słonica - слониха
słony - солёный
słoń - слон
Słowacja - Словакия
słowacki - словацкий
Słowenia - Словения
słowiański - славянский
słowik - соловей
słownik - словарь
słowo - слово
ślub - свадьба ; присяга , клятва
słuchać - слушать
słuchowisko - радиопередача , радиопостановка
Słupsk - Слупск
slup - шлюп
służba - служба
słyszeć - слышать
smaczny - вкусный
smakować - пробовать
smak - вкус
smartfon - смартфон|смартфо́н
śmiać się - смеяться
śmiałość - смелость
śmiech - смех
śmieciarka - мусоровоз
śmieciarz - мусорщик
śmierć - смерть
śmierdzieć - вонять
śmiertelny - смертельный; смертный
śmietana - сметана
śmietnik - мусорный ящик , мусорка ; помойка , мусорка
smok - дракон , змей
smukły - стройный, гибкий
smutek - грусть , тоска
smutny - грустный
smyk - карапуз
snajper - снайпер
śniadanie - завтрак
śnieg - снег
sobie - себя|себе
sobota - суббота
socjalistyczny - социалистический
socjologia - социология
soczewica - чечевица
soczysty - сочный
sód - натрий
sokolnik - сокольник
sokół - сокол
sok - сок
sola - морской язык
sól fizjologiczna - физиологический раствор
solić - солить
solidarność - солидарность|солида́рность
solniczka - солонка
solo - соло
sól - соль ; соль
Somalijczyk - сомалиец
somalijski - сомалийский
sonata - соната
sonet - сонем
sopel - сосулька
Sopot - Сопот
sosna - сосна|сосна́
sos - соус
sowa śnieżna - белая сова
sowa - сова , сыч , филин
spacer - прогулка
spać jak suseł - спать как сурок, спать как убитый
spacja - пробел
spać - спать
spadać - падать, валиться, сваливаться; падать, доставаться, приходиться на долю|приходиться на чью-то долю; падать, спадать, понижаться, убывать, уменьшаться, ослабевать, идти на убыль; чесать, пойти, убираться
spadek - наследство ; спад , спуск , понижение
specyficzny - специфический, характерный; специфический, особый
spermina - геронтин, мускуламин, нейридин, спермин
śpiący - сонный
spichrz - амбар
śpiewać - петь
śpiewak - певец
śpioch - соня
spironolakton - спиронолактон
śpiwór - спальный мешок
spodek - блюдце
spodenki - штанишки|штани́шки
spódnica - юбка
spodnie - штаны
spodziectwo - гипоспадия
spodziewać się - ожидать; ждать
spod - из-под
spójnik - союз
spojrzeć - взглянуть , посмотреть
spojrzenie - взгляд
spokojnie - спокойно
spokojny - спокойный
spokój - спокойствие
społeczeństwo - общество
społeczny - общественный
sportowiec - спортсмен
sport - спорт
spór - спор
sposób - способ, метод
spośród - из числа
spotkanie - встреча
spowiedź - исповедь, признание
spóźniać się - опаздывать
spożycie - потребление
sprawa - дело
sprawca - виновник
sprawiedliwość - справедливость , правосудие
Sprawiedliwy wśród Narodów Świata - Праведники мира
sprzedawać - продавать, продать
sprzedawca - продавец
sprzedawczyni - продавщица
sprzęgło - муфта
sprzyjać - способствовать
sp. z o.o. - ООО
srebrny - серебристый|сере́бристый; серебряный
srebro - серебро
średnik - точка с запятой
średniowiecze - средневековье
średniowieczny - средневековый
średnio-wysoko-niemiecki - Средневерхненемецкий
Sri Lanka - Шри-Ланка
Środa Popielcowa - Пепельная среда
środa - среда
środek przeciwstukowy - антидетонатор
środek - середина , центр ; средство , мера ; средство
środki produkcji - средства производства
środkowy - центральный
środowisko - природа
Śródziemie - Средиземье
sroka - сорока
śrubokręt - отвёртка
ssać - сосать
ssak - млекопитающее
stacja - станция , вокзал
stać - стоять; стоять
stado - стадо; ''chmara owadów:'' рой; ''stado ptaków:'' стая
stała - константа
stały - неизменный
stanowisko - должность
Stany Zjednoczone - Соединённые Штаты Америки , Соединённые Штаты
stan - состояние
staranie - старание, усилие
Stargard Szczeciński - Старгард Щециньски
starorzecze - старица
starość - старость
starożytny - древний; древний
starszy szeregowy - ефрейтор
Stary Testament - Ветхий Завет
stary - старый; предок ''''
starzec - старик , старец
statek - корабль , судно ; корабль
statyczny - статичен, статичный
stawiać - ставить; ставить, строить, сооружать; угощать; ставить, делать ставка|ставку; являться, прибывать; дерзить, перечить, держать себя вызывающе, хорохориться
staw - пруд ; сустав|суста́в
Stefan - Стефан
step - степь
sterczeć - торчать
ster - руль
stewardesa - стюардесса
stoa - стоа, стоя
stocznia - верфь
stodoła - сарай
stojak - стеллаж|стелла́ж
stolica - столица
stołówka - столовая
stół - стол
stomatologiczny - стоматологический
stonka - колорадский жук
stopa - стопа, ступня; фут
stoper - беруши|беру́ши
stopień najwyższy - превосходная степень
stopień wyższy - сравнительная степень
stopień - ступень ступенька ; градус ; отметка ; степень
stopniowo - постепенно
stop - сплав ; стоп
stosować - применять
stosunek - отношение
stowarzyszenie - общество , ассоциация
strach ma wielkie oczy - у страха глаза велики
strach - страх ; пугало , чучело
strajk włoski - итальянская забастовка
strajk - забастовка
straszliwy - страшный
straszny - ужасный
strażak - пожарный , пожарник
Strefa Gazy - сектор Газа
stres - стресс
strona bierna - страдательный залог , пассив
strona czynna - действительный залог
strona - страница ; сторона ; залог
stront - стронций
strop - перекрытие|перекры́тие
stróż - сторож , вахтёр
strudel - штрудель
strug - рубанок
strumień - ручей ; струя
strumyk - ручеёк
struś - страус
strychnina - стрихнин
strych - чердак
stryczek - петля , верёвка с петля|петлёй; виселица , петля , верёвка
stryj - дядя
strzała - стрела
strzałka - стрелка ; указатель
strzelać - стрелять
Strzelec - Стрелец ''Strieliec''
strzelnica - тир
strzęp - клок, Обтрёпывай
strzyga - стрига, стрыга
student - студент
studiować - учиться в вуз|вузе, в университете; изучать, всматриваться, разглядывать
studnia - колодец
stwardnienie rozsiane - рассеянный склероз
stworzenie - существо , создание ; создание
styczeń - январь
styczniowy - январский
substancja - субстанция
subtelność - тонкость
Suchań - Сухань
suchy - сухой
sufiks - суффикс
sufit - потолок
suka - сука
sukces - успех
sukienka - платье
suknia - платье
sułtanat - султанат
suma - сумма
sumienie - совесть
sum - сом
Surinam - Суринам
surowy - сырой; суровый
suseł - суслик
sutener - сутенёр
Svalbard - Свальбард
swat - сват
sweter - свитер
świadczyć - оказывать, обслуживать; свидетельствовать, служить свидетельство|свидетельством, подтверждать; свидетельствовать, давать свидетельский|свидетельские показание|показания, показывать
świadectwo - свидетельство , сертификат
świadomość - сознание
świat arabski - арабский мир
światłoczuły - светочувствительный, фоточувствительный
światłowód - оптоволокно
światłowstręt - светобоязнь
światło - свет
świątynia - храм
świat - свет , мир , земля
Świdwin - Свидвин
świeca - свеча , свеча зажигания , запальная свеча ; свечка ; дымовая шашка , ароматическая свеча
świecić - светить
świecznik - подсвечник , канделябр ; высокий|высокое положение
świekra - свекровь|свекро́вь
świergotać - чирикать
świerkowy - еловый
świerk - ель , ёлка ; ель
świerszczyk - сверчок
świerszcz - сверчок
święta prawda - святая истина
święto ruchome - переходящий праздник , подвижной праздник
świętość - святость
świętować - праздновать
święto - праздник
świeży - свежий
świnia - свинья
świństwo - пакость
świstak - сурок
świta - свита
świt - рассвет , заря ; заря
swój - свой
św. - св.
sybaryta - сибарит
Syberia - Сибирь
syberyjski - сибирский
Sybiraczka - сибирячка
Sybirak - сибиряк
sykatywa - сиккатив
sylwanit - сильванит
sylwetka - фигура
symbol - символ ; символ
symfonia - симфония
sympatia - симпатия
symptom - симптом
synek - сынок
synonim - синоним
synowa - сноха
syn - сын
sypialnia - спальня
system - система
sytuacja - ситуация , случай , положение
syzyfowa praca - сизифов труд
szabla - сабля
szachista - шахматист
szachistka - шахматистка
szachownica - шахматная доска
szachy - шахматы
szach - шах ; шах
szacunek - уважение ; оценка
szafa - шкаф
szafot - эшафот
szahada - шахада
szałas - шалаш
szalik - шарф
szambo - выгреб|вы́греб , септик|се́птик
szampan - шампанское
szantażować - шантажировать
szantażysta - шантажист
szantażystka - шантажистка
szantaż - шантаж
szarańcza - саранча
szara strefa - теневая экономика
szary - серый
szaszłyk - шашлык
szata - наряд , одежда ; покров , оформление
szczać - писать
szczawik - кислица|кисли́ца
szczawiówka - зелёный борщ
szczaw - щавель
Szczecin - Щецин ''Ščecin''
szczególnie - особенно, особо
szczególny - особенный, особый
szczekać - лаять
szczekanie - гавканье, лаянье ; лай
szczęka - челюсть|че́люсть
szczelina - щель , трещина
szczeniak - щенок
szczenię - щенок
szczepionka - прививка
szczery - искренний
szczęście - счастье
szczęśliwy - счастливый
szczotka - щётка
szczuć - травить; науськивать, натравливать, натравлять
szczupak - щука
szczurołap - крысолов
szczur - крыса
szczypawka - уховёртка
szczyt - вершина , верхушка , пик ; час пик ; предел , верх , высший|высшая степень
szef - шеф , начальник
szeptać - шептать
szereg homologiczny - гомологический ряд
szermierka - фехтование
szeroki - широкий
szeroko - вширь, в ширина|ширину; широко
szerszeń - шершень
sześcian - куб
szewc - сапожник
szezlong - кушетка
szisza - кальян
szkic - очерк, набросок
szkielet - скелет
szklanka - стакан
szklarnia - теплица|тепли́ца
szkło - стекло
Szkocja - Шотландия
szkodnik - вредитель
szkoła - школа
szkolny - школьный
szkuner - шхуна
szlachcic - дворянин
szlachetny - благородный; высококачественный
szlafrok - халат
szlama - грязнокровка
szmaragd - изумруд
szminka - губная помада , помада
szmugiel - контрабанда
sznaucer - шнауцер
sznurek - бечёвка, бечевка, веревочка, шнурок
sznurowadło - шнурок
sznur - шнур , верёвка , нитка
szofar - шофар
szop - енот
szowinizm gatunkowy - спесиецизм
szpachlować - шпаклевать
szpak - скворец
szparag - спаржа|спа́ржа
szpat - шпат
szpieg - шпион
szpilka - кнопка , булавка , игла
szpinak - шпинат|шпина́т
szpital - больница ; госпиталь ''''
szprycer - шипучка
szpulka - шпулька
szron - иней|и́ней
sztokholmski - стокгольмский
sztuczny - искусственный, неестественный
sztuka - искусство ; штука ; пьеса
szubienica - виселица|ви́селица
szuflada - ящик
szukać - искать
szurf - шурф
Szwabia - Швабия
szwagier - шурин
Szwajcaria - Швейцария
szwajcarski - швейцарский
Szwecja - Швеция
szwedzki - шведский
szybki - быстрый, скорый
szybkozłączka - штативная площадка
szybko - быстро
szybowiec - планер
szyć - шить
szydełkować - вязать
szydełko - крючок
Szydłowiec - Шидловец
szyfon - шифон
szyfrant - шифровщик
szyfr - шифр ; иероглиф|иероглифы
szyja - шея|ше́я , горло|го́рло
szynobus - рельсовый автобус
szypszyna - шиповник собачий|шипо́вник соба́чий, роза собачья|ро́за соба́чья
szyszka - шишка
tablica - доска
tabliczka - вывеска
taboret - табуретка
taca - поднос
Tadżykistan - Таджикистан ''Tadžikistan''
tajemnica poliszynela - секрет Полишинеля
tajemnica - тайна , секрет
tajfun - тайфун
tajga - тайга
Tajlandia - Таиланд
tajny - тайный
Tajwan - Тайвань
taki - такой
taksa - такса
tak sobie - так себе, спроста
taksówka - такси
taktyka - тактика
tak zwany - так называемый
tak - так; да
talasemia - талассемия
talent - талант
talerz - тарелка ; тарелка ; тарелка
tal - таллий '' ''
Tamara - Тамара
Tamiza - Темза
tamten - тот
tam - там
tancerz - танцор
tańczyć - танцевать, плясать
Tangier - Танжер
taniec - танец
tani - дешёвый
tank - танк
tantal - тантал
Tanzania - Танзания
tapczan - диван
tapeta - обои ; штукатурка
targi - ярмарка
tarnina - терновник ; терн
tartak - лесопилка
tartrazyna - тартразин
taśma - лента , полоса , плёнка
Taszkent - Ташкент
tata - папа
taternictwo - альпинизм
ta - та
tchawica - трахея
tchórzostwo - трусость
teatr - театр
technet - Технеций
techniczny - технический
technika - техника
technik - техник
technokracja - технократия
techno- - техно-; техно-
tęcza - радуга
tekst - текст
telefon komórkowy - мобильный телефон , сотовый телефон
telefon - телефон ; телефон ; телефон
teleskop - телескоп
teleturniej - телевикторина
telewizja - телевидение
telewizor - телевизор
tellur - теллур '' ''
temat - тема ; корень
temperatura bezwzględna - абсолютная температура
temperatura pokojowa - комнатная температура
temperatura - температура
tempo - темп
tenis - теннис
ten - этот
teologiczny - теологический
teoretyczny - теоретический, теоретичный
tępak - тупица
tępić - тупить|тупи́ть; уничтожать|уничтожа́ть
-terapia - -терапия
teratologia - тератология
teraźniejszy - настоящий, теперешний, нынешний
teraz - теперь
terb - тербий
termin - термин ; срок
termodynamika - термодинамика
termometr - термометр , градусник
terrorysta - террорист
terrorystyczny - террористический
terytorium - территория
teściowa - тёща
teść - тесть ; свёкор
tęsknić - скучать, грустить
tęsknota - тоска , грусть
testament - завещание ; завет
tetrarcha - тетрарх
Tezeusz - Тесей
tg - tg
Timor Wschodni - Восточный Тимор
tioarsenian - тиоарсенат
tioeter - тиоэфир
tkacz - ткач
tkać - ткать
tkanka tłuszczowa - жировая ткань
tkanka - ткань
tlenek potasu - оксид калия
tlenek węgla - угарный газ
tlen - кислород
tłok - давка , толкотня , толчея
tłumaczenie - перевод ; объяснение
tłumaczyć - объяснять; объяснять; переводить
tłumacz - переводчик
tłumić - удерживать
tłum - толпа , сборище , орда , орава , народ , масса
tłusty - жирный|жи́рный
tłuszcz - жир
tokarka - токарный станок
tok pisin - ток-писин
toksyczny - ядовитый
toksykologia - токсикология
Tomasz - Фома
tonąć - тонуть
tonsura - тонзура
topielec - утопленник
topless - топлес
topnieć - таять
topografia - топография
topograficzny - топографический
topola - тополь
toponim - топоним
Tora - Тора
torba - пакет , сумка ; сумка
tornado - смерч , торнадо
tors - торс
tort - торт
tor - торий
tost - тост
totalitarny - тоталитарный
totalitaryzm - тоталитаризм
towarzyszyć - сопровождать
towar - товар
tożsamość - одинаковость , идентичность ; личность , индивидуальность , самоопределение ; особенность , личный|личные данные ; принадлежность ; тождество
to - это
trąba - труба ; смерч , воронка ; хобот ; шляпа /, растяпа , разиня
trącać - толкать
tracić - терять
trącić - толкнуть
tradycja - традиция
tradycyjnie - традиционно
trąd - лепра
trafić - попасть
trafiła kosa na kamień - нашла коса на камень
tragedia - трагедия
tragikomedia - трагикомедия
tramadol - трамадол
tramwaj - трамвай
transformator - трансформатор
transmisja - трансмиссия
transporter opancerzony - бронетранспортёр
transport - транспорт , перевозка , транспортировка
tranzystor - транзистор
trapez - трапеция
trawa - трава
trawestować - травестировать
trawienie - пищеварение
trebusz - требушет , требюше
trefl - трефы ; трефовый
tren - шлейф
treser - дрессировщик
trochę - немного, немножко, несколько
trójkąt - треугольник
trójskok - тройной прыжок
trolejbus - троллейбус
troska - забота , хлопоты
troskliwy - заботливый
troszczyć się - заботиться
trucizna - яд
trudnić się - заниматься
trudność - трудность
trudny - сложный, трудный, непростой
trud - труд
trujący - ядовитый
trumna - гроб
trup - труп , мертвец , покойник
truskawka - клубника ; клубника
trwać - длиться, продолжаться
tryb rozkazujący - повелительное наклонение
tryk - баран
trylion - триллион
Trynidad i Tobago - Тринидад и Тобаго
trzeba - надо, необходимо, нужно
trzęsienie ziemi - землетрясение
trzeźwy - трезвый
trzymać - держать; держать; держать
tsunami - цунами
tu leży pies pogrzebany - вот где собака зарыта
tulipan - тюльпан
tułów - туловище|ту́ловище
Tuluza - Тулуза
tul - тулий
tunel - тоннель , туннель
Tunezja - Тунис|Туни́с
turban - тюрбан
Turcja - Турция
Turecka Republika Północnego Cypru - Турецкая Республика Северного Кипра
Turkmenistan - Туркменистан
Turyn - Турин
turysta - турист
tusz do rzęs - тушь для ресниц
tuzin - дюжина
tuż - почти
tu - здесь, тут
twardy - твёрдый
twaróg - творог
twarz - лицо
twierdzić - утверждать|утвержда́ть
twój - твой
twórczość - творчество
tybetański - тибетский; тибетский
tyć - полнеть, толстеть, тучнеть, жиреть, добреть, тяжелеть
tydzień - неделя ; неделя
tygrysica - тигрица
tygrys - тигр
tylko - только
tynkarz - штукатур
tytan - титан
tytoń - табак
tytuł - титул; титул
ty - ты, ''forma uprzejma'' Вы
tzw. - т.н.
ubezpieczenie - страхование
ubierać - одевать, одеть
ubiór - наряд
ubogi - убогий, скудный
ubóstwiać - обожать
ubóstwo - бедность , нищета
ubranie - одежда
uchodźca - беженец
ucho - ухо
uciekać - убегать
uczciwy - честный
uczelnia - вуз
uczeń - ученик
uczestnictwo - участие
uczestniczyć - участвовать
uczestnik - участник
uczucie - чувство
uczyć - учить; учиться
udar - удар
udawać - изображать
uderzenie - удар|уда́р
uderzyć - ударить
udział - участие
udziec - окорок
UE - ЕС
Uganda - Уганда
ukarać - наказать
ukąszenie - укус|уку́с
układać - составлять
układ okresowy - периодическая система
Układ Słoneczny - Солнечная система
układ - система , конфигурация ; договор , соглашение , пакт
ukleja - уклейка , уклея
Ukraina - Украина
ukraść - украсть
ukrywać - прятать; скрывать; прятаться
ułamek - дробь ; доля , часть
ulica - улица
ulotka - листовка
ultimatum - ультиматум
ultimogenitura - переход наследство|наследства к молодой|младшему сын|сыну
ulubiony - любимый
ul - улей
umieć - уметь
umiejętność - умение , способность , навык
umierać - умирать, умереть
umieszczać - помещать, располагать, размещать
umowa - договор
umożliwiać - делать возможным
umrzeć - умереть
umysł - ум
Unia Europejska - Европейский Союз , Евросоюз
unia - союз
unieważnić - аннулировать
unikać - избегать
uniwersalny - универсальный
uniwersytet - университет|университе́т
ununbium - унунбий
upał - жара
upiór - упырь
uprzejmy - любезный
uraczyć - угостить, запотчевать; угоститься, полакомиться
Ural - Уральские горы, Урал; Урал
uran - уран
Uran - Уран ; Уран
uratować - спасти
urlopowicz - отпускник
urlop - отпуск
urna - урна ; урна
uroczysko - урочище
uroczystość - торжество , празднество , праздник
uroczysty - торжественный
urodziny - день рождение|рождения
Urugwaj - Уругвай
urwisko - утёс, утес, обрыв
urządzenie - устройство
urząd - учреждение , ведомство , бюро ; должность , пост
urzędowy - служебный
USA - США
usługa - услуга
usłyszeć - услышать
uśmiechać się - улыбаться
uśmiech - улыбка
uspokajać - успокаивать
usta - губа|губы , уста
ustny - устный
Ustrzyki Dolne - Устрики Дольные
usuwać - удалять|удаля́ть
uszanka - ушанка
utrudniać - осложнять
utrzymywać - удерживаться
utworzenie - основание
utworzyć - соорудить
utwór - произведение , сочинение
uwaga - внимание ; замечание ; внимание; осторожно
uważać - считать
uwodzić - соблазнять, обольщать
uzależnienie - зависимость
uzasadniać - обосновывать, мотивировать, оправдывать
Uzbekistan - Узбекистан
uznać - признать|призна́ть&lt;ref&gt;&lt;/ref&gt;
uznanie - прнзнание|прнзна́ние; усмотрение|усмотре́ние&lt;ref&gt;&lt;/ref&gt;
uznawać - признавать|признава́ть&lt;ref&gt;&lt;/ref&gt;
użycie - использование
użyteczność - полезность
użytkownik - пользователь
używać - пользоваться, использовать
wacha - ваху
wachlarz - веер ; диапазон , круг , спектр
waga - весы
Waga - Весы ''Viesy''
wagon - вагон
wakacje - каникулы , отпуск
walczyć - бороться, воевать
walec - каток ; цилиндр
wałek do ciasta - скалка
walet - валет
Walia - Уэльс
walić konia - дрочить , играть с Дунькой Кулаковой
walizka - чемодан
walka - борьба
wałkoń - лентяй , лодурь
walor - достоинство; ценная бумага
waltornia - валторна
waluta - валюта
wampir - вампир , вурдалак , упырь ; вампир
wanad - ванадий
wanienka - ванночка
wanna - ванна
wanta - ванта
wapń - кальций
waran - варан
warga - губа
wariant - вариант
Warkocz Bereniki - Волосы Вероники
warkocz - коса
warstwa - слой; пласт
Warszawa - Варшава
warszawski - варшавский
wartość - ценность , достоинство ; стоимость , ценность ; ценность ; величина , значение
warto - стоит
warunek - условие
warunkowy - условный
warzywo - овощ
wąski - узкий , узко
wasz - ваш
wąs - ус
wątpić - сомневаться
wątpliwość - сомнение
wątpliwy - сомнительный
wątroba - печень
wątrobianka - ливерная колбаса
Watykan - Ватикан ''Vatikan''
wat - ватт
wąwóz - овраг , ущелье
wazektomia - вазэктомия
ważka - стрекоза
ważny - важный; действительный
ważyć - взвешивать
wąż - змея ; шланг ; гадюка , змея
w celu - с целью
wcześniej - тому назад, назад
wcześnie - рано
wczorajszy - вчерашний
wczoraj - вчера
wdowa - вдова
w drobny mak - вдребезги|вдре́безги, вдрызг
wdzięczność - благодарность
wdzięczny - благодарный
węch - обоняние , нюх ; нюх , чутьё
wędkarstwo - рыбная ловля , ужение
wędlina - колбасные изделия, копчёности
według - по
weganizm - веганство, веганизм
wegetarianizm - вегетарианство
wegetarianka - вегетарианка
węgielny - угольный|уго́льный, краеугольный|краеуго́льный
węgiel - углерод ; уголь
węgieł - угол
Węgierka - венгерка
węglan litu - карбонат лития
węglan - карбонат , углекислая соль
węglarka - полувагон
węglowy - угольный; углеродный
węgorz - угорь
Węgry - Венгрия
wejść - войти
welin - велень веленевая бумага
wełna - шерсть ; шерсть
welon - фата|фата́
Wełtawa - Влтава
wena - вдохновение
wenecjanin - венецианец
Wenecjanin - венецианец
Wenecja - Венеция
wenerologia - венерология
Wenezuela - Венесуэла
Wenezuelczyk - венесуэлец
Wenezuelka - венесуэлка
Wenus - Венера ; Венера
weranda - веранда
wersja - версия , вариант
werwa - огонь
wesoło - весело
Wesołych Świąt - с Рождеством
Westa - Веста
wesz - вошь
weterynaria - ветеринария
weterynarz - ветеринар
wet za wet - зуб за зуб
wewnątrz - внутри
wewnętrzny - внутренний
węzeł gordyjski - гордиев узел
węzeł - узел
wężowy - змеиный
wężyk - змейка
wiać - дуть; тянуть
wiadomości - новость|новости
wiadomość - новость , информация , сообщение
wiadro - ведро
wiara - вера
wiatrak - ветряная мельница
wiatr - ветер
wiązanie - связь
widelec do porcjowania - вилка порционная
widelec - вилка
widły - вилы
widoczny - видимый, заметный
widzenie - свидание
widzieć - видеть
widz - зритель
więcej - больше
wieczność - вечность
wieczorem - вечером
wieczorny - вечерний
wieczorynka - вечерний|вече́рняя телепередача|телепереда́ча для малыш|малыше́й
wieczór - вечер
Wiedeń - Вена
wiedza - знание|зна́ние
wiedzieć - знать, ведать
wiek emerytalny - пенсионный возраст
większy - больший|бо́льший
wiek - возраст ; век ; вечность
wiele - много
Wielka Brytania - Великобритания ; Британия
wielkanocny - пасхальный
Wielkanoc - Пасха
Wielkie Równiny - Великие равнины
wielki - большой; великий
wielkoduszny - великодушный
wielkość - величина
wielokąt - многоугольник
Wieluń - Велюнь
wieniec - венок|вено́к
wierny - верный; верный; верующий
wiersz - стих
Wieruszów - Веру́шув
wierzba płacząca - плакучая ива
wierzba - ива
wierzchołek - вершина
wierzyć - верить
wieszak - вешалка
wieś - деревня , село
Wietnamka - вьетнамка
wietnamski - вьетнамский
wiewiórka - белка
wieża Babel - Вавилонская башня
wieża - башня ; ладья
więzienie - тюрьма
wigilia - сочельник
Wigilia - сочельник
wigor - живость, темперамент
Wikipedia - Википедия
Wikisłownik - Викисловарь, Вики-словарь
Wikiźródła - Викитека
Wiktor - Виктор
Wilamowice - Вилямовице
wilczę - волчонок
wilczy bilet - волчий билет
Wilczy Szaniec - Волчье логово
wilczy - волчий
wilga - иволга
wilkołak - оборотень
wilk w owczej skórze - волк в овечьей шкуре
wilk - волк
wina - вина
winda - лифт ; винда
winny - винный
winogrono - виноград
winorośl - виноград
wino - вино
wiolonczela - виолончель
wioślarka - гребчиха
wiosło - весло
wiosna - весна
wirtuoz - виртуоз
wisieć - висеть
Wisła - Висла
wiśnia - вишня
witraż - витраж|витра́ж
wiza - виза
wizerunek - изображение
wizytówka - визитная карточка , визитка
wkładka do butów - стелька|сте́лька
wkrótce - вскоре, скоро, в скором времени
w kwiecie wieku - в расцвет|расцвете
włączać - включать; включать, присоединять, причислять
władca - повелитель , властелин , владыка
władza - власть ; власть|власти , орган|органы власть|власти
właściciel - владелец , собственник , хозяин , , властитель
właściwość - свойство , признак
właśnie - вот; именно; вот это именно
własny - собственный
Włochy - Италия
Włoch - итальянец
Włocławek - Влоцлавек
włóczęga - бродяга
Włodzimierz - Владимир|Влади́мир
włókiennictwo - текстильный|текстильная промышленность
włoski - итальянский; итальянский ; волосок|волоски
włos - волос
wnęka - ниша
wniosek - вывод , следствие ; заявление , предложение
wnioskodawca - заявитель , автор предложение|предложения
WNP - СНГ
wnuczka - внучка
wnuk - внук
woalka - вуаль , вуалетка
wobec - перед, по отношению, в отношении, из-за, ввиду
woda - вода
wódka - водка
Wodnik - Водолей ''Vodoliej''; Водолей ''Vodoliej''
wodny - водяной
wodociąg - водопровод
wodorotlenek berylu - гидроксид бериллия
wodór - водород
wodospad - водопад
w ogóle - вообще
Wojciech - Войтех
województwo - воеводство
wojna - война
wojskowy - военный; военный
wójt - войт
wokalista - вокалист
wokalizm - вокализм
wokanda - перечень дело|дел, подлежать|подлежащих рассмотрение|рассмотрению суд|суда
wokół - вокруг
wołacz - звательный падеж
wolant - штурвал
woleć - предпочитать
wolfram - вольфрам
Wołga - Волга
Wołgograd - Волгоград
wolność słowa - свобода слова
wolność - свобода , воля
wolny rynek - свободный рынок
wolny - свободный; холостой, незамужняя; медленный, неторопливый
wołowina - говядина
woń - аромат
worek - мешок
wosk - воск
wózek inwalidzki - коляска
woźnica - ямщик
wpław - вплавь
wpływ - влияние
wprost - спроста
wracać - возвращаться
wrak - остов
wrażenie - ощущение , впечатление
wrażliwy - чувствительный
wreszcie - наконец
wróbelek - воробейчик
wróbel - воробей
wrócić - вернуться|верну́ться
wróg - враг
wrona - ворона
wrotka - ролик
wrzątek - кипяток
wrzeć - кипеть
wrzesień - сентябрь
wrzód - язва
wrzos - вереск
wschodni - восточный
Wschód - Восток
wschód - восход ; восток
wścieklizna - бешенный
wskaźnik - показатель
wskazówka - стрелка
wskazywać - указывать
wspaniałomyślny - великодушный
wsparcie - поддержка
współczesny - современный
Wspólnota Niepodległych Państw - Содружество Независимых Государств
wspólnota - сообщество , объединение , союз , общность ; сходство , подобие , общность
współpraca - сотрудничество
współpracownik - сотрудник
współwyznawca - сторонник; единоверец
współżyć - сожительствовать, жить совместно; находиться в симбиоз|симбиозе
wspomagać - помогать
wspomnienie - воспоминание
wstać lewą nogą - встать не с той ноги
wstąpić - войти, зайти, вступить
wstępny - вступительный, предварительный
wszędzie dobrze, ale w domu najlepiej - в гостях хорошо, а дома лучше
wszędzie - везде, всюду, повсеместно
wszyscy - весь|все
wszystko jedno - всё равно
wszystko - всё
wtedy - тогда
wtem - вдруг, внезапно, неожиданно
wtorek - вторник
wtyk - знакомство
wujek - дядя
wulgarnie - вульгарно
wulgaryzm - вульгаризм , вульгарный|вульгарное слово/выражение
wulkan - вулкан
wulkan - вулкан
Wulkan - Вулкан
wybaczać - прощать
wybierać - выбирать; избирать, выбирать
wybitny - выдающийся
wyborca - избиратель
wyborny - отличный
wybory - выборы
wybór - выбор
wybrać - выбрать
wybranka - избранница
wybredny - разборчивый
Wybrzeże kość Kości Słoniowej - Кот-д'Ивуар , Республика Кот-д’Ивуар , Берег Слоновой Кости
wybrzeże - побережье
wychodzić za mąż - выходить замуж, жениться
wychodzić - выходить; глядеть
wychowanie - воспитание
wychwalać - превозносить, восхвалять
wyciąg - лебёдка ; выжимка подъемник
wyczesywać - вычёсывать, чесать
wyć - выть; выть
wydanie - издание
wydarzenie - происшествие , событие ; событие
wydawać - тратить, расходовать; давать сдача|сдачу; выдавать; предавать, выдавать; издавать, выпускать на свет; издавать; казаться
wydawnictwo - издательство ; издание , публикация
wydłużyć - удлинять
wydma - дюна
wydmuszka - выдутое яйцо
wydruk - распечатка
wyglądać - выглядеть; выглядывать; ожидать, поджидать, дожидаться
wygląd - вид , внешность
wygwizdywać - освистывать, шикать; высвистывать
wyjątek - исключение
wyjątkowy - исключительный
wyjazd - отъезд
wyjście - выход
wyjść za mąż - выйти замуж
wyjść - выйти
wykałaczka - зубочистка
wykonalny - выполнимый
wykonanie - исполнение , выполнение
wykonawca - исполнитель
wykonawczyni - исполнительница
wykonawstwo - исполнение , подряд , подрядный|подрядные работа|работы
wykonywać - изготавливать
wykopywać - выкапывать, вырывать; выкопаться
wykorzystać - использовать
wykorzystywać - использовать, пользоваться; использовать, пользоваться
wykpić - высмеять|вы́смеять; увернуться|уверну́ться, отделаться|отде́латься
wykrzyknik - восклицательный знак
wykształcenie - образование
wykształcony - образованный
wyłączać - выключать
wyłącznie - исключительно
wyłącznik - выключатель
wylogowywać - закончить работа|работу
wymagać - требовать
wymiana - обмен
wymiar - измерение ; размерность ; размер , величина , объём , масштаб
wymiennik ciepła - теплообменник
wymiennik - теплообменник
wymienny - обменный
wymioty - рвота ; блевотина
wymowa - произношение ; оттенок , значение
wynajmować - сдавать в наём, отдавать напрокат; снимать, брать напрокат, нанимать
wynikać - вытекать, следовать
wyobrażać sobie - воображать себе, представлять себе
wyobrażać - изображать; изображать
wyodrębniać - обособлять
wypadek - случай , факт , событие , происшествие ; несчастный случай , катастрофа
wypiek - выпечка
wyrażać - выражать; выражаться, высказываться
wyraz - слово , лексема ; выражение ; проявление
wyrób - изделие , продукт ; продукция , производство , изготовление , выделка
wyróżniać - отличать
wyściełać - выстилать
wysiłek - труд , усилие
wyśmienicie - отлично
wysokie napięcie - высокое напряжение
wysoki - высокий
wysokość - высота|высота́ ; высота|высота́
wysoko - высоко|высоко́
wysoko- - высоко-|высо́ко-
Wyspa Bożego Narodzenia - Остров Рождества
Wyspa Książęca - Принсипи
Wyspa Man - Остров Мэн
Wyspa Świętego Wyspy Świętego Tomasza i Wyspa Książęca - Сан-Томе и Принсипи
wyspa - остров
Wyspy Alandzkie - Аландские острова
Wyspy Brytyjskie - Британские острова
Wyspy Kanaryjskie - Канарские острова
Wyspy Owcze - Фарерские острова
wystarczać - хватать, быть достаточный|достаточным; хватать|хватит
występować - выходить, уходить; выступать
wysyłać - посылать, высылать; выслать
wywiad - интервью ; разведка ; опрос , расспрос
wyznanie - вероисповедание; признание
wyżymaczka - выжималка
wy - вы
wzajemność - взаимность
wzbudzać - возбуждать, внушать
wzbudzić - возбудить
wzdłuż - вдоль; вдоль
wzgląd - соображение
wzgórze - холм
wzniesienie - возвышенность
wzrok - зрение
wzrost - рост , высота ; рост , увеличение
wz- - вз
w - в
zaaferować - занять, поглотить
zabawka - игрушка
żaba - лягушка
zabijać czas - убивать время
zabijać - убивать , убить ; забивать , забить , заколачивать ; убиваться
żabka - подковка ; гаечный ключ ; брасс ; лягушка
zabójca - убийца
zabraniać - запрещать
zabudowa - застройка
ząb - зуб
zachodniopomorski - западнопоморской
zachodni - западный
zachodzić - заходить, закатываться; заходить ; происходить, возникать; покрываться
zachód - закат ; запад ; хлопоты , усилие|усилия , старание|старания
zachorować - заболеть
zachowanie - поведение
zaciągać - завербовываться, вступать, поступать; затягиваться
zaćmienie - затмение
zacząć - начать
zaczynać - начинать; начинать; начинать; начинать, стать
żądać - требовать
zadanie - задание , задача
żaden - никакой, ни один; никакой, никуда не годный, никудышный
żądło - жало
zadowalać - удовлетворять; быть доволен|довольным
zadupie - захолустье , глубинка
za friko - бесплатно
zagadnienie - вопрос
Żagań - Жагань
żagiel - парус
zaginiony - пропавший
żaglowiec - парусник , парусное судно
zagroda - двор
zagrożenie - опасность , угроза
Zagrzeb - Загреб
zaimek - местоимение
zainteresowania - увлечение|увлечения
zainteresowanie - интерес , заинтересованность
zaiwaniać - жать, крыть
zając - заяц
zajebisty - охуенный
zajęcie - занятие
zajmować - занимать; заниматься; загораться, вспыхивать, заниматься
zakazany owoc - запретный плод
zakażenie - инфекция
zakaz - запрет
zakładać - основывать, учреждать; надевать; принимать, предполагать, исходить, предпосылать; платить ; спорить, держать пари, биться об заклад
zakładka - закладка
zakładnik - пленник , пленница
zakład - предприятие , завод , комбинат ; предприятие , заведение , учреждение ; фотоателье , парикмахерская , учебный|учебное заведение , научный|научное учреждение , похоронный|похоронное бюро ; пари ; складка , подшивка , запас
żako - жако, серый попугай
zakreślacz - маркер
zakręt - поворот ; разворот
zalegalizować - оформить
zalesiać - насаждать лес, проводить лесонасаждение
zależność - закономерность
założyć - одеть, надеть; заложить, положить, подложить, вложить; принять, предположить; заплатить
żal - сожаление , горе
zamach stanu - путч
Zambia - Замбия
zamek błyskawiczny - застёжка-молния
zamek - замок ; замок ; замок , молния
zamężna - замужняя
zamiar - намерение
zamiast - вместо, взамен; вместо
zamieniać (zamienić, zmienić) się w słuch - обратиться в слух, превратиться в слух
zamknąć - заткнуться; закрыться, запереться; уйти в себя, замкнуться
Zamość - Замосць, Замость
zamykać - закрывать
zapach - запах
zapadać - проваливаться , провалиться , углубляться , углубиться , погружаться , погрузиться , заваливаться , завалиться , западать , запасть ; заболевать , заболеть , занемогать , занемочь ; спускаться , спуститься , садиться , сесть ; укрываться , укрыться , уходить , уйти
zapalać - зажигать
zapalenie płuc - пневмония
zapalenie skóry - дерматит
zapalenie - воспаление
zapałka - спичка
zapalniczka - зажигалка|зажига́лка
zapamiętywać - запоминать
zapaść - коллапс
zapiąć - застегнуть
zapisywać - записывать; завещать, записывать; прописывать; записывать, вносить в список
zapis - запись
zapładniać - оплодотворять
zapominać - забывать , забыть ; забывать , забыть
zapomnieć - забыть
zapomoga - пособие
zapora - преграда , заграждение , барьер , помеха ; плотина
Zaporoże - Запорожье, Запорожье
zapowiedź - объявление
zapraszać - приглашать|приглаша́ть
zapytać - спросить|спроси́ть
zarabiać - зарабатывать
zaratusztrianizm - зороастризм
zaraz - сейчас, тотчас, сразу, тут же
żarłok - обжора , прожора
zarost - борода
żarówka - лампочка
żartowniś - шутник
żart - шутка
zasada - правило ; щёлочь
zasięgnąć języka - разузнать, разведать
zaskroniec - уж
zasługa - заслуга
zasługiwać - заслуживать
zasnąć - заснуть
zasnąć - засыпать
zaspa - сугроб
Zatoka Botnicka - Ботнический залив
Zatoka Fińska - Финский залив
zatoka - залив
zatrudniać - давать работу
zatrudnienie - трудоустройство ; трудовой|трудова́я деятельность|де́ятельность , занятость|за́нятость
zatrzymywać - задерживать, задерживаться, останавливать, останавливаться, задержать, задержаться, остановить, остановиться; оставить
zaufanie - доверие
zauważyć - заметить
zawartość - содержимое , содержание , предмет
zawiadomienie - уведомление , извещение , сообщение
zawierać - содержать, вмещать, заключать ; заключать
zawód - профессия ; разочарование
zawór bezpieczeństwa - предохранительный клапан
zawór motylkowy - дроссельная заслонка
zawór sterujący - регулирующий клапан
zawór - вентиль , клапан
zawrzeć - вскипеть, закипеть
zawsze - всегда
zawziętość - ожесточение , упорство ; упорство
zazdrość - зависть ; ревность
zazwyczaj - обычно
zbałamucić - задурить
zbawca - избавитель , спаситель
zbędny - лишний
zbić z pantałyku - сбить с панталыку
zbierać - собирать
Zbigniew - Збигнев
żbik - лесной кот
zbiornik - цистерна, бак ; водоём
zbiór - сбор , собрание ; уборка ; урожай ; коллекция , собрание , комплект , набор ; множество ; файл
zbir - бандит , разбойник
zbocze - откос , склон
zbójczyni - разбойница
zboże - злаки
zbrodnia - преступление
zbuk - тухлый|тухлое яйцо
zbyt - сбыт ; слишком
zdanie - предложение ; мнение
zdecydowanie - решимость
zdjąć - снять
zdobyć - приобрести
zdobywać - завоёвывать
zdobywca - завоеватель ; обладатель
zdolność - способность ; способность
zdrada stanu - государственный|госуда́рственная измена|изме́на
zdrada - предательство , измена ; измена , неверность
zdradzać - выдавать; предавать, изменять; измнять; проявлять, выказывать
zdradziecko - предательски
zdrajca - предатель
zdrobnienie - уменьшительная форма , ласкательная форма
zdrowy - здоровый
źdźbło - стебель , стебелёк , соломинка , травинка ; капелька , малость , крошка , частица
żebrak - попрошайка, нищий
zebranie - собрание
zebra - зебра ; пешеходный переход
żebro - ребро
zebu - зебу
żeby - чтобы; чтоб
zegarek - часы
zegarmistrz - часовщик
zegar słoneczny - солнечные часы /
zegar - часы
żeglarz - парусник , яхтсмен
żelatyna - желатин
żelazko - утюг
żelazokrzem - ферросилиций
żelazomangan - феромарганець
żelazo - железо
żelbet - железобетон
żel - гель
zenit - зенит ; зенит , вершина
żeński - женский
zero - нуль , ноль
zespół kanału nadgarstka - синдром запястного канала, карпальный туннельный синдром
zespół napięcia przedmiesiączkowego - предменструальный синдром
zespół - ансамбль
zeszły - прошлый
zeszyt - тетрадь
zetrzeć w proch - стереть в табак
zetta- - зетта-
zewnętrzny - внешний, наружный
zez - косоглазие
że - что; потому что, так как
zgierski - згежский
zgierzanin - житель Згеж|Згежа
Zgierz - Згеж
zgniły - скапан; скапан
zgoda - согласие
zgodnie - согласно; согласно
zgodzić - согласиться
z góry - сверху; ''płacić z góry'' платить вперёд; заранее; сверху
zgraja - свора
zgromadzenie - собрание
zgrubienie - аугментатив ; утолщение
zgryzota - огорчение , забота
zgryz - прикус
zgubny - губительный, пагубен, гибельный, губителен
ziarno - зернистость
zięba - зяблик
zięć - зять
zieleń - зелень
zielnik - гербарий
zielony - зелёный
ziemia - земля
Ziemia - Земля
ziemniaczany - картофельный
ziemniak - картошка , картофель ; картофелина
zima - зима
Zimbabwe - Зимбабве
zimny - холодный
zimorodek - зимородок
zimowisko - зимовка, зимовье; зимовка, зимовье
zimowy - зимний
ziomek - дружище ; земляк , соотечественник
zipać - дышать, хватать воздух
ziszczać - выполнить, осуществить, оправдать
zjawa - призрак
zjednoczenie - объединение
Zjednoczone Emiraty Arabskie - Объединённые Арабские Эмираты
źle - плохо
żłobek - детские ясли
złocień - хризантема
złodziej - вор
złość - злоба , злость
złośliwy - злобный
złota rączka - золотые руки , умелые ручки
złotnik - золотильщик|золоти́льщик , золотых дел мастер|золоты́х дел ма́стер
złoto - золото ; золото
złoty - золотой; золотистый; злотый
zły - злой, сердитый; плохой, нехороший; неподходящий, плохой; плохой; плохой; плохой; плохой; плохой; плохой
zmarły - мёртвый, умерший
zmartwienie - сожаление, забота
zmęczony - усталый, уставший, утомлённый
zmiana - изменение , перемена ; смена
zmieniać - менять, изменять; превращать; сменять, заменять
zmierzch - сумерки
żmija - гадюка
żmijówka - змеиное вино
zmrok - сумерки
zmuszać - заставлять
znaczenie - значение , смысл ; значение
znaczny - значительный|значи́тельный, заметный|заме́тный
znaczyć - значить, иметь значение ; значить, обозначать, означать; метить, клеймить, маркировать, оставлять знак|знаки ; назначать, определять, устанавливать, наметить, указывать
znać - знать; знакомый|быть знакомым с
znajdować - находить; находиться
znak - знак , марка , метка , клеймо , указатель ; знак , сигнал ; знак , признак , примета ; знак , след ; знамя
znaleźć - найти
znany - известный
znawca - знаток
znicz - лампада
znienacka - врасплох
żniwa - жатва
żniwiarz - жнец , косарь , косильщик
znosić - сносить; отменять; терпеть; переносить; сглаживаться, уравновешиваться
znowu - опять, снова, вновь
znużenie - утомление
zobaczyć - увидеть; посмотреть
zob. - см.
zodiak - зодиак
zoil - зоил
żołądek - желудок|желу́док
żołądź - жёлудь ; трефы ; головка полового члена
żółć - жёлчь
żołd - денежное довольствие
żołnierz - солдат
żółtaczka - желтуха
żółta kartka - жёлтая карточка
żółty - жёлтый
żółwi - черепаший
żółw - черепаха
żonaty - женатый
żona - жена
zoofilia - зоофилия
zoolatria - зоолатрия
zoologia - зоология
zoo- - зоо-
zoo - зоопарк
zostawać - оставаться, остаться; становиться, стать
z poważaniem - с уважением
z powrotem - назад, обратно, вспять
źrebić się - жеребиться
źrebię - жеребёнок
źrebna - жерёбая
z reguły - как правило
ZRiB - СГРБ, СРБ
zrobić - сделать
źródlany - ключевой, родниковый
źródłosłów - этимология ; этимон
źródło - ключ , родник , источник ; источник ; причина
zrównoważony - уравновешенный
ZSRR - СССР
żuaw - зуави; зуав
żubr - зубр
żuk - жук
żul - жулик
zupa - суп
zupełny - полный, совершенный, сплошной
żurawina - клюква
żuraw - журавль ; подъёмный кран
żurek - суп на мучная|мучной закваска|закваске
żużel - шлак; спидвей
zwiastun - вестник ; трейлер
związek chemiczny - химическое соединение
związek nieorganiczny - неорганическое соединение , неорганическое вещество
związek organiczny - органическое соединение , органическое вещество
Związek Radziecki - Советский Союз
związek rządu - подчинительная связь
związek siarkoorganiczny - сероорганическое соединение
Związek Socjalistycznych Republik Radzieckich - Союз Советских Социалистических Республик ''Sojuz Sovietskich Socialističieskich Riespublik''
związek - связь ; общество
związywać - связывать
zwiększać - увеличивать
zwierzę - животное , зверь
żwir - гравий, хрящ
zwolennik - сторонник
zwoływać - созывать
zworka - джампер
zwrotnica - стрелка
zwrotnik - тропик ; мордент
zwrot - поворот; склонность, уклон; оборот
zwycięstwo - победа
zwyciężać - побеждать
zwyczajny - обычный, простой
zwyczaj - обычай ; обычай , привычка
zwykle - обычно
zwyrodnialec - вырожденец
życie - жизнь ; существование
życiorys - жизнеописание , биография
życiowy - жизненный
żyć jak pączek w maśle - кататься как сыр в масле
żyć na wysokiej stopie - жить на широкую ногу
życzyć - желать; пожелать
żyć - жить
Żyd - еврей
żyd - иудей
żyła - вена
żyletka - лезвие
żyrafa - жираф
żyrandol - люстра
żyto - рожь
żywa pagina - колонтитул
żywić - питаться
żywność - продовольствие
żywopłot - живая изгородь
żywy - живой; живой, оживлённый
żyzny - плодородный
z - из; из; с, со
-ż - -ка
ż - латинский|латинская буква з с точка|точкой
ź - латинский|латинская буква з с чёрточка|чёрточкой
